border_size=1
usage=map

Xol, Xol, Xol, Xol, Xol, Xol, Xol, Xol, Xol, Xol, Xol, Xol, Xol, Xol, Xol, Xol, Xol, Xol, Xol, Xol, Xol
Xol, Xol, Xol, Xol, Xol, Xol, Xol, Xol, Xol, Xol, Xol, Xol, Xol, Xol, Xol, Xol, Xol, Xol, Xol, Xol, Xol
Xol, Xol, Xol, Xol, Xol, Xol, Urb, Xol, Urb, Xol, Xol, Xol, Urb, Xol, Urb, Urb, Urb, Urb^Dr, Xol, Xol, Xol
Xol, Xol, Xol, Xol, Urb, Urb, 1 Urb, Urb, Urb, Urb, Urb, Urb, Urb, Urb, Xol, Urb, Urb, Urb, Urb, Xol, Xol
Xol, Xol, Xol, Urb^Dr, Urb, Urb, Urb, Urb, Urb, Urb, Urb, Urb, Urb, Urb, Xol, Xol, Urb, Urb, Urb, Xol, Xol
Xol, Xol, Xol, Urb, Urb, Urb, Urb, Urb^Dr, Xol, Urb, Rb, Rb, Xol, Xol, Xol, Xol, Urb, Urb^Dr, Xol, Xol, Xol
Xol, Xol, Xol, Urb, Urb, Urb, Xol, Xol, Xol, Xol, Rb, Rb, Xol, Xol, Xol, Xol, Xol, Xol, Xol, Xol, Xol
Xol, Xol, Xol, Xol, Xol, Xol, Xol, Xol, Rb, Rb, Xol, Xol, Xol, Xol, Xol, Xol, Xol, Xol, Xol, Xol, Xol
Xol, Xol, Xol, Xol, Xol, Xol, Xol, Xol, Rb, Xol, Xol, Xol, Xol, Xol, Xol, Xol, Xol, Xol, Xol, Xol, Xol
