border_size=1
usage=map

Gg, Gg, Gg^Es, Gg, Gg^Es, Gg, Gg^Efm, Gg^Efm, Gg^Efm, Gg^Es, Gg, Gg, Gs^Fds, Gg, Gs^Fds, Gg, Gs^Fds, Gg, Gg, Gg, Gg^Es, Gg, Gg, Gs^Fds, Gs^Fds, Gg, Gs^Fds, Gg, Gg^Efm, Gg, Gg, Gg, Gg, Gs^Fds, Gs^Fds, Gs^Fds, Gs^Fds, Gs^Fds, Gs^Fds, Gs^Fds, Gs^Fds, Gs^Fds, Rp, Gg, Gg, Gg
Gg, Gg^Es, Gg, Gg^Efm, Gg^Efm, Gg^Efm, Gg, Gg^Es, Gg, Gg^Efm, Gg, Gg, Hh^Fds, Gs^Fds, Gs^Vl, Gs^Fds, Gg, Gs^Fds, Hh^Es, Gg^Es, Gg^Efm, Gg, Gs^Fds, Gs^Fds, Gs^Fds, Gs^Fds, Gs^Fds, Gg, Gg^Efm, Gg^Es, Gg^Es, Gg^Efm, Gg, Gs^Fds, Gs^Fds, Gs^Fds, Mm, Mm, Ch, Gs^Fds, Rp, Rp, Gg^Es, Gg, Gg, Gg
Gg, Gg^Efm, Gg^Es, Gg^Efm, Gg, Gg, Gs^Fds, Gg, Gg, Gg, Hh^Fds, Gg, Hh^Fds, Hh^Fds, Gg, Gg, Gg, Gg, Gg, Gg, Hh^Fds, Hh^Fds, Gg, Gs^Fds, Gs^Vl, Gs^Fds, Gg, Gg^Efm, Gg, Gg, Gg, Gg, Gg, Gs^Fds, Ch, Ch, Ch, 3 Kh, Ch, Ch, Rp, Gg, Gg^Efm, Gg^Es, Gg, Gg
Gg, Gg^Efm, Gg^Efm, Gg, Gs^Fds, Gs^Fds, Gs^Fds, Gs^Fds, Gs^Fds, Gg, Gs^Fds, Hh^Fds, Hh^Fds, Gg, Gg^Es, Gg^Efm, Gg^Efm, Gg^Es, Gg^Es, Gg, Gg, Gg, Gg, Gg, Gg^Efm, Gg, Gg^Es, Gg^Efm, Gs^Fds, Gs^Fds, Gs^Fds, Gg, Gg, Gg, Gg^Efm, Ch, Ch, Ch, Ch, Ch, Rp, Gg^Efm, Gg, Gg^Es, Hh^Fds, Gg
Gg^Es, Gg^Es, Gg^Efm, Gg^Es, Gs^Fds, Hh^Fds, Hh^Fds, Gs^Fds, Hh^Fds, Gs^Fds, Hh^Fds, Gg, Gg^Efm, Gg^Es, Gg, Gg^Es, Gg^Efm, Gg^Efm, Gg, Gg^Es, Gg, Gg, Gg, Gg^Es, Gg, Gg^Efm, Gg, Gs^Fds, Gs^Fds, Gs^Fds, Gs^Fds, Gs^Fds, Gs^Fds, Gg, Gg, Gg, Rp, Ch, Rp, Rp, Gg, Gg, Hh^Fds, Hh^Fds, Hh^Fds, Gg
Gg, Ce, Ce, Gg, Gg, Hh^Fds, Gs^Fds, Gs^Fds, Gs^Fds, Gs^Fds, Gg, Gg^Es, Gs^Fds, Gs^Fds, Gs^Fds, Gg, Gg^Efm, Gg, Gg, Gg, Gg, Gg, Gg, Gg^Es, Gg^Es, Gg, Gs^Fds, Gs^Fds, Gs^Fds, Gs^Fds, Gs^Fds, Gs^Fds, Gg, Gg, Gg, Rp, Gg, Rp, Gg, Gg^Efm, Gg^Efm, Gg, Gg, Gs^Fds, Gs^Fds, Gs^Fds
Hh^Fds, Ce, Ce, Ce, Ce, Gg, Gg, Gs^Vl, Gg^Es, Gs^Fds, Gg^Es, Gg, Gg, Gs^Fds, Gg, Gg, Gg^Efm, Gg, Gs^Fds, Gs^Fds, Gs^Fds, Gs^Fds, Gs^Fds, Gs^Fds, Gg^Es, Gg, Gg, Gg, Gs^Fds, Gs^Fds, Gg, Gs^Vl, Gg, Gg, Rp, Rp, Gg, Gg, Gg, Gg^Efm, Gg, Gg, Gg^Es, Gs^Vl, Gg^Es, Gg
Hh^Fds, Ce, 4 Ke, Ce, Ce, Gg, Gg, Gg, Gg^Efm, Gg^Es, Gg, Gs^Fds, Gs^Fds, Gg, Gg, Gg^Efm, Gg^Es, Gg^Es, Gg, Gs^Fds, Gs^Fds, Gs^Fds, Gs^Fds, Gg, Gg^Efm, Gg^Efm, Gg, Gg, Gg, Gg^Es, Gg, Gg, Gg, Gg, Rp, Gg, Gg, Gg, Gg, Gg, Gg^Efm, Gg^Efm, Gg^Efm, Gg^Es, Gg, Gg
Hh^Fds, Ce, Ce, Ce, Gg, Gg, Gg, Gg, Gg, Gg, Gs^Fds, Hh^Fds, Gs^Fds, Gs^Fds, Gs^Fds, Gg^Efm, Gg, Gg^Es, Gg^Es, Gs^Fds, Gs^Fds, Gs^Fds, Gs^Efm, Gg, Gg, Gg, Gg^Efm, Gg, Gg^Efm, Gg, Gg^Efm, Gg, Rp, Rp, Gs^Fds, Gg, Gs^Fds, Gs^Fds, Gs^Fds, Gg, Gg^Efm, Gg^Efm, Gg, Gg^Efm, Gs^Fds, Gg
Gs^Fds, Hh^Fds, Ce, Ce, Hh^Fds, Gs^Fds, Gs^Fds, Gg, Gg^Es, Gg, Gg^Efm, Gg^Es, Gg^Es, Gg, Gg^Es, Gg^Efm, Gs^Fds, Gs^Fds, Gg, Gg, Gg, Gg^Efm, Gg^Efm, Gg, Gg^Eff, Gg^Eff, Gg^Eff, Gg^Eff, Gg^Eff, Gg^Efm, Gg, Gg, Rp, Gg, Gg, Gs^Fds, Gs^Fds, Gs^Fds, Gs^Fds, Gs^Vl, Gg, Gg, Gg, Hh^Fds, Gs^Fds, Gg
Gs^Fds, Ce, Gg, Gs^Fds, Gs^Fds, Gs^Fds, Gs^Fds, Gg, Gg, Gg^Es, Gg, Gg, Hh^Fds, Gg^Es, Gg, Gg, Gs^Vl, Gs^Fds, Gs^Fds, Gg, Gg, Gg, Gg^Eff, Gg^Eff, Rb^Gvs, Rb^Gvs, Rb^Gvs, Rb^Gvs, Rb^Gvs, Gg^Eff, Gg, Rp, Gg, Gg, Gg, Gs^Fds, Gs^Fds, Gs^Fds, Gs^Fds, Gg, Gg, Gg, Gg, Gs^Fds, Hh^Fds, Hh^Fds
Gg, Gg^Es, Gg, Gs^Fds, Gs^Fds, Gs^Fds, Gs^Fds, Gs^Fds, Hh^Fds, Gg, Gg, Hh^Fds, Gs^Fds, Gs^Fds, Gg, Gg, Gs^Fds, Hh^Fds, Gg, Gg, Gg^Efm, Gg, Gg^Eff, Gg^Eff, Rb^Gvs, Rb^Vh, Rb^Gvs, Rb^Gvs, Gg, Gg, Rp, Rp, Gg^Eff, Gg, Gs^Fds, Gg, Gg, Gg, Gg, Gg, Gg, Gg, Hh^Fds, Hh^Fds, Gg, Gs^Fds
Gg, Gg^Es, Gg^Es, Gg, Gs^Vl, Gs^Fds, Gg, Hh^Fds, Gg, Gg, Gg, Hh^Fds, Gg, Gg, Gg, Gg, Gs^Fds, Gs^Fds, Gs^Fds, Gg, Gg, Gg^Eff, Gg^Eff, Rb^Gvs, Gg, Rb^Gvs, Gg, Gg, Rp, Rp, Gg, Gg, Gg^Eff, Gs^Eff, Hh^Fds, Hh^Fds, Gs^Fds, Gg, Gg, Gg, Gs^Fds, Gg, Gg, Gg, Gg, Gs^Fds
Gg, Gg, Gg, Gg, Gg^Efm, Gg, Gg^Efm, Gg, Gg^Efm, Gg^Efm, Gg^Efm, Gg^Efm, Gg^Es, Gg, Gg, Gg, Gg, Gg, Gg, Gg, Gg^Eff, Gg^Eff, Rb^Gvs, Rb^Gvs, Rb^Gvs, Gg, Gg^Wm, Rp, Rb^Gvs, Gg, Rb^Gvs, Gg^Eff, Gg^Eff, Gg, Gg, Gs^Fds, Gg, Gg, Gg^Es, Hh^Fds, Gs^Fds, Gs^Fds, Gg, Gg^Es, Gg, Gg
Hh^Fds, Gs^Fds, Gs^Fds, Gg, Gg^Es, Gg^Efm, Gg^Es, Gg^Es, Gg, Gg, Gg, Gg, Gg, Gg^Es, Gg, Gg, Gg^Efm, Gg, Gg^Efm, Gg^Eff, Gg^Eff, Rb^Gvs, Rb^Gvs, Rb^Vh, Rb^Gvs, Rb^Gvs, Rp, Rp, Rb^Gvs, Rb^Gvs, Rb^Vh, Rb^Gvs, Rb^Gvs, Gg^Eff, Gg^Eff, Gg, Gg, Gg^Efm, Gg, Gg, Gg, Gg, Gg, Gg, Gg, Gg
Hh^Fds, Hh^Fds, Hh^Fds, Gg, Gg^Es, Gg^Es, Gg^Es, Gg, Gs^Fds, Gg, Gs^Fds, Gg, Gs^Fds, Gg, Gg, Gg^Es, Gg^Efm, Gg, Gg, Gg^Eff, Gg^Eff, Rb^Gvs, Gg, Rb^Gvs, Gg, Gg, Ket, Gg, Gg, Rb^Gvs, Rb^Gvs, Rb^Gvs, Rb^Gvs, Gg^Eff, Gg^Eff, Gg^Es, Gs^Fds, Gs^Fds, Hh^Fds, Gg, Gg^Es, Gg, Hh^Fds, Gs^Vl, Hh^Fds, Gg
Hh^Fds, Hh^Fds, Gg, Gg, Gg^Es, Gg, Gg, Gg, Gs^Fds, Gg, Gg, Gs^Fds, Gs^Fds, Gs^Fds, Gg^Es, Gg^Es, Gg, Gg, Gg^Eff, Gg^Eff, Rb^Gvs, Rb^Gvs, Rb^Gvs, Gg, Gg, Ket, 1 Ket, Ket, Gg, Gg, Gg, Gg, Rb^Gvs, Gg^Eff, Gg^Eff, Gg, Hh^Fds, Hh^Fds, Hh^Fds, Gg, Gg^Es, Gg, Hh^Fds, Hh^Fds, Hh^Fds, Gg
Gg, Hh^Fds, Gg, Gg, Gg^Efm, Gg^Efm, Gg, Gg, Gg, Gg^Es, Gg^Es, Gs^Fds, Gs^Vl, Gg, Gg^Es, Gg, Gg^Eff, Gg^Eff, Gg, Gg, Rb^Gvs, Rb^Vh, Rb^Gvs, Rb^Gvs, Rb^Gvs, Ket, Ket, Ket, Gg, Gg, Rb^Gvs, Rb^Gvs, Rb^Vh, Rb^Gvs, Rb^Gvs, Gg^Eff, Gg^Eff, Gs^Fds, Gg, Gg, Gg^Efm, Gg, Gs^Fds, Hh^Fds, Gs^Fds, Gs^Fds
Gg, Hh^Fds, Gg, Gg^Efm, Gg, Gg, Hh^Fds, Gg, Gg, Gg, Gs^Fds, Gg, Gg, Gg^Es, Gs^Fds, Gs^Fds, Gg, Gg^Eff, Gg^Eff, Rb^Gvs, Rb^Gvs, Rb^Gvs, Rb^Gvs, Rb^Gvs, Rb^Vh, Rb^Gvs, Gg, Gg, Gg, Rb^Gvs, Rb^Gvs, Rb^Gvs, Rb^Gvs, Rb^Gvs, Gg^Eff, Gg^Eff, Gg, Gs^Fds, Gg, Gg, Gg, Hh^Fds, Hh^Fds, Hh^Fds, Hh^Fds, Gs^Fds
Gg, Gg, Gg, Gg, Gg^Efm, Gg, Gg, Hh^Fds, Gs^Fds, Gs^Fds, Gs^Fds, Gg, Gg, Gg, Gg, Hh^Fds, Gs^Fds, Gg, Gg, Gg^Eff, Gg^Eff, Gg^Eff, Gg^Eff, Rb^Gvs, Rb^Gvs, Rb^Gvs, Gg^Efm, Gg^Efm, Rb^Gvs, Gg, Rb^Gvs, Rb^Gvs, Gg^Eff, Gg^Eff, Gs^Fds, Gg, Gg^Es, Gg^Es, Gg^Es, Gg^Es, Gg^Es, Gg, Gg, Gs^Fds, Hh^Fds, Gs^Fds
Gg, Gg, Gg^Es, Gg^Efm, Gg^Efm, Gg, Gg, Gs^Vl, Gs^Fds, Gs^Fds, Hh^Fds, Gg, Gg^Efm, Gg^Es, Gg, Gs^Fds, Gs^Fds, Gs^Fds, Gs^Fds, Gg, Gg, Gg, Gg, Gg^Eff, Gg^Eff, Gg, Gg^Es, Gg^Efm, Rb^Gvs, Rb^Gvs, Rb^Vh, Rb^Gvs, Gg, Gg^Eff, Gg^Eff, Gs^Fds, Gg^Es, Gg, Gs^Fds, Gg, Gg^Es, Gg^Es, Gg, Gs^Vl, Gg, Gs^Fds
Gg, Gg, Gg^Es, Gg, Gg, Gg^Es, Gg, Gg, Gg^Efm, Gg, Gg, Gg, Gs^Fds, Gg, Gg, Gs^Fds, Gs^Fds, Gs^Fds, Gs^Fds, Gs^Fds, Gs^Fds, Gs^Fds, Gs^Fds, Gg, Gs^Fds, Gg^Eff, Gg^Eff, Gg, Rb^Gvs, Rb^Gvs, Rb^Gvs, Rb^Gvs, Gg^Eff, Gg^Eff, Gg, Gs^Fds, Gs^Fds, Gs^Fds, Hh^Fds, Gs^Fds, Gg, Gg^Es, Gg^Es, Gg, Gg, Gg
Gg, Gg^Efm, Gg, Gg, Gs^Fds, Gg, Hh^Fds, Gg^Es, Gg, Gg^Efm, Gg^Es, Gg, Gg, Gs^Fds, Gs^Fds, Gg^Efm, Gg^Efm, Gs^Fds, Gg, Gs^Fds, Gs^Fds, Gs^Fds, Gs^Fds, Gs^Fds, Gg, Gg^Efm, Gg^Efm, Gg^Eff, Gg^Eff, Gg, Gg^Eff, Gg^Eff, Gs^Fds, Gg, Gg, Gs^Vl, Gg, Hh^Fds, Gg, Gg, Gg, Gg^Efm, Gg^Efm, Gg, Gg, Gg
Gg, Gg^Es, Gg, Gg, Gs^Fds, Hh^Fds, Gs^Fds, Hh^Fds, Hh^Fds, Gg^Es, Gg^Es, Gg, Gs^Fds, Gs^Fds, Gs^Vl, Gg^Es, Gg^Es, Gg^Efm, Gg, Gs^Fds, Gg, Gg, Gg, Gg, Gg, Gg, Gg, Gg, Gg, Gg^Eff, Gg, Gg, Gs^Fds, Gs^Fds, Gg, Gg, Gg, Gg, Gg, Gg, Gg, Gg, Gg, Gg, Gg, Gg
Gg^Es, Gg^Es, Gg, Gg, Gs^Fds, Gs^Fds, Hh^Fds, Gs^Fds, Hh^Fds, Gg^Efm, Gg^Efm, Hh^Fds, Hh^Fds, Hh^Fds, Gs^Fds, Gg, Gg, Gg, Gg, Gg, Gg, Gg, Gg, Gg, Gg, Gg, Gg, Gs^Fds, Gs^Fds, Gg, Gg, Gg, Hh^Fds, Gs^Fds, Hh^Fds, Gg, Gg, Gg^Es, Gs^Vl, Gg, Gg, Gs^Fds, Hh^Fds, Gg, Gg, Gg
Gg, Gg, Gg, Gs^Vl, Gs^Fds, Hh^Fds, Hh^Fds, Hh^Fds, Gg, Gg, Gg, Gg, Gs^Fds, Hh^Fds, Hh^Fds, Hh^Fds, Hh^Fds, Gg, Gg, Gg, Gg^Efm, Gg^Efm, Gg^Efm, Gg, Gg, Gg, Gs^Fds, Gs^Fds, Hh^Fds, Gs^Fds, Gs^Fds, Gg, Hh^Fds, Gs^Fds, Gs^Fds, Gs^Fds, Gg, Gg, Hh^Fds, Hh^Fds, Gg, Hh^Fds, Gg, Gg^Efm, Gg^Efm, Gg
Gg, Gg^Es, Gg, Gs^Fds, Gs^Fds, Gs^Fds, Gs^Fds, Gg, Gg, Gg^Efm, Gg, Gs^Fds, Gs^Fds, Gs^Fds, Gs^Fds, Hh^Fds, Gs^Fds, Gg, Gg, Gg, Gg^Efm, Gg, Gg^Efm, Gg, Gg, Gs^Fds, Gs^Fds, Gs^Fds, Hh^Fds, Hh^Fds, Gs^Fds, Gg, Gg, Hh^Fds, Gs^Fds, Gs^Fds, Gg^Efm, Gg, Hh^Fds, Gg, Gg, Gg^Es, Gg, Gg^Efm, Gs^Fds, Gg
Gg^Es, Gg^Es, Gg^Es, Gg, Gg, Gs^Fds, Gg, Gg, Gg^Es, Gg^Efm, Gg, Gg, Gs^Fds, Gs^Fds, Gs^Fds, Gs^Fds, Gs^Fds, Gs^Vl, Gg, Gg^Efm, Gg, Gg, Gg, Gg, Gg, Gg, Gs^Vl, Gs^Fds, Gs^Fds, Hh^Fds, Gs^Fds, Gs^Fds, Gg, Gg, Gg, Gg, Gg, Hh^Fds, Gg, Gg, Gg, Gg^Efm, Gg, Gg, Gs^Fds, Gs^Fds
Gg^Es, Gg^Es, Gg^Es, Gg^Es, Gg^Es, Gg^Es, Gg^Es, Gg, Gg^Efm, Gg, Gg, Gg, Gg, Gg, Gg, Gs^Fds, Gs^Fds, Gg, Gg, Gg, Gg, Gg^Es, Gg^Es, Gg^Efm, Gg^Efm, Gg, Gg, Gs^Fds, Gg, Gg, Gg, Gg, Gg^Es, Gg^Es, Gg, Gg, Gg, Gg, Gg, Gs^Fds, Gs^Fds, Gg, Gg^Es, Hh^Fds, Gs^Fds, Gs^Fds
Gg, Gg, Hh^Fds, Gg^Es, Gg, Gg, Gg, Gg^Es, Gg^Es, Gg^Efm, Gg, Gg, Gg^Efm, Gg, Gg^Efm, Gg, Gg, Gg, Gg, Gg, Gg, Gg, Gg^Es, Gg^Es, Gg^Efm, Gg, Gg^Efm, Gg, Gg, Gg^Efm, Gg^Efm, Gg, Gg^Efm, Gg^Es, Gg, Gg, Gg^Es, Gg, Gg, Gg, Gg, Gg, Gg^Efm, Gs^Vl, Hh^Fds, Hh^Fds
Gg, Gg, Hh^Fds, Hh^Fds, Hh^Fds, Gg, Gg, Gg, Gg^Efm, Gg^Efm, Gg, Gg, Gg, Gg^Efm, Gg^Efm, Gg^Efm, Gg^Es, Gg^Es, Gg^Es, Gg, Gg, Gg, Gg, Gg^Es, Gg, Gg^Efm, Gg, Gg, Gs^Fds, Gg, Gg, Gg, Gg, Gg, Gg^Efm, Gg^Efm, Gg^Efm, Gg^Efm, Gg^Efm, Gg, Gg, Gg^Efm, Gg^Efm, Gg, Gg, Gg
Hh^Fds, Gg, Gs^Fds, Hh^Fds, Gs^Fds, Gg, Gg, Gg, Gg^Efm, Gg^Efm, Gg, Gg, Gg, Gs^Fds, Gs^Fds, Gs^Vl, Gs^Fds, Gg^Es, Gg, Gg^Efm, Gg, Gg^Es, Gg, Gg, Gs^Vl, Gg, Gg, Gs^Fds, Gs^Fds, Hh^Fds, Hh^Fds, Gg, Gs^Vl, Gg, Gg, Gg, Ce, Ce, Ce, Ce, Ce, Gg, Gs^Fds, Gs^Fds, Hh^Fds, Gg
Hh^Fds, Gs^Fds, Gs^Fds, Gs^Fds, Hh^Fds, Gs^Vl, Gg, Gg, Gg^Es, Gg^Efm, Gg, Gg, Hh^Fds, Gs^Fds, Gs^Fds, Gs^Fds, Gs^Fds, Hh^Fds, Gg, Gg, Gg, Gg^Es, Gg^Efm, Gg, Gs^Fds, Gs^Fds, Gs^Fds, Gs^Fds, Hh^Fds, Gs^Fds, Hh^Fds, Gs^Fds, Gs^Fds, Gg, Gg, Ce, Ce, Ce, Ce, Ce, Ce, Hh^Fds, Hh^Fds, Hh^Fds, Hh^Fds, Gs^Fds
Hh^Fds, Hh^Fds, Gs^Fds, Gs^Fds, Gs^Fds, Gs^Fds, Hh^Fds, Gg, Gg^Es, Gg, Gg, Hh^Fds, Hh^Fds, Hh^Fds, Hh^Fds, Gs^Fds, Gs^Fds, Gs^Fds, Hh^Fds, Gg, Gg, Gg, Gg^Efm, Gg, Gs^Fds, Gs^Fds, Hh^Fds, Hh^Fds, Hh^Fds, Gs^Fds, Gs^Fds, Gs^Fds, Gs^Fds, Hh^Fds, Gs^Fds, Gs^Fds, Gg, Ce, Ce, 5 Ke, Hh^Fds, Hh^Fds, Hh^Fds, Hh^Fds, Gs^Fds, Gs^Fds
Hh^Fds, Hh^Fds, Gg, Hh^Fds, Hh^Fds, Gs^Fds, Gg, Gg, Gg, Gg^Es, Gg, Hh^Fds, Hh^Fds, Hh^Fds, Hh^Fds, Hh^Fds, Gs^Fds, Hh^Fds, Gg, Hh^Fds, Gg, Gg, Gg, Gs^Fds, Gs^Fds, Gs^Fds, Gg, Hh^Fds, Gg, Gs^Fds, Gs^Fds, Gs^Fds, Gs^Fds, Gs^Fds, Gs^Fds, Gs^Fds, Gg, Gg, Gg, Gs^Fds, Gg, Hh^Fds, Gg, Hh^Fds, Gs^Fds, Gs^Fds
