border_size=1
usage=map

Gs^Fds, Gg, Gs^Fds, Gg, Gs^Fds, Gs^Fds, Gs^Fds, Gs^Fds, Gs^Fds, Gg, Gs^Fds, Gg, Gg^Efm, Gg, Gs^Fds, Gs^Fds, Gs^Fds, Gg, Gg, Gg, Gg, Gg, Gg, Gg, Gs^Fds, Gs^Fds, Gs^Fds, Gs^Fds, Gs^Fds, Gg, Ww, Gg, Gg, Gg, Rb^Gvs, Gg, Gg, Gg, Gg^Es, Gg, Gg, Gg, Gg, Gg, Gg, Gg
Gs^Fds, Gs^Fds, Gs^Fds, Gs^Fds, Gs^Fds, Gs^Fds, Gg, Gs^Fds, Gg, Gg^Efm, Gs^Fds, Gg, Gs^Fds, Gs^Fds, Gs^Fds, Gs^Fds, Gs^Fds, Gs^Fds, Gg, Gg^Efm, Gg, Gg, Gg^Efm, Gg, Gs^Fds, Gs^Fds, Gs^Fds, Gs^Fds, Gs^Fds, Gg^Es, Ww, Gg, Gg, Rb^Gvs, Rb^Gvs, Rb^Gvs, Rb^Gvs, Gg, Rb^Vh, Gg, Rb^Gvs, Rb^Gvs, Rb^Vh, Rb^Gvs, Gg, Gg^Es
Gs^Fds, Gs^Fds, Gg, Rb^Gvs, Gg, Gs^Fds, Gg, Gs^Fds, Gs^Fds, Gs^Fds, Gs^Fds, Gs^Fds, Gs^Fds, Gs^Fds, Gs^Fds, Gs^Fds, Gs^Fds, Gs^Fds, Gs^Fds, Gg, Gg^Em, Gs^Vl, Gg, Gg, Gs^Fds, Gs^Fds, Gs^Fds, Gs^Fds, Gg, Gg, Ww^Edt, Gg^Em, Gg^Es, Rb^Gvs, Rb^Gvs, Rb^Vh, Rb^Gvs, Rb^Gvs, Rb^Gvs, Rb^Gvs, Rb^Gvs, Rb^Gvs, Rb^Gvs, Rb^Gvs, Gg, Gg
Gs^Fds, Gs^Fds, Gs^Fds, Rb^Gvs, Rb^Gvs, Gg^Efm, Gg, Gg^Em, Rb^Gvs, Rb^Gvs, Rb^Gvs, Gs^Fds, Gs^Fds, Gs^Fds, Gs^Fds, Gs^Fds, Gs^Fds, Gs^Fds, Gs^Fds, Gs^Fds, Gs^Fds, Gs^Fds, Gs^Fds, Gs^Fds, Gs^Fds, Gs^Fds, Gg, Gg^Em, Gg, Gg, Gg^Es, Ww, Ww, Gg, Gg, Rb^Gvs, Rb^Vh, Rb^Gvs, Ket, Ket, Ket, Rb^Gvs, Rb^Gvs, Rb^Gvs, Gg, Gg
Gs^Fds, Gs^Fds, Gg^Em, Gg, Rb^Gvs, Rb^Vh, Rb^Gvs, Rb^Gvs, Rb^Gvs, Rb^Gvs, Rb^Gvs, Gs^Fds, Gs^Fds, Gs^Fds, Gg, Gs^Fds, Gg, Gs^Fds, Gs^Fds, Gs^Fds, Gg^Efm, Gs^Fds, Gs^Fds, Gs^Fds, Gg^Efm, Gg^Efm, Gg, Gg^Es, Gg^Es, Gg^Es, Gg, Gg, Gg, Ww, Gg, Rb^Gvs, Rb^Gvs, Rb^Gvs, Rb^Gvs, Ket, Rb^Gvs, Rb^Gvs, Rb^Gvs, Rb^Vh, Gg, Gg
Gs^Fds, Gg, Gg^Es, Gg, Gg, Rb^Gvs, Ket, Rb^Gvs, Rb^Gvs, Rb^Vh, Gs^Fds, Gs^Fds, Gg^Es, Gg, Gg^Es, Gs^Vl, Gg, Gg^Es, Gs^Fds, Gs^Fds, Gs^Fds, Gs^Fds, Gg, Gg, Gg, Gg, Gs^Fds, Gg, Gg, Gg, Gg, Gg^Es, Gg, Ww, Ww, Gg^Es, Gg, Rb^Gvs, Rb^Gvs, Rb^Gvs, Rb^Vh, Rb^Gvs, Gg, Gg, Gg^Efm, Gg
Gs^Fds, Gs^Fds, Rb^Gvs, Rb^Gvs, Rb^Gvs, Ket, Gg^Em, Rb^Gvs, Rb^Gvs, Gg^Es, Gs^Fds, Gs^Fds, Gs^Fds, Gg, Gg, Gg^Em, Gs^Fds, Gs^Fds, Gs^Fds, Gs^Fds, Gs^Fds, Gs^Fds, Gs^Fds, Gs^Fds, Gs^Fds, Gs^Fds, Gs^Fds, Gs^Fds, Gs^Fds, Gg, Gs^Vl, Gg, Gg, Gg, Gg, Ww, Ww, Rb^Gvs, Rb^Vh, Rb^Gvs, Rb^Gvs, Rb^Gvs, Gg, Gg^Es, Gg^Efm, Gg
Gs^Fds, Gs^Fds, Gs^Fds, Rb^Gvs, Rb^Gvs, Rb^Vh, Rb^Gvs, Gg, Gg^Es, Rb^Gvs, Gs^Fds, Gs^Fds, Gs^Fds, Gg, Gs^Fds, Gg, Gs^Fds, Gs^Fds, Gs^Fds, Gs^Fds, Gg, Gg^Efm, Gs^Fds, Gs^Fds, Gs^Fds, Gs^Fds, Gs^Fds, Gs^Fds, Gs^Fds, Gs^Fds, Gg, Gg, Gg^Es, Gg^Es, Gg^Es, Gg, Ww^Edt, Rb^Gvs, Rb^Gvs, Rb^Gvs, Rb^Gvs, Rb^Gvs, Gg^Es, Gg^Efm, Gg, Gg
Gs^Fds, Gs^Fds, Gs^Fds, Gs^Fds, Gs^Fds, Rb^Gvs, Rb^Gvs, Rb^Gvs, Rb^Gvs, Rb^Gvs, Gs^Fds, Gs^Fds, Gs^Fds, Gs^Fds, Gs^Fds, Gs^Fds, Gg, Gg^Em, Gg, Gs^Fds, Gs^Fds, Gg, Gs^Fds, Gs^Fds, Gs^Fds, Gs^Fds, Gs^Fds, Gs^Fds, Gs^Fds, Gs^Fds, Gs^Fds, Gg, Gg, Gg^Em, Gg, Gg, Gg, Ww, Gg, Rb^Gvs, Gg, Gg, Gg^Es, Gg, Gs^Fds, Gs^Fds
Gs^Fds, Gs^Fds, Gs^Fds, Gs^Fds, Gs^Fds, Gs^Fds, Gs^Fds, Rb^Gvs, Gs^Fds, Rb^Gvs, Gs^Fds, Gs^Fds, Gs^Fds, Gs^Fds, Gs^Fds, Gg^Es, Gg, Gg, Gg^Es, Gg, Gs^Fds, Gs^Fds, Gs^Fds, Gs^Fds, Gs^Fds, Gs^Fds, Gs^Fds, Gs^Fds, Gs^Fds, Gs^Fds, Gs^Fds, Gs^Fds, Gs^Fds, Gg, Gs^Fds, Gs^Fds, Gs^Fds, Ww, Gg, Gg^Es, Gs^Fds, Gs^Fds, Gs^Fds, Gs^Fds, Hh^Fds, Hh^Fds
Hh^Fds, Gs^Fds, Hh^Fds, Gs^Fds, Gs^Fds, Gs^Fds, Gs^Fds, Gs^Fds, Gs^Fds, Gs^Fds, Gs^Fds, Gs^Fds, Gs^Fds, Gs^Fds, Gs^Fds, Gs^Fds, Gs^Fds, Gg, Gs^Fds, Gs^Fds, Gs^Fds, Gs^Fds, Gs^Fds, Gs^Fds, Gs^Fds, Gs^Fds, Gs^Fds, Gs^Fds, Gs^Fds, Gs^Fds, Gs^Fds, Gs^Fds, Gs^Fds, Gs^Fds, Gs^Fds, Gs^Fds, Gs^Fds, Ww, Ww, Gg, Gg, Gs^Fds, Hh^Fds, Hh^Fds, Mm^Fds, Gs^Fds
Hh^Fds, Hh^Fds, Hh^Fds, Hh^Fds, Hh^Fds, Hh^Fds, Hh^Fds, Gs^Fds, Gs^Fds, Gs^Fds, Hh^Fds, Hh^Fds, Hh^Fds, Hh^Fds, Hh^Fds, Gs^Fds, Hh^Fds, Gs^Fds, Gs^Fds, Gs^Fds, Hh^Fds, Hh^Fds, Hh^Fds, Hh^Fds, Hh^Fds, Gs^Fds, Hh^Fds, Hh^Fds, Hh^Fds, Gs^Fds, Hh^Fds, Hh^Fds, Hh^Fds, Gs^Fds, Hh^Fds, Gs^Fds, Hh^Fds, Hh^Fds, Hh^Fds, Ww, Gg, Gs^Fds, Hh^Fds, Mm^Fds, Hh^Fds, Mm^Fds
Mm^Fds, Mm^Fds, Mm^Fds, Mm^Fds, Mm^Fds, Hh^Fds, Hh^Fds, Hh^Fds, Hh^Fds, Hh^Fds, Hh^Fds, Hh^Fds, Hh^Fds, Hh^Fds, Mm^Fds, Hh^Fds, Hh^Fds, Hh^Fds, Hh^Fds, Hh^Fds, Hh^Fds, Hh^Fds, Mm^Fds, Hh^Fds, Mm^Fds, Hh^Fds, Hh^Fds, Hh^Fds, Mm^Fds, Hh^Fds, Mm^Fds, Mm^Fds, Mm^Fds, Hh^Fds, Mm^Fds, Hh^Fds, Mm^Fds, Mm^Fds, Hh^Fds, Ww, Ww, Gs^Fds, Gg, Gs^Fds, Gs^Fds, Hh^Fds
Mm^Fds, Mm^Fds, Mm^Xm, Mm^Fds, Mm^Fds, Mm^Fds, Mm^Fds, Hh^Fds, Mm^Fds, Hh^Fds, Mm^Fds, Mm^Fds, Mm^Fds, Mm^Fds, Mm^Fds, Mm^Fds, Mm^Fds, Mm^Fds, Mm^Fds, Hh^Fds, Mm^Fds, Hh^Fds, Mm^Fds, Mm^Fds, Mm^Fds, Mm^Fds, Mm^Fds, Mm^Fds, Mm^Fds, Mm^Fds, Mm^Fds, Mm^Fds, Mm^Xm, Mm^Fds, Mm^Fds, Mm^Fds, Mm^Fds, Mm^Fds, Hh^Fds, Gs^Fds, Ww^Edt, Gg, Gg^Em, Gg^Es, Gg, Gg
Mm^Xm, Mm^Xm, Mm^Xm, Mm^Xm, Mm^Xm, Mm^Fds, Mm^Fds, Mm^Fds, Mm^Fds, Mm^Fds, Mm^Xm, Mm^Fds, Mm^Xm, Mm^Xm, Mm^Xm, Mm^Xm, Mm^Xm, Mm^Fds, Mm^Xm, Mm^Fds, Mm^Fds, Mm^Fds, Mm^Fds, Mm^Xm, Mm^Xm, Mm^Xm, Mm^Xm, Mm^Fds, Mm^Xm, Mm^Xm, Mm^Xm, Mm^Xm, Mm^Xm, Mm^Xm, Mm^Fds, Mm^Fds, Hh^Fds, Hh^Fds, Gs^Fds, Gs^Fds, Gg^Es, Ww, Ww, Ww, Ww, Ww
Mm^Xm, Mm^Xm, Mm^Xm, Mm^Xm, Mm^Xm, Mm^Xm, Mm^Xm, Mm^Xm, Mm^Xm, Mm^Xm, Mm^Xm, Mm^Xm, Mm^Xm, Mm^Xm, Mm^Xm, Mm^Xm, Mm^Xm, Mm^Xm, Mm^Xm, Mm^Xm, Mm^Xm, Mm^Xm, Mm^Xm, Mm^Xm, Mm^Xm, Mm^Xm, Mm^Xm, Mm^Xm, Mm^Xm, Mm^Xm, Mm^Xm, Mm^Xm, Mm^Xm, Mm^Xm, Mm^Fds, Mm^Fds, Hh^Fds, Hh^Fds, Gs^Fds, Gg, Ww^Edt, Ww, Gg, Gs^Vl, Gg^Es, Gg
Mm^Xm, Mm^Xm, Mm^Fds, Mm^Fds, Mm^Xm, Mm^Xm, Mm^Xm, Mm^Xm, Mm^Xm, Mm^Xm, Mm^Xm, Mm^Xm, Mm^Xm, Mm^Xm, Mm^Xm, Mm^Xm, Mm^Fds, Mm^Xm, Mm^Xm, Mm^Xm, Mm^Xm, Mm^Xm, Mm^Xm, Mm^Xm, Mm^Xm, Mm^Xm, Mm^Xm, Mm^Xm, Mm^Xm, Mm^Xm, Mm^Fds, Mm^Xm, Mm^Fds, Mm^Fds, Hh^Fds, Mm^Fds, Hh^Fds, Gs^Fds, Ww, Ww, Gg, Gg, Gg, Gg, Gg, Gg
Mm^Fds, Mm^Xm, Mm^Fds, Mm^Fds, Mm^Fds, Mm^Xm, Mm^Fds, Mm^Fds, Mm^Fds, Mm^Xm, Mm^Fds, Mm^Fds, Mm^Fds, Mm^Fds, Mm^Fds, Mm^Fds, Mm^Fds, Mm^Fds, Mm^Xm, Mm^Xm, Mm^Xm, Mm^Xm, Mm^Fds, Mm^Xm, Mm^Xm, Mm^Xm, Mm^Fds, Mm^Fds, Mm^Fds, Mm^Fds, Mm^Fds, Mm^Fds, Hh^Fds, Hh^Fds, Gg, Hh^Fds, Hh^Fds, Gs^Fds, Ww, Gg^Em, Gg, Gg^Es, Gs^Fds, Gs^Fds, Gs^Fds, Gs^Fds
Hh^Fds, Mm^Fds, Mm^Fds, Mm^Fds, Hh^Fds, Mm^Fds, Hh^Fds, Mm^Fds, Mm^Fds, Mm^Fds, Hh^Fds, Mm^Fds, Mm^Fds, Mm^Fds, Hh^Fds, Mm^Fds, Hh^Fds, Mm^Fds, Mm^Fds, Mm^Fds, Mm^Fds, Mm^Fds, Mm^Fds, Mm^Xm, Mm^Xm, Hh^Fds, Hh^Fds, Hh^Fds, Hh^Fds, Hh^Fds, Hh^Fds, Hh^Fds, Hh^Fds, Hh^Fds, Gg, Hh^Fds, Ww, Ww, Gg, Gg, Gg, Gg, Gs^Fds, Gs^Fds, Gs^Fds, Gs^Fds
Hh^Fds, Hh^Fds, Gs^Fds, Hh^Fds, Gs^Fds, Hh^Fds, Hh^Fds, Hh^Fds, Hh^Fds, Hh^Fds, Hh^Fds, Hh^Fds, Hh^Fds, Hh^Fds, Hh^Fds, Hh^Fds, Hh^Fds, Hh^Fds, Gs^Fds, Mm^Fds, Hh^Fds, Hh^Fds, Hh^Fds, Mm^Fds, Mm^Xm, Hh^Fds, Hh^Fds, Hh^Fds, Gs^Fds, Hh^Fds, Gg, Hh^Fds, Gg, Gg^Es, Ww, Ww, Gs^Fds, Gs^Fds, Gs^Fds, Gg^Efm, Gs^Fds, Gs^Fds, Gs^Fds, Gs^Fds, Gs^Fds, Gg
Gs^Fds, Gs^Fds, Gs^Fds, Gs^Fds, Gs^Fds, Gs^Fds, Gs^Fds, Gg^Es, Gg, Hh^Fds, Gs^Fds, Hh^Fds, Gg, Hh^Fds, Gg, Gs^Fds, Gs^Fds, Gs^Fds, Gs^Fds, Hh^Fds, Gs^Fds, Hh^Fds, Hh^Fds, Mm^Fds, Mm^Fds, Mm^Fds, Hh^Fds, Gs^Fds, Gs^Fds, Gs^Fds, Gs^Fds, Gs^Fds, Gs^Fds, Ww, Gg, Gg, Gs^Fds, Gs^Fds, Gg, Gs^Fds, Gs^Fds, Gg, Gg, Gs^Fds, Gg^Es, Gg
Ww, Ww, Ww, Gs^Fds, Ww, Gs^Fds, Gs^Fds, Gg, Gs^Fds, Gs^Fds, Gs^Fds, Gs^Fds, Gs^Fds, Gs^Fds, Gs^Fds, Gg^Efm, Gs^Fds, Gs^Fds, Gs^Fds, Gs^Fds, Gs^Fds, Hh^Fds, Hh^Fds, Hh^Fds, Hh^Fds, Mm^Fds, Hh^Fds, Hh^Fds, Gs^Fds, Gs^Fds, Gg, Gs^Fds, Gs^Fds, Ww, Gs^Fds, Gg, Gg^Efm, Gg, Gs^Vl, Gg, Gg, Gg^Efm, Gg, Gg, Gs^Fds, Gg
Gs^Fds, Gs^Fds, Gs^Fds, Ww, Gs^Fds, Ww, Ww, Gs^Fds, Gg^Efm, Gs^Fds, Gs^Fds, Gs^Fds, Gg^Es, Gg, Gs^Fds, Gs^Fds, Gg, Gs^Fds, Gg, Gs^Fds, Gs^Fds, Gs^Fds, Gs^Fds, Gs^Fds, Hh^Fds, Mm^Fds, Hh^Fds, Gs^Fds, Gs^Fds, Gs^Fds, Gg^Efm, Gs^Fds, Gs^Fds, Ww, Gs^Fds, Gg, Gg, Gg, Gg, Gg^Em, Gs^Fds, Gs^Fds, Gs^Fds, Gs^Fds, Gs^Fds, Gs^Fds
Gs^Fds, Gs^Fds, Gs^Fds, Gg, Gs^Fds, Gs^Fds, Gs^Fds, Ww, Ww, Ww, Ww, Gg, Ww, Gs^Fds, Gs^Fds, Gg^Em, Ww, Gg^Efm, Gg, Gs^Fds, Rr, Gs^Fds, Gs^Fds, Gs^Fds, Gs^Vl, Gg, Ww, Gs^Fds, Rr, Rr, Rr, Gg, Ww, Ww, Gg^Es, Gg, Gs^Fds, Gg, Gs^Fds, Gs^Fds, Gs^Fds, Gs^Fds, Gs^Fds, Gs^Fds, Gs^Fds, Gs^Fds
Gs^Fds, Gs^Fds, Rb^Gvs, Gg^Efm, Gs^Fds, Gs^Fds, Gs^Fds, Gs^Fds, Gg^Efm, Gg, Gs^Fds, Ww, Gs^Fds, Ww, Ww, Ww, Gs^Fds, Ww, Ww^Edt, Rr, Gs^Fds, Rr, Rr, Gg^Es, Ww, Ww, Gg^Es, Ww^Edt, Ww, Gs^Fds, Ww, Ww^Edt, Rr, Gg, Gg, Rb^Gvs, Rb^Gvs, Gs^Fds, Gs^Fds, Gs^Fds, Gs^Fds, Gs^Fds, Gs^Fds, Gs^Fds, Gs^Fds, Gs^Fds
Gg, Rb^Gvs, Gs^Vh, Rb^Gvs, Rb^Gvs, Gs^Fds, Gs^Fds, Gs^Fds, Rb^Gvs, Gg, Rb^Gvs, Gs^Fds, Gs^Fds, Gs^Fds, Gs^Fds, Gs^Fds, Rr, Rr, Ww, Gg^Es, Gs^Fds, Gs^Fds, Gs^Fds, Rr, Ww^Edt, Rr, Rr, Rr, Gs^Fds, Ww, Gs^Fds, Gg, Gg, Rr, Rr, Rb^Vh, Rb^Gvs, Rb^Gvs, Gs^Fds, Gs^Fds, Gg, Gs^Fds, Gg, Gs^Fds, Gg^Es, Gg
Rb^Gvs, Rb^Gvs, Rb^Gvs, Rb^Gvs, Gg, Gg, Rb^Gvs, Rb^Gvs, Rb^Vh, Rb^Gvs, Rb^Gvs, Rb^Gvs, Rb^Vh, Rb^Gvs, Rr, Rr, Gs^Fds, Gs^Fds, Gs^Fds, Ww, Ww, Gs^Fds, Ww, Ww, Hh^Fds, Gs^Fds, Gs^Fds, Gg, Gg^Efm, Ww, Ww, Gg^Efm, Gs^Fds, Gs^Fds, Rb^Gvs, Rr, Rb^Gvs, Rb^Gvs, Rb^Gvs, Gs^Fds, Rb^Gvs, Rb^Vh, Rb^Gvs, Rb^Gvs, Rb^Gvs, Gg
Rb^Gvs, Rb^Gvs, Gg^Es, Gg, Ket, Ket, Ket, Rb^Gvs, Rb^Gvs, Rb^Gvs, Rb^Gvs, Rb^Gvs, Rr, Rr, Gs^Fds, Gs^Fds, Gs^Fds, Gs^Fds, Gs^Fds, Gs^Fds, Gs^Fds, Ww, Gs^Fds, Gs^Fds, Gs^Vl, Hh^Fds, Hh^Fds, Gs^Fds, Gs^Fds, Gg, Ww, Gg, Gs^Fds, Gs^Fds, Gs^Fds, Gs^Fds, Rb^Gvs, Rb^Gvs, Ket, Ket, Ket, Rb^Gvs, Rb^Gvs, Rb^Gvs, Rb^Gvs, Gg
Rb^Gvs, Rb^Gvs, Rb^Gvs, Ket, Ket, Ket, Ket, Ket, Rb^Gvs, Rb^Gvs, Rb^Vh, Rr, Rb^Gvs, Gg^Es, Gs^Fds, Gs^Fds, Gg^Em, Gg^Efm, Gg, Gs^Fds, Gs^Fds, Gs^Fds, Gs^Fds, Gs^Fds, Hh^Fds, Gs^Fds, Hh^Fds, Gs^Fds, Gs^Fds, Gs^Fds, Ww, Gs^Fds, Gg, Gs^Fds, Gs^Fds, Gg^Es, Rb^Vh, Rb^Gvs, Rb^Gvs, Ket, Rb^Gvs, Rb^Gvs, Gs^Fds, Rb^Gvs, Gg, Gg
Rb^Gvs, Rb^Vh, Rb^Gvs, Gg, Gg, Ket, Gg^Efm, Gg, Rb^Gvs, Rb^Gvs, Rb^Gvs, Rb^Gvs, Rb^Gvs, Gs^Fds, Gs^Fds, Gs^Fds, Gg, Gs^Fds, Gs^Fds, Gs^Fds, Gg^Es, Gs^Fds, Gs^Fds, Gs^Fds, Hh^Fds, Hh^Fds, Hh^Fds, Gs^Fds, Gs^Fds, Gg, Gg^Es, Ww, Ww, Gg, Gg, Rb^Gvs, Rb^Gvs, Rb^Gvs, Rb^Gvs, Rb^Gvs, Rb^Gvs, Gs^Fds, Gs^Fds, Gs^Fds, Gs^Fds, Gg
Rb^Gvs, Rb^Gvs, Rb^Gvs, Ket, Gg, Gg, Gg, Ket, Rb^Gvs, Rb^Gvs, Rb^Gvs, Rb^Gvs, Rb^Gvs, Gg^Efm, Gs^Fds, Gs^Fds, Gs^Fds, Gs^Fds, Gs^Fds, Gs^Fds, Gs^Fds, Gs^Fds, Gs^Fds, Gs^Fds, Gs^Fds, Hh^Fds, Hh^Fds, Hh^Fds, Hh^Fds, Gs^Fds, Gs^Fds, Gs^Fds, Gs^Fds, Ww, Gg, Gg^Efm, Gs^Fds, Gs^Fds, Rb^Gvs, Rb^Vh, Gs^Fds, Gs^Fds, Gs^Fds, Gs^Fds, Gs^Fds, Gs^Fds
Rb^Gvs, Rb^Gvs, Rb^Gvs, Gg, Rb^Gvs, 1 Ket, Gg, Gg, Rb^Gvs, Rb^Gvs, Rb^Gvs, Rb^Vh, Rb^Gvs, Rb^Gvs, Gg^Es, Gs^Fds, Gs^Fds, Gs^Fds, Gs^Fds, Gg, Gg, Gs^Fds, Gs^Fds, Gs^Fds, Gs^Fds, Gs^Fds, Hh^Fds, Hh^Fds, Hh^Fds, Gs^Fds, Gs^Fds, Gs^Fds, Gs^Fds, Ww, Ww, Gs^Fds, Gs^Fds, Gs^Fds, Gs^Fds, Rb^Gvs, Gs^Fds, Gs^Fds, Gs^Fds, Gs^Fds, Gs^Fds, Gs^Fds
Rb^Gvs, Rb^Vh, Rb^Gvs, Rb^Gvs, Rb^Gvs, Gg, Rb^Gvs, Rb^Gvs, Rb^Vh, Rb^Gvs, Rb^Gvs, Rb^Gvs, Gg^Wm, Rb^Gvs, Gs^Fds, Gs^Fds, Gg^Efm, Gg, Gg, Gg, Gg^Es, Gg, Gs^Fds, Gs^Fds, Hh^Fds, Hh^Fds, Hh^Fds, Hh^Fds, Hh^Fds, Gs^Fds, Gs^Fds, Gs^Fds, Gs^Fds, Gs^Fds, Gs^Fds, Ww, Gs^Fds, Gs^Fds, Gs^Fds, Gs^Fds, Gs^Fds, Gs^Fds, Gg, Gg, Gg^Em, Gg^Em
Rb^Gvs, Rb^Gvs, Rb^Gvs, Rb^Vh, Rb^Gvs, Rb^Gvs, Rb^Vh, Rb^Gvs, Rb^Gvs, Rb^Gvs, Rb^Vh, Rb^Gvs, Gg, Gs^Fds, Gs^Fds, Gg, Gs^Fds, Gg, Gs^Fds, Gg, Gs^Fds, Gs^Fds, Gs^Fds, Hh^Fds, Hh^Fds, Hh^Fds, Hh^Fds, Hh^Fds, Hh^Fds, Gs^Fds, Gs^Fds, Gs^Fds, Gs^Fds, Gs^Fds, Gs^Fds, Ww, Gg, Gs^Fds, Gs^Fds, Gs^Fds, Gs^Fds, Gg, Gg, Gg^Em, Gg^Em, Gg^Em
Gg, Rb^Gvs, Rb^Gvs, Rb^Gvs, Rb^Gvs, Rb^Gvs, Rb^Gvs, Rb^Gvs, Rb^Gvs, Rb^Gvs, Rb^Gvs, Rb^Gvs, Gs^Fds, Gs^Fds, Gs^Fds, Gs^Fds, Gg, Gs^Fds, Gg, Gs^Fds, Gg, Gs^Fds, Gs^Fds, Hh^Fds, Gs^Fds, Hh^Fds, Hh^Fds, Hh^Fds, Hh^Fds, Hh^Fds, Gs^Fds, Gs^Fds, Gg, Gs^Fds, Gs^Fds, Ww, Gg, Gg, Gg, Gs^Fds, Gs^Fds, Gs^Fds, Gg, Gg^Em, Gg^Em, Gg^Em
