border_size=1
usage=map

Mm, Mm, Mm^Fds, Mm, Mm, Gg, Mm^Fds, Mm^Fds, Mm^Fds, Mm^Fds, Mm^Fds, Mm^Fds, Mm, Mm, Mm, Mm, Mm, Mm, Mm^Fds, Mm, Mm, Mm, Mm^Fds, Mm, Mm^Fds, Mm, Mm, Mm, Mm, Mm, Mm^Fds, Gg, Mm, Gg, Mm, Mm, Mm
Mm^Fds, Mm^Fds, Mm^Fds, Mm^Fds, Mm^Fds, Mm^Fds, Mm, Mm, Hh^Fds, Mm, Mm, Mm, Mm^Fds, Mm, Mm, Mm, Mm, Mm^Fds, Mm^Fds, Mm^Fds, Hh^Fds, Hh^Fds, Hh^Fds, Mm^Fds, Mm, Mm^Fds, Mm, Mm, Mm, Mm^Fds, Mm, Mm, Mm^Fds, Mm, Mm, Mm^Fds, Mm
Mm^Fds, Mm, Mm^Fds, Mm, Mm, Mm^Fds, Mm, Hh^Fds, Hh^Fds, Hh^Fds, Hh^Fds, Hh^Fds, Hh^Fds, Mm^Fds, Mm^Fds, Mm^Fds, Mm, Mm, Hh^Fds, Hh^Fds, Hh^Fds, Hh^Fds, Hh^Fds, Hh^Fds, Hh^Fds, Hh^Fds, Hh^Fds, Hh^Fds, Hh^Fds, Mm, Hh^Fds, Mm, Mm^Fds, Mm^Fds, Mm, Mm^Fds, Mm
Mm^Fds, Mm, Mm^Fds, Mm^Fds, Mm^Fds, Mm^Fds, Mm, Mm, Hh^Fds, Hh^Fds, Hh^Fds, Hh^Fds, Hh^Fds, Hh^Fds, Hh^Fds, Mm, Hh^Fds, Hh^Fds, Hh^Fds, Hh^Fds, Hh^Fds, Hh^Fds, Gs^Fds, Hh^Fds, Hh^Fds, Hh^Fds, Gs^Fds, Hh^Fds, Hh^Fds, Hh^Fds, Hh^Fds, Mm^Fds, Mm, Mm^Fds, Mm^Fds, Mm, Mm
Mm^Fds, Mm^Fds, Mm, Mm, Mm, Mm, Hh^Fds, Hh^Fds, Gs^Fds, Gs^Fds, Gs^Fds, Gs^Fds, Hh^Fds, Hh^Fds, Hh^Fds, Hh^Fds, Hh^Fds, Hh^Fds, Gs^Fds, Gs^Fds, Gs^Fds, Gs^Fds, Gs^Fds, Gs^Fds, Gs^Fds, Gs^Fds, Gs^Fds, Gs^Fds, Gs^Fds, Hh^Fds, Hh^Fds, Hh^Fds, Hh^Fds, Mm, Mm^Fds, Mm, Mm
Mm^Fds, Mm, Hh^Fds, Hh^Fds, Hh^Fds, Hh^Fds, Hh^Fds, Gs^Fds, Gs^Fds, Gs^Fds, Gs^Fds, Gs^Fds, Gs^Fds, Gs^Fds, Gs^Fds, Hh^Fds, Gs^Fds, Gs^Fds, Gs^Fds, Gs^Fds, Gs^Fds, Gs^Fds, Gg^Em, Gs^Fds, Gs^Fds, Gs^Fds, Gg^Em, Gs^Fds, Gs^Fds, Gs^Fds, Gs^Fds, Hh^Fds, Hh^Fds, Hh^Fds, Mm, Mm^Fds, Mm
Mm^Fds, Mm^Fds, Hh^Fds, Hh^Fds, Hh^Fds, Hh^Fds, Gs^Fds, Gs^Fds, Gs^Fds, Gg, Gg, Gs^Fds, Gs^Vl, Gs^Fds, Gs^Fds, Gs^Fds, Gs^Fds, Gs^Fds, Gg, Gg, Gg, Gg, Gs^Fds, Gg^Vdt, Gg, Gg, Gg, Gg, Gg, Gs^Fds, Gs^Fds, Hh^Fds, Hh^Fds, Hh^Fds, Hh^Fds, Mm^Fds, Mm
Mm^Fds, Mm^Fds, Hh^Fds, Hh^Fds, Hh^Fds, Hh^Fds, Gs^Fds, Gs^Fds, Gs^Fds, Gg^Efm, Gg, Gg, Gg, Gg, Gg, Gs^Fds, Gg, Ce, Gg, Gg^Em, Gs^Fds, Gs^Fds, Gs^Fds, Gs^Fds, Gg, Gg^Vdt, Gg, Gg^Ecf, Gg, Gg^Em, Gg, Gs^Fds, Hh^Fds, Hh^Fds, Mm, Mm^Fds, Mm
Mm^Fds, Mm, Hh^Fds, Hh^Fds, Gs^Fds, Hh^Fds, Gs^Fds, Gs^Fds, Gs^Fds, Gg, Gg^Es, Gs^Fds, Gs^Fds, Gg, Gg, Gg^Efm, Gg, Ce, 6 Ke, Gs^Fds, Gs^Fds, Gs^Fds, Gs^Fds, Gs^Fds, Gg^Em, Gg, Ww, Gg, Ww, Gg^Vdt, Gs^Fds, 3 Ke, Ce, Hh^Fds, Hh^Fds, Mm, Mm
Mm^Fds, Hh^Fds, Hh^Fds, Hh^Fds, Gs^Fds, Gs^Fds, Gs^Fds, Gs^Fds, Gs^Fds, Gg, Gg^Es, Gs^Fds, Gs^Fds, Gs^Fds, Gs^Fds, Gg, Gg, Ce, Ce, Gg, Rd, Rd, Rd, Gg, Gg^Vdt, Ww, Ww, Ww, Ww, Gs^Fds, Ce, Ce, Ce, Hh^Fds, Hh^Fds, Mm, Mm^Fds
Mm, Hh^Fds, Hh^Fds, Hh^Fds, Gs^Fds, Gs^Fds, Gs^Fds, Gs^Fds, Gg, Gg^Efm, Gg^Em, Gg, Gs^Fds, Gs^Fds, Gs^Fds, Gs^Fds, Gg^Es, Gg, Rd, Rd, Ce, Gg^Vdt, Gg^Em, Rd, Ww^Bh\, Ww, Ww, Ww, Gg^Vdt, Ce, Rd, Rd, Rd, Hh^Fds, Hh^Fds, Mm, Mm^Fds
Hh^Fds, Hh^Fds, Hh^Fds, Gs^Fds, Gs^Fds, Gs^Fds, Gg, Gg, Gg, Gg, Gg, Gg^Es, Rd, Gg, Gs^Vl, Gg, Rd, Rd, Gg, Ce, 5 Ke, Gs^Fds, Ww, Ww, Gs^Fds, Rd, Gg^Vdt, Ww, Rd, Rd, Gg^Vdt, Gs^Fds, Gs^Fds, Rd, Rd, Mm, Mm^Fds
Hh^Fds, Hh^Fds, Gs^Fds, Gs^Fds, Gs^Fds, Gg, Gg, Gg^Efm, Gs^Fds, Gg, Rd, Rd, Gg, Rd, Rd, Rd, Gg^Efm, Gg, Gg, Ce, Ce, Gs^Fds, Ww, Ce, Ce, Rd, Rd, Rd, 4 Ke, Ce, Ce, Ce, Gs^Fds, Hh^Fds, Hh^Fds, Rd, Hh^Fds
Hh^Fds, Hh^Fds, Gs^Fds, Gs^Fds, Gs^Fds, Gs^Fds, Gg, Gg, Gs^Fds, Gs^Fds, Rd, Gs^Fds, Gg, Gg^Efm, Gg, Gg, Gs^Fds, Gs^Fds, Gs^Fds, Gs^Fds, Ww, Ww, Gg, Gs^Fds, Gs^Fds, Ce, Ce, Ce, Ce, Ce, Gg^Efm, Gs^Fds, Gs^Fds, Hh^Fds, Rd, Rd, Hh^Fds
Hh^Fds, Hh^Fds, Hh^Fds, Gs^Fds, Gs^Fds, Gg, Gs^Vl, Gg, Gs^Fds, Gs^Fds, Rd, Gs^Fds, Gs^Fds, Gs^Fds, Gg^Em, Gg, Gs^Fds, Gs^Fds, Gs^Fds, Gs^Fds, Ww, Gg^Es, Gg, Gs^Fds, Gs^Fds, Gs^Fds, Gs^Fds, Gs^Fds, Gs^Fds, Gs^Fds, Gg, Gs^Fds, Gs^Fds, Hh^Fds, Rd, Hh^Fds, Hh^Fds
Hh^Fds, Hh^Fds, Hh^Fds, Gs^Fds, Gg, Gg, Gg^Efm, Gg, Gg, Gg, Rd, Gs^Fds, Gs^Fds, Gs^Fds, Gg, Gs^Fds, Gg, Gs^Fds, Gs^Fds, Gs^Fds, Ww, Gg, Gg, Gs^Fds, Gg, Gs^Fds, Gs^Fds, Gs^Fds, Gs^Fds, Gs^Fds, Gg, Gs^Fds, Gs^Fds, Gs^Fds, Hh^Fds, Rd, Hh^Fds
Gs^Fds, Hh^Fds, Gs^Fds, Gs^Fds, Gg, Gg^Efm, Rd, Rd, Rd, Rd, Gg, Gs^Fds, Gs^Fds, Gg, Gg^Es, Gg, Gg, Gs^Fds, Gg, Gg, Ww, Gg, Gg^Es, Gg, Gs^Fds, Gg, Gg, Gg^Em, Gg, Gg^Efm, Gg, Gg, Gs^Fds, Gs^Fds, Hh^Fds, Rd, Hh^Fds
Gs^Fds, Gs^Fds, Gs^Fds, Gs^Fds, Gg, Rd, Gs^Fds, Gs^Fds, Gs^Fds, Gg, Gg^Es, Gg, Gg, Gg, Gg, Gg, Gs^Fds, Gg, Gg^Efm, Ww, Gg^Es, Gg, Gs^Fds, Gs^Fds, Gs^Fds, Gs^Fds, Gs^Fds, Gg, Gs^Fds, Gg, Gg, Gs^Vl, Gg, Gs^Fds, Gs^Fds, Rd, Hh^Fds
Gs^Fds, Gs^Fds, Gg, Gg^Efm, Rd, Rd, Gs^Fds, Gs^Fds, Gs^Fds, Gg, Gg, Gg, Gg, Gs^Vl, Gg, Gg, Gs^Fds, Gs^Fds, Gg, Ww, Gg, Gs^Fds, Gg, Gg, Gg, Gg^Es, Gg, Gs^Fds, Gs^Fds, Gs^Fds, Gs^Fds, Gg, Gg, Gs^Fds, Gs^Fds, Rd, Rd
Gs^Fds, Gs^Fds, Gg, Rd, Gs^Fds, Gs^Fds, Gs^Fds, Gs^Fds, Gg, Gg, Gg^Efm, Gg, Gs^Fds, Gg, Gg^Efm, Gg, Gs^Fds, Gs^Fds, Gs^Fds, Ww, Gg, Gg, Gg, Gs^Vl, Gg, Gg, Gg, Gg, Gg, Gs^Fds, Gs^Fds, Gg, Gg, Gg, Gg, Rd^Fds, Rd^Fds
Gs^Fds, Gs^Fds, Rd, Rd, Gs^Fds, Gs^Fds, Gs^Fds, Gg, Gg^Em, Gg, Gg, Gg, Gs^Fds, Gg, Gg, Gg^Efm, Gs^Fds, Gs^Fds, Gs^Fds, Ww, Gs^Fds, Gs^Fds, Gs^Fds, Gs^Fds, Gs^Fds, Gs^Fds, Gg, Gg, Gg^Efm, Gg^Efm, Gg, Gs^Fds, Gg^Efm, Gg^Es, Gg, Rd^Fds, Gs^Fds
Gs^Fds, Gs^Fds, Rd, Gg^Efm, Gg, Gg, Gg, Gg, Gg^Efm, Gg, Gg, Gg, Gs^Fds, Gg, Gg^Em, Gg, Gg, Gs^Fds, Gs^Fds, Ww, Gg, Gg, Gg, Gg, Gs^Fds, Gg, Gg, Gg, 1 Gg, Gg^Em, Gg^Efm, Gg, Gg, Gg, Gs^Fds, Rd^Fds, Gs^Fds
Rd, Rd, Gg, Gg^Efm, Gs^Vl, Gg, Gg, Gg^Efm, Gg^Efm, Gg, Gs^Fds, Gs^Fds, Gg, Gg, Gg, Gg^Es, Gg^Es, Gg, Ww, Ww, Gg^Efm, Gg, Gg, Gg, Gs^Fds, Gs^Fds, Gs^Fds, Gg, Ke, Gg, Gg, Gg^Es, Gg, Gg, Gs^Fds, Gs^Fds, Gs^Fds
Gs^Fds, Gs^Fds, Gs^Fds, Gg, Gg^Efm, Gg, Gg, Gg^Es, Gg, Gs^Fds, Gs^Fds, Gs^Fds, Gs^Fds, Gs^Fds, Gg, Gg^Efm, Gg, Gg, Ww, Gg, Gs^Fds, Gg^Em, Gg, Gg, Gg^Efm, Gs^Fds, Gg, Ce, Ce, Ce, Gg, Gg, Gg, Gg, Gs^Fds, Gs^Fds, Gs^Fds
Gs^Fds, Gs^Fds, Gs^Fds, Gg, Gs^Fds, Gs^Fds, Gg, Gg^Efm, Gg, Gg, Gs^Fds, Gs^Fds, Gs^Fds, Gs^Fds, Gg, Gg, Gg, Ww, Gg, Gs^Fds, Gs^Fds, Gs^Fds, Gg, Gg, Gg, Gg, Gg, Gg, Gg, Gg, Gg, Gg, Gs^Fds, Gs^Fds, Gs^Fds, Gs^Fds, Gg
