border_size=1
usage=map

Gs^Fds, Gs^Fds, Gs^Fds, Gs^Fds, Gg, Gg, Ww, Gg, Gs^Fds, Gs^Fds, Gs^Fds, Gs^Fds, Gg, Gg, Gg, Gg, Gg^Efm, Gg, Rb^Gvs, Gg, Rb^Gvs, Gg, Gg, Gg, Rb^Gvs, Gg, Rb^Gvs, Rb^Gvs, Rb^Gvs, Gg, Ch, Ch, Rrc, Rrc, Rrc, Rrc, Ch, Rrc, Rrc, Rrc, Rrc, Rrc, Rrc, Rrc, Rrc, Rrc
Gs^Fds, Hh^Fds, Hh^Fds, Hh^Fds, Gs^Vl, Gg, Ww, Hh^Fds, Hh^Fds, Hh^Fds, Gs^Fds, Gs^Fds, Gg, Gg, Gg^Es, Gg^Efm, Gg, Gg, Rb^Gvs, Rb^Gvs, Rb^Gvs, Rb^Gvs, Rb^Gvs, Rb^Gvs, Rb^Gvs, Rb^Gvs, Rb^Gvs, Rb^Gvs, Gg, Ch, Rrc, Rrc^Vhc, Rrc, Rrc, Ch, Ch, Ch, Ch, Ch, Ch, Ch, Rrc, Rrc, Rrc, Rrc^Vhc, Rrc
Gs^Fds, Hh^Fds, Gs^Fds, Hh^Fds, Gg, Gg^Efm, Gg, Ww, Ww, Hh^Fds, Gg, Gg, Gs^Fds, Gs^Fds, Gs^Fds, Gs^Fds, Gs^Fds, Rb^Gvs, Rb^Gvs, Rb^Gvs, Rb^Vh, Rb^Gvs, Rb^Gvs, Rb^Gvs, Rb^Gvs, Rb^Vh, Gg, Gg^Es, Gg, Ch, Rrc^Vhc, Rrc, Rrc, Ch, Ch, Kh, Kh, 4 Kh, Kh, Kh, Ch, Ch, Ch, Rrc, Rrc, Rrc
Gg, Gs^Fds, Gg, Gg, Gg, Gg, Gs^Fds, Gg, Gs^Fds, Ww, Ww, Gs^Fds, Hh^Fds, Hh^Fds, Hh^Fds, Gs^Fds, Gg, Rb^Gvs, Rb^Gvs, Rb^Gvs, Rb^Gvs, Rb^Gvs, Rb^Gvs, Rb^Gvs, Rb^Gvs, Rb^Gvs, Rb^Gvs, Rb^Gvs, Rb^Gvs, Ch, Ch, Rrc, Rrc, Ch, Ch, Ch, Ch, Kh, Ch, Ch, 5 Kh, Ch, Ch, Ch, Rrc, Rrc
Gg, Gg, Gg^Es, Gg^Es, Gs^Fds, Gs^Fds, Hh^Fds, Gs^Fds, Hh^Fds, Gs^Efm, Ww, Gs^Fds, Gs^Fds, Hh^Fds, Gs^Fds, Gs^Fds, Gs^Fds, Gg, Gg, Gg, Gg, Rb^Gvs, Gg, Rb^Gvs, Rb^Gvs, Rb^Vh, Rb^Gvs, Rb^Gvs, Gg, Gg, Ch, Rrc^Vhc, Rrc, Ch, Ch, Ch, 3 Kh, Ch, Ch, Kh, Kh, Kh, Ch, Ch, Rrc, Rrc
Gs^Fds, Gs^Fds, Gg, Gg^Efm, Gg^Efm, Gs^Fds, Hh^Fds, Hh^Fds, Hh^Fds, Gs^Fds, Ww, Gg, Gg, Gs^Fds, Gg, Gs^Fds, Gg, Gg^Efm, Rb^Gvs, Rb^Gvs, Rb^Gvs, Rb^Gvs, Rb^Gvs, Rb^Gvs, Rb^Gvs, Rb^Gvs, Rb^Gvs, Rb^Gvs, Gg, Gg, Ch, Rrc, Rrc, Ch, Ch, Kh, Kh, Kh, Ch, Ch, Ch, Ch, Ch, Rrc, Rrc^Vhc, Rrc
Gs^Fds, Gs^Fds, Hh^Fds, Gs^Fds, Gs^Efm, Gg^Efm, Gg^Efm, Gg, Gg, Gs^Fds, Gg^Es, Ww, Gs^Vl, Gg, Gs^Fds, Gg, Hh^Fds, Gg^Efm, Gg, Rb^Gvs, Rb^Vh, Rb^Gvs, Rb^Gvs, Rb^Gvs, Rb^Gvs, Rb^Vh, Rb^Gvs, Gg, Gg^Es, Gg, Ch, Rrc^Vhc, Rrc, Ch, Rrc, Ch, Ch, Ch, Ch, Ch, Rrc, Ch, Rrc, Rrc, Rrc, Rrc
Hh^Fds, Hh^Fds, Hh^Fds, Hh^Fds, Gs^Fds, Gg, Gg^Efm, Gg, Gg, Gg^Es, Gg^Es, Ww, Ww, Gg, Hh^Fds, Hh^Fds, Hh^Fds, Gg^Efm, Gg^Efm, Rb^Gvs, Gg, Rb^Gvs, Gg^Wm, Rb^Gvs, Gg, Rb^Gvs, Rb^Gvs, Gg, Gg, Gg, Gg, Ch, Rrc^Vhc, Rrc, Rrc^Vhc, Rrc, Rrc, Rrc, Rrc, Rrc, Rrc, Rrc, Rrc, Rrc, Rrc^Vhc, Rrc
Gs^Fds, Hh^Fds, Hh^Fds, Hh^Fds, Gs^Fds, Gg, Gg, Gg^Efm, Gs^Fds, Gg, Gg, Gg, Ww, Gs^Fds, Gs^Fds, Gs^Fds, Gs^Fds, Gg, Gg, Rb^Gvs, Rb^Gvs, Rb^Gvs, Rb^Gvs, Gg, Gg^Efm, Gg^Efm, Rb^Gvs, Rb^Gvs, Rb^Vh, Gg, Gg, Ch, Ch, Rrc, Rrc, Rrc, Rrc, Rrc^Vhc, Rrc, Rrc, Rrc, Rrc^Vhc, Rrc, Rrc, Rrc, Rrc
Gg, Gg, Gg, Gs^Fds, Gg, Gg, Gg, Gg, Gs^Fds, Gs^Fds, Hh^Fds, Gs^Fds, Gs^Fds, Ww, Gg, Gs^Fds, Gg, Gg^Efm, Gg, Gg, Gg, Gg, Rb^Gvs, Rb^Vh, Gg, Gg^Efm, Rb^Gvs, Rb^Gvs, Rb^Gvs, Rb^Gvs, Rb^Gvs, Gg, Gg, Ch, Rrc, Rrc, Rrc, Rrc, Rrc, Rrc^Vhc, Rrc, Rrc, Ch, Rrc^Vhc, Ch, Ch
Gs^Fds, Gs^Fds, Hh^Fds, Gg, Gg, Gs^Vl, Gg, Gg, Gs^Fds, Hh^Fds, Hh^Fds, Hh^Fds, Hh^Fds, Ww, Ww, Gg^Efm, Gg^Efm, Gg^Efm, Gg, Gg, Gg, Rb^Gvs, Rb^Gvs, Rb^Gvs, Rb^Gvs, Gg^Efm, Gg, Rb^Gvs, Rb^Gvs, Rb^Gvs, Rb^Gvs, Gg, Rr, Rr, Gg, Ch, Ch, Rrc^Vhc, Ch, Rrc, Ch, Ch, Gg, Ch, Gg, Gg
Gs^Fds, Gs^Fds, Hh^Fds, Hh^Fds, Gs^Fds, Gg, Gg^Efm, Gg, Gg, Gs^Fds, Gs^Fds, Hh^Fds, Gs^Fds, Gg, Ww, Gg^Es, Gg^Em, Gs^Fds, Gs^Fds, Gs^Fds, Gg, Rb^Gvs, Rb^Gvs, Rb^Gvs, Rb^Gvs, Rb^Gvs, Rb^Vh, Gg, Rb^Gvs, Rb^Gvs, Rb^Vh, Rr, Rb^Gvs, Gg, Rb^Gvs, Rb^Gvs, Gg, Ch, Gg, Ch, Gg, Gg, Rb^Gvs, Gg, Gg, Gg
Gs^Fds, Hh^Fds, Hh^Fds, Hh^Fds, Gs^Fds, Gs^Fds, Gg^Es, Gg, Gg^Em, Gg, Gg, Gg, Gg, Gg, Gg^Es, Ww, Hh^Fds, Gs^Fds, Gs^Fds, Gs^Fds, Gs^Fds, Gg, Gg^Efm, Gg, Rb^Gvs, Rb^Gvs, Rb^Gvs, Rb^Gvs, Gg, Rb^Gvs, Rb^Gvs, Rr, Rb^Vh, Rb^Gvs, Rb^Gvs, Rb^Gvs, Rb^Gvs, Rb^Gvs, Rb^Gvs, Gg, Rb^Gvs, Rb^Gvs, Rb^Gvs, Rb^Gvs, Rb^Gvs, Gg
Gg, Gs^Fds, Gs^Fds, Gs^Es, Gg^Es, Gg^Es, Gg^Es, Gg, Gs^Fds, Gs^Fds, Hh^Fds, Gs^Fds, Gg, Gg, Gg^Efm, Ww, Gs^Fds, Hh^Fds, Gs^Fds, Gs^Fds, Gs^Fds, Gg^Efm, Gg^Efm, Gg^Efm, Rb^Gvs, Rb^Gvs, Rb^Gvs, Rb^Vh, Rb^Gvs, Rb^Gvs, Gg, Rr, Rb^Gvs, Rb^Gvs, Gg, Rb^Gvs, Rb^Gvs, Rb^Gvs, Rb^Gvs, Rb^Vh, Rb^Gvs, Rb^Gvs, Rb^Vh, Rb^Gvs, Rb^Gvs, Gg
Gg, Gg^Efm, Gs^Fds, Gg, Gg, Gg^Efm, Gg^Efm, Gg, Gs^Fds, Hh^Fds, Hh^Fds, Gs^Fds, Gg, Gg, Gg^Efm, Ww, Ww, Gs^Fds, Gs^Fds, Gs^Fds, Hh^Fds, Gg, Hh^Fds, Gg^Efm, Gg, Gg, Gg, Rb^Gvs, Rb^Gvs, Rb^Gvs, Rr, Rr, Gg, Gg, Gg, Rb^Vh, Rb^Gvs, Rb^Gvs, Gg, Rb^Gvs, Rb^Gvs, Rb^Gvs, Rb^Gvs, Rb^Gvs, Gg, Gg
Gs^Fds, Gs^Fds, Gs^Fds, Gg, Gs^Fds, Gg^Efm, Gg, Gg, Gg, Hh^Fds, Gs^Fds, Gs^Fds, Gg, Gg, Gg, Gg, Gg, Ww, Ww, Hh^Fds, Hh^Fds, Hh^Fds, Hh^Fds, Gs^Fds, Gs^Fds, Gg, Gg^Es, Rb^Gvs, Rb^Gvs, Rr, Rb^Gvs, Rb^Gvs, Rb^Gvs, Rb^Vh, Rb^Gvs, Rb^Gvs, Rb^Gvs, Rb^Gvs, Gg, Gg, Gg, Rb^Gvs, Rb^Gvs, Gg, Gg, Gg
Gs^Fds, Gs^Fds, Hh^Fds, Hh^Fds, Gs^Fds, Gg, Gg, Gg, Gg, Gg, Gg, Gg, Gg^Es, Gg, Gs^Fds, Gg, Gs^Fds, Gs^Fds, Ww, Gg, Gs^Fds, Hh^Fds, Hh^Fds, Hh^Fds, Gs^Fds, Gs^Fds, Gg, Rb^Gvs, Rr, Rr, Gg, Rb^Gvs, Rb^Gvs, Rb^Gvs, Rb^Vh, Gg, Rb^Gvs, Rb^Vh, Rb^Gvs, Gg, Gg, Gg, Rb^Gvs, Rb^Gvs, Rb^Gvs, Rb^Gvs
Gs^Fds, Gs^Fds, Gs^Fds, Hh^Fds, Gg, Gg, Gg, Gg, Gs^Vl, Gg, Gg, Gg, Gg^Es, Gg^Es, Gs^Fds, Gs^Fds, Gs^Fds, Gs^Fds, Gs^Fds, Ww, Gs^Vl, Gs^Fds, Gs^Fds, Gs^Fds, Gs^Fds, Gs^Fds, Rr, Rr, Gg, Gg, Gg, Gg, Gg, Rb^Gvs, Gg, Gg, Rb^Gvs, Rb^Gvs, Rb^Gvs, Gg, Gg, Rb^Vh, Rb^Gvs, Rb^Gvs, Rb^Gvs, Rb^Gvs
Gs^Fds, Gs^Fds, Gg, Gg^Em, Gg, Gg, Gg, Gg, Gg, Gg, Gg, Gg, Gg^Es, Gg, Gs^Fds, Gs^Fds, Hh^Fds, Gs^Fds, Gs^Fds, Ww, Ww, Gg^Efm, Gg, Gs^Fds, Gg, Rr, Gg^Es, Gg, Gs^Fds, Gs^Fds, Gs^Fds, Gs^Fds, Gg, Rb^Gvs, Gg, Gg, Gg, Rb^Gvs, Rb^Gvs, Gg, Gg^Efm, Gg, Rb^Gvs, Rb^Gvs, Rb^Gvs, Rb^Gvs
Gg, Gg, Gg, Gg, Gg, Gg, Gs^Fds, Gs^Fds, Gs^Fds, Gs^Fds, Gg, Gg^Em, Gs^Fds, Gg, Gg^Efm, Gg, Gg^Efm, Hh^Fds, Gs^Fds, Gs^Fds, Gg, Ww, Ww, Gg, Rr, Rr^Efm, Gg^Es, Gg, Gs^Fds, Gs^Fds, Hh^Fds, Gs^Fds, Gg, Gg, Gg^Es, Gg^Efm, Gg, Gg, Gg, Gg, Gg^Efm, Gg, Gg, Rb^Gvs, Gg, Gg
Gg, Gg^Efm, Gg, Gg^Efm, Gg, Gg, Gs^Fds, Gs^Fds, Hh^Fds, Hh^Fds, Hh^Fds, Gs^Fds, Gs^Fds, Gg, Gg, Gg^Efm, Gg^Efm, Gg, Gg^Efm, Gg^Efm, Gg^Efm, Gg^Efm, Rr, Ww^Bsb/, Ww, Gg^Efm, Gg^Es, Gs^Fds, Gs^Fds, Hh^Fds, Hh^Fds, Hh^Fds, Hh^Fds, Gg^Efm, Gg, Gs^Fds, Gs^Fds, Gg, Hh^Fds, Gg, Gg, Gg^Efm, Gg^Es, Gg, Gg^Efm, Gg
Gg, Gg^Efm, Gg^Es, Gg^Es, Gg, Gs^Fds, Gs^Fds, Hh^Fds, Gs^Fds, Gs^Fds, Gs^Fds, Gs^Fds, Rr, Rr, Rr, Gg, Gg^Efm, Gg^Efm, Gg^Efm, Gg^Efm, Gg, Rr, Gg, Gg^Efm, Ww, Gg^Es, Gs^Fds, Gs^Fds, Gs^Fds, Gs^Fds, Hh^Fds, Hh^Fds, Hh^Fds, Gs^Fds, Gs^Fds, Gs^Fds, Hh^Fds, Hh^Fds, Hh^Fds, Gg, Gs^Fds, Gg^Efm, Gg, Gg^Efm, Gg^Es, Gg
Gg, Gg^Efm, Gg^Es, Gg^Es, Gg, Gg, Gg, Gs^Fds, Gg, Gs^Fds, Rr, Rr, Gg, Gg^Es, Gg^Es, Rr, Rr, Gg, Gg, Gg, Rr, Rr, Gg, Gg, Ww, Gs^Fds, Gs^Fds, Gs^Fds, Gs^Fds, Gs^Fds, Gs^Fds, Gs^Fds, Gs^Fds, Gs^Fds, Gs^Fds, Hh^Fds, Gs^Fds, Hh^Fds, Gs^Fds, Gs^Fds, Gs^Fds, Gg, Gg, Gg^Efm, Gg^Efm, Gg
Gg, Gg^Efm, Gg, Gg^Efm, Gg, Gg, Gg, Gg, Rr, Rr, Gg, Gg, Gg^Efm, Gg^Es, Gg^Es, Gg, Gg, Rr, Rr, Rr, Gg, Gg, Gg, Gs^Vl, Ww, Gs^Fds, Gs^Fds, Gs^Fds, Gs^Fds, Gs^Fds, Gg, Gg, Gg^Em, Gg, Gg, Gs^Fds, Gg^Em, Gg, Gs^Fds, Gs^Fds, Gs^Fds, Gg, Gs^Vl, Gg, Gg, Gg
Rb^Gvs, Gg, Gg, Gg, Gg, Gg, Rr, Rr, Gg, Gg, Gg^Efm, Gg^Efm, Gg, Gg^Efm, Gg, Gg, Gs^Fds, Gg, Gg, Gg, Gs^Fds, Gg, Gg, Gg, Gg^Efm, Ww, Ww, Gs^Fds, Gg, Gs^Fds, Hh^Fds, Hh^Fds, Gs^Fds, Gg, Gg, Gg, Gg^Efm, Gg^Efm, Gg^Efm, Gg, Gg^Efm, Gg, Gg, Gg, Gg, Gg
Gg, Rb^Gvs, Rb^Gvs, Gg, Gg, Gg, Rr, Gg, Rb^Gvs, Gg, Gg, Gg^Em, Gg, Gs^Fds, Gs^Fds, Gs^Fds, Gs^Fds, Gs^Fds, Gg^Efm, Gg, Gs^Fds, Gs^Fds, Gs^Fds, Gg, Gs^Fds, Gg^Efm, Gg^Efm, Ww, Ww, Gs^Fds, Gs^Fds, Hh^Fds, Gs^Fds, Gs^Fds, Gg, Gg, Gs^Fds, Gg, Gs^Fds, Gg^Efm, Gg, Gg, Gs^Fds, Hh^Fds, Hh^Fds, Gg
Rb^Gvs, Rb^Gvs, Rb^Gvs, Rb^Gvs, Rb^Gvs, Rr, Rb^Gvs, Rb^Gvs, Gg, Gg, Rb^Gvs, Gg, Gg, Gs^Fds, Hh^Fds, Gs^Fds, Hh^Fds, Gs^Fds, Gg, Gg^Efm, Gg, Gs^Fds, Hh^Fds, Gs^Fds, Gs^Es, Gg^Efm, Gg^Efm, Gg^Efm, Ww, Gs^Fds, Gs^Fds, Gs^Fds, Gg, Gg, Gg, Gs^Fds, Gs^Fds, Hh^Fds, Gs^Fds, Gs^Fds, Gs^Fds, Gs^Fds, Gs^Fds, Hh^Fds, Gs^Fds, Gg
Gg, Rb^Vh, Rb^Gvs, Rb^Gvs, Rb^Gvs, Rr, Rb^Gvs, Rb^Vh, Rb^Gvs, Rb^Gvs, Rb^Gvs, Rb^Gvs, Rb^Gvs, Gg, Gg, Hh^Fds, Hh^Fds, Hh^Fds, Hh^Fds, Gg^Efm, Gg^Es, Gs^Fds, Gs^Fds, Hh^Fds, Gs^Fds, Gg^Es, Gg^Efm, Gg^Es, Gg, Ww, Ww, Gg^Efm, Gg^Efm, Gg, Gs^Fds, Gs^Fds, Gs^Fds, Hh^Fds, Gs^Fds, Gs^Fds, Gs^Fds, Gs^Fds, Gs^Fds, Gs^Fds, Gs^Fds, Gs^Fds
Rb^Gvs, Rb^Gvs, Rb^Gvs, Rb^Vh, Rb^Gvs, Rr, Rr, Rb^Gvs, Rb^Gvs, Rb^Gvs, Rb^Gvs, Rb^Vh, Rb^Gvs, Rb^Gvs, Gg, Gg, Gg, Gg, Gg, Gg, Gg^Efm, Gg, Gg, Gs^Fds, Gg, Gg^Efm, Gg^Efm, Gg^Es, Gg, Gg^Em, Gg^Es, Ww, Ww, Chw, Gg, Gs^Fds, Gg, Gs^Fds, Gs^Fds, Gs^Fds, Gs^Fds, Gg, Gs^Fds, Gs^Fds, Gs^Fds, Gg
Gg, Rb^Gvs, Rb^Gvs, Rb^Gvs, Rb^Gvs, Rb^Gvs, Rr, Rb^Gvs, Rb^Vh, Rb^Gvs, Rb^Gvs, Rb^Gvs, Rb^Gvs, Rb^Gvs, Rb^Gvs, Gg, Gg, Gg, Gs^Fds, Gg, Gg, Gg^Efm, Gg^Em, Gg, Gg, Gg^Efm, Gg, Gg, Gs^Fds, Gs^Fds, Gs^Fds, Gs^Fds, Ww, Khw, Chw, Gg, Gg, Gg, Gg, Gs^Fds, Gg, Gg, Gg, Gs^Fds, Gg, Gg
Gg, Rb^Vh, Rb^Gvs, Rb^Gvs, Ket, Ket, Ket, Rb^Gvs, Rb^Gvs, Rb^Gvs, Rb^Gvs, Rb^Gvs, Rb^Gvs, Rb^Gvs, Gg, Rb^Gvs, Gg, Gs^Fds, Gs^Fds, Hh^Fds, Hh^Fds, Gg, Gs^Fds, Gs^Vl, Gg^Efm, Gg^Efm, Gg, Gg, Gs^Fds, Gs^Fds, Hh^Fds, Gs^Fds, Ww, Chw, Chw, Gs^Vl, Gg, Gg, Gg, Gg^Efm, Gg^Efm, Gg^Efm, Gg^Efm, Gg^Efm, Gg^Efm, Gg^Efm
Rb^Gvs, Rb^Gvs, Ket, Gg, Ket, Ket, Ket, Ket, Gg, Gg, Rb^Gvs, Rb^Vh, Rb^Gvs, Gg, Rb^Gvs, Gg, Gg, Gg, Gs^Fds, Gs^Fds, Hh^Fds, Hh^Fds, Gg, Gg^Efm, Gg^Es, Gg, Gs^Fds, Gs^Fds, Gs^Fds, Hh^Fds, Hh^Fds, Hh^Fds, Gs^Fds, Ww, Ww, Gg, Gg, Gg, Gs^Fds, Gs^Fds, Hh^Fds, Hh^Fds, Gs^Fds, Gs^Es, Gg^Efm, Gg^Efm
Rb^Gvs, Rb^Gvs, Rb^Gvs, Ket, Ket, 1 Ket, Rb^Gvs, Rb^Gvs, Gg, Rb^Wm, Rb^Gvs, Rb^Gvs, Rb^Gvs, Rb^Gvs, Rb^Gvs, Rb^Gvs, Gg, Gg, Gg, Hh^Fds, Gs^Fds, Gs^Fds, Gs^Fds, Gg^Efm, Gg, Gg, Gg, Gg, Gs^Fds, Hh^Fds, Gs^Fds, Gs^Fds, Gg, Gg^Efm, Gg^Efm, Ww, Gs^Fds, Gs^Fds, Hh^Fds, Hh^Fds, Hh^Fds, Hh^Fds, Gs^Fds, Gs^Fds, Gs^Fds, Gs^Fds
Rb^Gvs, Rb^Gvs, Rb^Gvs, Gg, Rr, Rb^Gvs, Rb^Vh, Rb^Gvs, Rb^Gvs, Rb^Gvs, Rb^Vh, Rb^Gvs, Rb^Gvs, Rb^Vh, Rb^Gvs, Rb^Gvs, Rb^Gvs, Gg, Gg, Gg, Gg, Gg, Gg, Gg, Gs^Fds, Gg, Gs^Fds, Gg, Gg, Gg, Gg, Gg, Gg, Gg^Efm, Gg^Efm, Ww, Gg, Gg, Gs^Fds, Hh^Fds, Gs^Fds, Gs^Fds, Gs^Fds, Gs^Fds, Gs^Fds, Gs^Fds
Gg, Rb^Vh, Rb^Gvs, Rr, Gg, Rb^Gvs, Rb^Gvs, Rb^Gvs, Gg, Rb^Gvs, Gg, Rb^Gvs, Rb^Gvs, Rb^Gvs, Gg, Rb^Gvs, Gg, Rb^Gvs, Gg, Gg, Gg, Gg, Gg, Gs^Fds, Gg, Gs^Fds, Gs^Fds, Gs^Fds, Gs^Fds, Gg, Gg, Gg, Gg, Gg, Gg, Ww, Ww, Gg, Gg, Gs^Fds, Gg, Gs^Fds, Gs^Fds, Gs^Fds, Gs^Fds, Gs^Fds
