border_size=1
usage=map

Dd^Fztd     , Dd^Fztd     , Dd^Fztd     , Dd^Fztd     , Rd          , Rd          , Dd^Fztd     , Dd^Fztd     , Dd^Fztd     , Dd^Fztd     , Dd^Fztd     , Dd^Vda      , Rd          , Dd^Fztd     , Xos         , Xos         , Xos         , Xos         , Xos         , Xos         , Xos         , Xos         , Xos         , Xos         , Xol         , Xos         , Xos         , Xos         , Xos         , Xos         , Xos         , Xos         , Xos         , Xos         , Xos         , Xos         , Dd^Fztd     , Dd^Fztd     , Rd          , Dd^Fztd     , Dd^Fztd     , Dd^Fzts     , Dd^Fzts     , Dd^Fztd     , Rd          , Dd^Fztd     
Dd^Fztd     , Dd^Fztd     , Dd^Fztd     , Dd^Vda      , Dd^Fzts     , Rd          , Rd          , Dd^Fzts     , Dd^Fzts     , Dd^Fztd     , Dd^Vda      , Dd^Fztd     , Rd          , Dd^Vda      , Xos         , Xos         , Xos         , Xos         , Xos         , Xos         , Xos         , Xos         , Xol         , Xol         , Urb         , Xol         , Urb         , Xol         , Xol         , Xos         , Xos         , Xos         , Xos         , Xos         , Xos         , Xos         , Dd^Fztd     , Dd^Fztd     , Rd          , Dd^Fztd     , Dd^Vda      , Dd^Fzts     , Rd          , Rd          , Dd^Fztd     , Dd^Fzts     
Rd          , Dd^Vda      , Dd^Fztd     , Dd^Fztd     , Rd          , Dd^Fztd     , Rd          , Rd          , Rd          , Dd^Fzts     , Rd          , Rd          , Dd^Fzts     , Rd          , Xos         , Xos         , Xos         , Xos         , Xol         , Xol         , Urb         , Xol         , Urb         , Urb         , Urb         , Urb         , Urb         , Urb         , Urb         , Xol         , Xol         , Xos         , Xos         , Xos         , Xos         , Dd^Fztd     , Dd^Fztd     , Dd^Fztd     , Dd^Vda      , Rd          , Rd          , Rd          , Rd          , Dd^Fzts     , Dd^Fzts     , Dd^Fzts     
Dd^Fzts     , Rd          , Rd          , Rd          , Rd          , Rd          , Dd^Fztd     , Dd^Fzts     , Rd          , Dd^Fztd     , Rd          , Dd^Fzts     , Dd^Fztd     , Dd^Fztd     , Dd^Fztd     , Xos         , Xos         , Xol         , Xol         , Urb         , Urb         , Urb         , Urb         , Urb         , Urb         , Urb         , Urb         , Urb         , Urb         , Urb         , Xol         , Xos         , Xos         , Xos         , Dd^Fztd     , Dd^Fztd     , Dd^Vda      , Dd^Fzts     , Rd          , Rd          , Rd          , Rd          , Dd^Vda      , Dd^Fzts     , Dd^Fzts     , Dd^Fzts     
Dd^Fztd     , Dd^Vda      , Rd          , Rd          , Rd          , Dd^Fzts     , Dd^Fztd     , Dd^Vda      , Rd          , Rd          , Rd          , Rd          , Rd          , Dd^Vda      , Rd          , Xos         , Xos         , Xol         , Urb         , Urb         , Urb         , Urb         , 5 Urb       , Urb         , 1 Urb       , Urb         , 4 Urb       , Urb         , Urb         , Urb         , Urb         , Xol         , Dd^Fztd     , Dd^Fztd     , Dd^Vda      , Dd^Fztd     , Rd          , Rd          , Dd^Fztd     , Dd^Fztd     , Rd          , Rd          , Dd^Fzts     , Dd^Fztd     , Dd^Fztd     , Dd^Fztd     
Dd^Fzts     , Dd^Fzts     , Rd          , Rd          , Dd^Fzts     , Rd          , Rd          , Rd          , Dd^Vda      , Dd^Fztd     , Rd          , Dd^Fzts     , Dd^Vda      , Rd          , Rd          , Dd^Vda      , Dd^Fztd     , Xos         , Xos         , Urb         , Urb         , Urb         , Urb         , 3 Urb       , Urb         , 2 Urb       , Urb         , Urb         , Urb         , Urb         , Xos         , Xos         , Dd^Fztd     , Dd^Fztd     , Dd^Fzts     , Rd          , Rd          , Dd^Vda      , Dd^Fztd     , Dd^Fztd     , Rd          , Dd^Vda      , Dd^Fzts     , Dd^Fztd     , Dd^Fzts     , Dd^Fzts     
Dd^Vda      , Rd          , Dd^Vda      , Dd^Fzts     , Dd^Fztd     , Rd          , Rd          , Dd^Fztd     , Dd^Fzts     , Dd^Fztd     , Rd          , Rd          , Dd^Fztd     , Dd^Fztd     , Rd          , Dd^Fztd     , Dd^Vda      , Xos         , Xos         , Xol         , Urb         , Urb         , Urb         , Urb         , Urb         , Urb         , Urb         , Urb         , Urb         , Urb         , Xos         , Dd^Fztd     , Dd^Fztd     , Dd^Fzts     , Rd          , Dd^Fzts     , Rd          , Dd^Fztd     , Dd^Fzts     , Dd^Fztd     , Rd          , Dd^Fztd     , Dd^Fzts     , Dd^Fztd     , Dd^Fzts     , Dd^Fzts     
Rd          , Rd          , Rd          , Rd          , Rd          , Rd          , Rd          , Rd          , Rd          , Rd          , Rd          , Rd          , Rd          , Dd^Vda      , Dd^Fztd     , Rd          , Rd          , Dd^Fztd     , Dd^Fztd     , Xos         , Xos         , Urb         , Urb         , Urb         , Urb         , Urb         , Urb         , Urb         , Xos         , Xos         , Dd^Fztd     , Dd^Fztd     , Rd          , Rd          , Dd^Vda      , Rd          , Dd^Fztd     , Rd          , Rd          , Dd^Vda      , Rd          , Rd          , Dd^Vda      , Dd^Fztd     , Dd^Fzts     , Dd^Fzts     
Dd^Fztd     , Rd          , Rd          , Dd^Fztd     , Dd^Fzts     , Dd^Fzts     , Dd^Vda      , Rd          , Dd^Fztd     , Dd^Vda      , Dd^Fztd     , Dd^Fztd     , Dd^Fztd     , Rd          , Rd          , Rd          , Dd^Fztd     , Dd^Fztd     , Dd^Fztd     , Dd^Fztd     , Dd^Fztd     , Xos         , Xos         , Urb         , Urb         , Urb         , Xos         , Xos         , Dd^Fztd     , Dd^Fzts     , Dd^Fztd     , Dd^Vda      , Dd^Fztd     , Rd          , Rd          , Rd          , Rd          , Rd          , Rd          , Rd          , Dd^Vda      , Rd          , Rd          , Dd^Fzts     , Dd^Fztd     , Dd^Fztd     
Dd^Fzts     , Dd^Fzts     , Dd^Fztd     , Rd          , Rd          , Dd^Fztd     , Dd^Fzts     , Rd          , Rd          , Dd^Fztd     , Dd^Vda      , Dd^Fztd     , Dd^Vda      , Dd^Fztd     , Rd          , Dd^Vda      , Dd^Fztd     , Dd^Fztd     , Dd^Fztd     , Dd^Fztd     , Kd^Xo       , Dd^Fztd     , Xos         , Urb         , Urb         , Urb         , Xol         , Dd^Fztd     , Kd^Xo       , Dd^Fztd     , Dd^Fztd     , Dd^Fztd     , Dd^Vda      , Rd          , Rd          , Dd^Fzts     , Dd^Vda      , Dd^Fztd     , Rd          , Dd^Fzts     , Dd^Fzts     , Dd^Fztd     , Rd          , Dd^Fzts     , Dd^Fzts     , Dd^Fztd     
Dd^Fztd     , Dd^Fztd     , Dd^Vda      , Rd          , Rd          , Dd^Vda      , Dd^Fztd     , Dd^Fzts     , Dd^Vda      , Rd          , Rd          , Dd^Fztd     , Rd          , Rd          , Dd^Fztd     , Rd          , Dd^Fztd     , Dd^Fztd     , Kd^Xo       , Kd^Xo       , Kd^Xo       , Kd^Xo       , Xos         , Urb^Xo      , Xol         , Urb^Xo      , Xol         , Kd^Xo       , Kd^Xo       , Kd^Xo       , Kd^Xo       , Dd^Fztd     , Dd^Fztd     , Dd^Fztd     , Dd^Fzts     , Rd          , Rd          , Rd          , Dd^Fzts     , Rd          , Rd          , Dd^Vda      , Rd          , Dd^Fztd     , Dd^Fztd     , Dd^Fztd     
Dd^Fzts     , Dd^Fztd     , Rd          , Rd          , Rd          , Rd          , Rd          , Dd^Fztd     , Dd^Fztd     , Rd          , Dd^Fztd     , Rd          , Dd^Vda      , Dd^Fztd     , Dd^Fztd     , Dd^Fztd     , Kd^Xo       , Kd^Xo       , Kd^Xo       , Kd^Xo       , Rd          , Rd          , Rd          , Rd          , Rd          , Rd          , Rd          , Rd          , Rd          , Kd^Xo       , Kd^Xo       , Kd^Xo       , Kd^Xo       , Dd^Fztd     , Rd          , Rd          , Rd          , Dd^Fztd     , Dd^Fztd     , Dd^Fztd     , Dd^Fztd     , Rd          , Rd          , Dd^Vda      , Dd^Fztd     , Dd^Fztd     
Rd          , Rd          , Dd^Fztd     , Dd^Fzts     , Rd          , Dd^Vda      , Dd^Fztd     , Rd          , Rd          , Dd^Vda      , Rd          , Rd          , Dd^Fztd     , Dd^Fztd     , Dd^Fztd     , Dd^Fztd     , Kd^Xo       , Kd^Xo       , Rd          , Rd          , Rd          , Rd          , Rd          , Rd          , Rd^Vdt      , Rd          , Rd          , Rd          , Rd          , Rd          , Rd          , Kd^Xo       , Kd^Xo       , Rd          , Dd^Fztd     , Dd^Fzts     , Dd^Vda      , Rd          , Rd          , Dd^Vda      , Dd^Fztd     , Dd^Vda      , Rd          , Rd          , Dd^Fztd     , Dd^Fztd     
Dd^Fztd     , Dd^Fzts     , Dd^Fztd     , Dd^Vda      , Rd          , Dd^Fztd     , Dd^Fzts     , Dd^Fztd     , Dd^Vda      , Rd          , Rd          , Dd^Fztd     , Dd^Fztd     , Dd^Fztd     , Kd^Xo       , Kd^Xo       , Kd^Xo       , Kd^Xo       , Rd          , Rd          , Cdr         , Rd          , Rd          , Rd          , Rd          , Rd          , Rd          , Rd          , Cdr         , Rd          , Rd          , Kd^Xo       , Kd^Xo       , Kd^Xo       , Kd^Xo       , Dd^Fztd     , Dd^Fztd     , Rd          , Rd          , Dd^Fztd     , Dd^Fztd     , Rd          , Rd          , Rd          , Dd^Vda      , Dd^Fztd     
Dd^Fztd     , Dd^Fzts     , Dd^Fztd     , Dd^Fztd     , Rd          , Rd          , Rd          , Dd^Fztd     , Dd^Fztd     , Rd          , Dd^Fztd     , Rd          , Rd          , Dd^Fztd     , Kd^Xo       , Kd^Xo       , Kd^Xo       , Rd          , Rd          , Rd          , Rd          , Rd          , Rd          , Rd^Dr       , Rd^Dr       , Rd^Dr       , Rd          , Rd          , Rd          , Rd          , Rd          , Rd          , Kd^Xo       , Kd^Xo       , Kd^Xo       , Dd^Fztd     , Dd^Fztd     , Dd^Fztd     , Dd^Vda      , Rd          , Rd          , Rd          , Dd^Fzts     , Rd          , Dd^Fztd     , Dd^Fztd     
Rd          , Rd          , Rd          , Dd^Vda      , Rd          , Rd          , Rd          , Rd          , Rd          , Rd          , Dd^Fztd     , Dd^Fzts     , Dd^Fztd     , Kd^Xo       , Kd^Xo       , Kd^Xo       , Rd          , Rd          , Rd^Vdt      , Rd          , Rd^Dr       , Rd          , Rd^Vdt      , Rd          , Rd          , Rd          , Rd^Vdt      , Rd          , Rd^Dr       , Rd          , Rd^Vdt      , Rd          , Rd          , Kd^Xo       , Kd^Xo       , Kd^Xo       , Dd^Fztd     , Dd^Fztd     , Rd          , Rd          , Dd^Fztd     , Dd^Fztd     , Dd^Fzts     , Rd          , Dd^Vda      , Dd^Fztd     
Dd^Fztd     , Dd^Fzts     , Dd^Fztd     , Rd          , Rd          , Dd^Fztd     , Dd^Fztd     , Dd^Vda      , Rd          , Dd^Vda      , Dd^Fztd     , Dd^Fztd     , Kd^Xo       , Kd^Xo       , Kd^Xo       , Kd^Xo       , Rd          , Rd          , Rd          , Rd          , Rd^Dr       , Rd          , Rd          , Rd          , Rd          , Rd          , Rd          , Rd          , Rd^Dr       , Rd          , Rd          , Rd          , Rd          , Kd^Xo       , Kd^Xo       , Kd^Xo       , Kd^Xo       , Rd          , Dd^Fztd     , Rd          , Dd^Vda      , Dd^Fztd     , Dd^Vda      , Rd          , Dd^Fzts     , Dd^Fztd     
Dd^Fztd     , Dd^Fzts     , Dd^Vda      , Dd^Fztd     , Rd          , Dd^Fzts     , Dd^Fztd     , Dd^Fztd     , Rd          , Dd^Fztd     , Dd^Fzts     , Dd^Fztd     , Kd^Xo       , Kd^Xo       , Kd^Xo       , Rd          , Rd          , Rd          , Rd          , Rd^Dr       , Rd          , Rd          , Rd          , Rd          , Rd          , Rd          , Rd          , Rd          , Rd          , Rd^Dr       , Rd          , Rd          , Rd          , Rd          , Kd^Xo       , Kd^Xo       , Kd^Xo       , Dd^Fztd     , Dd^Vda      , Rd          , Dd^Fztd     , Dd^Fztd     , Rd          , Rd          , Dd^Fztd     , Dd^Fztd     
Dd^Fztd     , Dd^Fztd     , Dd^Fztd     , Dd^Fzts     , Rd          , Dd^Vda      , Dd^Fztd     , Dd^Vda      , Rd          , Dd^Fztd     , Dd^Fztd     , Dd^Fztd     , Kd^Xo       , 7 Kd^Xo     , Kd^Xo       , Rd          , Rd          , Rd          , Cdr         , Rd          , Rd^Vdt      , Rd          , Rd          , Rd          , Rd          , Rd          , Rd          , Rd          , Rd^Vdt      , Rd          , Cdr         , Rd          , Rd          , Rd          , Kd^Xo       , Kd^Xo       , Kd^Xo       , Dd^Fztd     , Dd^Fztd     , Rd          , Dd^Vda      , Dd^Fztd     , Rd          , Dd^Vda      , Dd^Fzts     , Dd^Fztd     
Rd          , Dd^Fztd     , Rd          , Dd^Fztd     , Rd          , Rd          , Rd          , Dd^Fztd     , Rd          , Dd^Vda      , Dd^Fztd     , Dd^Fztd     , Kd^Xo       , Kd^Xo       , Kd^Xo       , Rd          , Rd          , Rd          , Rd          , Rd          , Rd          , Rd          , Rd          , Rd          , Rd          , Rd          , Rd          , Rd          , Rd          , Rd          , Rd          , Rd          , Rd          , Rd          , Kd^Xo       , Kd^Xo       , Kd^Xo       , Dd^Fztd     , Dd^Fzts     , Rd          , Dd^Fztd     , Dd^Fztd     , Rd          , Dd^Fzts     , Dd^Fztd     , Dd^Fztd     
Dd^Fztd     , Rd          , Dd^Fztd     , Rd          , Rd          , Rd          , Dd^Fzts     , Rd          , Rd          , Dd^Fztd     , Dd^Fzts     , Dd^Fztd     , Kd^Xo       , Kd^Xo       , Kd^Xo       , Rd          , Rd          , Rd          , Rd          , Rd^Dr       , Rd^Dr       , Rd          , Rd          , Rd          , Rd          , Rd          , Rd          , Rd          , Rd^Dr       , Rd^Dr       , Rd          , Rd          , Rd          , Rd          , Kd^Xo       , Kd^Xo       , Kd^Xo       , Dd^Fztd     , Dd^Fztd     , Rd          , Rd          , Rd          , Rd          , Dd^Vda      , Dd^Fzts     , Dd^Fztd     
Dd^Fztd     , Dd^Fzts     , Dd^Fzts     , Dd^Vda      , Rd          , Dd^Fztd     , Dd^Fztd     , Dd^Vda      , Rd          , Rd          , Rd          , Rd          , Dd^Fztd     , Kd^Xo       , Kd^Xo       , Kd^Xo       , Rd          , Rd          , Rd^Vdt      , Rd          , Rd^Dr       , Rd          , Rd^Vdt      , Rd          , Rd          , Rd          , Rd^Vdt      , Rd          , Rd^Dr       , Rd          , Rd^Vdt      , Rd          , Rd          , Kd^Xo       , Kd^Xo       , Kd^Xo       , Dd^Fzts     , Rd          , Rd          , Rd          , Dd^Vda      , Dd^Fztd     , Dd^Fztd     , Rd          , Dd^Fztd     , Dd^Fzts     
Dd^Fzts     , Dd^Fztd     , Dd^Fzts     , Dd^Fztd     , Rd          , Dd^Vda      , Rd          , Rd          , Dd^Vda      , Rd          , Dd^Vda      , Dd^Fztd     , Dd^Fztd     , Kd^Xo       , Kd^Xo       , Kd^Xo       , Kd^Xo       , Rd          , Rd          , Rd          , Rd          , Rd          , Rd          , Rd          , Rd^Dr       , Rd          , Rd          , Rd          , Rd          , Rd          , Rd          , Rd          , Kd^Xo       , Kd^Xo       , Kd^Xo       , Kd^Xo       , Dd^Fztd     , Dd^Fztd     , Dd^Vda      , Rd          , Rd          , Dd^Fztd     , Dd^Fzts     , Rd          , Dd^Fzts     , Dd^Fztd     
Dd^Fztd     , Dd^Fzts     , Rd          , Rd          , Rd          , Rd          , Dd^Vda      , Dd^Fzts     , Dd^Fztd     , Rd          , Rd          , Dd^Fztd     , Dd^Fztd     , Dd^Fztd     , Kd^Xo       , Kd^Xo       , Kd^Xo       , Rd          , Rd          , Rd          , Cdr         , Rd          , Rd          , Rd^Dr       , Rd          , Rd^Dr       , Rd          , Rd          , Cdr         , Rd          , Rd          , Rd          , Kd^Xo       , Kd^Xo       , Kd^Xo       , Dd^Fztd     , Dd^Vda      , Dd^Fzts     , Rd          , Rd          , Dd^Fztd     , Rd          , Rd          , Rd          , Dd^Fztd     , Dd^Fztd     
Rd          , Rd          , Rd          , Dd^Fztd     , Dd^Vda      , Rd          , Dd^Fztd     , Dd^Fztd     , Dd^Fztd     , Dd^Vda      , Rd          , Dd^Fztd     , Dd^Fztd     , Dd^Fztd     , Dd^Fztd     , Kd^Xo       , Kd^Xo       , Kd^Xo       , Rd          , Rd          , Rd          , Rd          , Rd          , Rd          , Rd^Vdt      , Rd          , Rd          , Rd          , Rd          , Rd          , Rd          , Kd^Xo       , Kd^Xo       , Kd^Xo       , Dd^Fztd     , Dd^Fzts     , Dd^Fzts     , Rd          , Rd          , Dd^Vda      , Dd^Fztd     , Rd          , Rd          , Dd^Vda      , Dd^Fztd     , Dd^Fztd     
Rd          , Rd          , Rd          , Dd^Fztd     , Dd^Fzts     , Rd          , Rd          , Dd^Vda      , Dd^Fztd     , Dd^Fztd     , Rd          , Dd^Vda      , Dd^Fztd     , Dd^Fzts     , Rd          , Kd^Xo       , Kd^Xo       , Kd^Xo       , Kd^Xo       , Rd          , Rd          , Rd          , Rd          , Rd          , Rd          , Rd          , Rd          , Rd          , Rd          , Rd          , Kd^Xo       , Kd^Xo       , Kd^Xo       , Kd^Xo       , Rd          , Dd^Vda      , Rd          , Rd          , Dd^Vda      , Dd^Fztd     , Dd^Fztd     , Dd^Fzts     , Rd          , Dd^Fzts     , Dd^Fztd     , Dd^Fzts     
Dd^Fztd     , Dd^Vda      , Rd          , Dd^Vda      , Dd^Fztd     , Dd^Fztd     , Dd^Fztd     , Rd          , Rd          , Dd^Fzts     , Dd^Vda      , Rd          , Rd          , Rd          , Dd^Fztd     , Dd^Fztd     , Dd^Fztd     , Kd^Xo       , Kd^Xo       , Kd^Xo       , Kd^Xo       , Rd          , Xol         , Rd          , Xos         , Rd          , Xos         , Rd          , Kd^Xo       , Kd^Xo       , Kd^Xo       , Kd^Xo       , Dd^Fztd     , Dd^Fztd     , Dd^Fzts     , Rd          , Rd          , Dd^Fztd     , Dd^Fztd     , Dd^Fzts     , Rd          , Rd          , Rd          , Dd^Fzts     , Dd^Fztd     , Gs^Fzty     
Dd^Fztd     , Dd^Fztd     , Rd          , Dd^Fztd     , Dd^Vda      , Dd^Fzts     , Dd^Fztd     , Dd^Fztd     , Dd^Vda      , Rd          , Rd          , Rd          , Rd          , Dd^Fztd     , Dd^Fztd     , Dd^Fztd     , Dd^Fztd     , Dd^Fztd     , Dd^Fztd     , Kd^Xo       , Xol         , Xol         , Urb         , Urb         , Urb         , Urb         , Urb         , Xol         , Xol         , Kd^Xo       , Dd^Fzts     , Dd^Fztd     , Dd^Fztd     , Dd^Fzts     , Rd          , Rd          , Dd^Vda      , Rd          , Rd          , Rd          , Dd^Vda      , Dd^Fzts     , Rd          , Dd^Vda      , Dd^Fztd     , Dd^Fztd     
Rd          , Rd          , Rd          , Rd          , Dd^Fztd     , Dd^Fzts     , Dd^Vda      , Dd^Fztd     , Rd          , Rd          , Dd^Vda      , Dd^Fztd     , Dd^Vda      , Rd          , Rd          , Dd^Vda      , Dd^Fztd     , Dd^Fztd     , Xol         , Xol         , Urb         , Urb         , Urb         , Urb         , Urb         , Urb         , Urb         , Urb         , Urb         , Xol         , Xol         , Dd^Fzts     , Dd^Fztd     , Dd^Vda      , Rd          , Dd^Fztd     , Dd^Fztd     , Dd^Fzts     , Dd^Fzts     , Rd          , Dd^Fzts     , Dd^Fzts     , Rd          , Dd^Fzts     , Dd^Fzts     , Dd^Fztd     
Rd          , Rd          , Dd^Vda      , Rd          , Rd          , Dd^Fzts     , Rd          , Rd          , Rd          , Dd^Fztd     , Dd^Fztd     , Dd^Fzts     , Dd^Fztd     , Dd^Fztd     , Rd          , Rd          , Dd^Fztd     , Dd^Fzts     , Xol         , Urb         , Urb         , Urb         , Urb         , Urb         , Urb         , Urb         , Urb         , Urb         , Urb         , Urb         , Xol         , Dd^Fzts     , Dd^Fzts     , Rd          , Rd          , Dd^Fztd     , Rd          , Dd^Fzts     , Rd          , Dd^Fztd     , Rd          , Rd          , Dd^Vda      , Dd^Fzts     , Dd^Fzts     , Dd^Fztd     
Dd^Fztd     , Dd^Fztd     , Dd^Fzts     , Dd^Fztd     , Dd^Vda      , Rd          , Rd          , Dd^Vda      , Dd^Fzts     , Rd          , Rd          , Dd^Vda      , Dd^Fztd     , Dd^Vda      , Rd          , Dd^Vda      , Dd^Fztd     , Dd^Fztd     , Xol         , Urb         , Urb         , Urb         , Urb         , Urb         , Urb         , Urb         , Urb         , Urb         , Urb         , Urb         , Xol         , Dd^Fzts     , Dd^Fzts     , Dd^Vda      , Rd          , Rd          , Dd^Vda      , Rd          , Dd^Fzts     , Rd          , Dd^Fzts     , Dd^Fztd     , Dd^Fztd     , Dd^Fztd     , Dd^Fzts     , Dd^Fztd     
Rd          , Dd^Fzts     , Dd^Fzts     , Dd^Fzts     , Rd          , Rd          , Rd          , Dd^Fztd     , Dd^Fztd     , Dd^Fztd     , Dd^Vda      , Rd          , Rd          , Rd          , Dd^Vda      , Dd^Fztd     , Dd^Fztd     , Xol         , Xol         , Urb         , Urb         , Urb         , Urb         , Urb         , Urb         , Urb         , Urb         , Urb         , Urb         , Urb         , Xol         , Dd^Fztd     , Rd          , Rd          , Dd^Vda      , Rd          , Dd^Fzts     , Dd^Fzts     , Dd^Fztd     , Dd^Vda      , Dd^Fzts     , Dd^Fztd     , Dd^Fzts     , Dd^Fztd     , Dd^Fzts     , Dd^Fztd     
Rd          , Dd^Vda      , Rd          , Rd          , Rd          , Dd^Vda      , Dd^Fztd     , Rd          , Rd          , Rd          , Rd          , Rd          , Rd          , Dd^Fztd     , Dd^Fzts     , Dd^Fztd     , Dd^Fztd     , Xol         , Xol         , Urb         , Urb         , Urb         , Urb         , Urb         , Urb         , Urb         , Urb         , Urb         , Urb         , Urb         , Xol         , Dd^Fztd     , Rd          , Rd          , Dd^Fztd     , Rd          , Rd          , Dd^Fztd     , Dd^Fzts     , Dd^Fzts     , Dd^Fztd     , Dd^Fzts     , Dd^Fzts     , Dd^Fztd     , Dd^Fzts     , Dd^Fzts     
Dd^Fztd     , Rd          , Dd^Vda      , Rd          , Rd          , Dd^Fztd     , Dd^Fzts     , Dd^Vda      , Rd          , Dd^Vda      , Dd^Fztd     , Dd^Fztd     , Rd          , Rd          , Dd^Fzts     , Dd^Fztd     , Dd^Fztd     , Xol         , Xol         , Xol         , Xol         , Urb         , Urb         , Urb         , Urb         , Urb         , Urb         , Urb         , Xol         , Xol         , Xol         , Dd^Vda      , Rd          , Rd          , Rd          , Rd          , Rd          , Dd^Vda      , Dd^Fzts     , Dd^Fztd     , Dd^Fztd     , Dd^Fztd     , Dd^Fzts     , Dd^Fzts     , Dd^Fzts     , Dd^Fzts     
Dd^Fztd     , Dd^Fzts     , Dd^Fzts     , Rd          , Dd^Fzts     , Dd^Fztd     , Dd^Fztd     , Dd^Vda      , Rd          , Dd^Fztd     , Dd^Fztd     , Dd^Vda      , Dd^Fztd     , Rd          , Dd^Fztd     , Dd^Vda      , Dd^Fztd     , Xol         , Xol         , Xol         , Xol         , Xol         , Xol         , Xol         , Xol         , Xol         , Xol         , Xol         , Xol         , Xol         , Xol         , Rd          , Rd          , Dd^Vda      , Dd^Fztd     , Dd^Fzts     , Dd^Fzts     , Rd          , Rd          , Dd^Fztd     , Dd^Fztd     , Dd^Fzts     , Dd^Fztd     , Dd^Fzts     , Dd^Fzts     , Dd^Fzts     
