border_size=1
usage=map

Rb^Gvs      , Rb^Gvs      , Rb^Gvs      , Rb^Gvs      , Rb^Gvs      , Rb^Gvs      , Rb^Gvs      , Gg          , Gg          , Gg          , Gg          , Rb^Gvs      , Rb^Gvs      , Rb^Gvs      , Re          , Gg          , Gg          , Gg          , Gg          , Gg          , Gg          , Gg          , Gg          , Gg          , Gg          , Rrc         , Gg          , Gg          , Gg          , Gg          , Gg          , Gg          , Gg          , Gg          , Ww          , Ww          , Gg          , Gg          , Gg          , Re          , Gg          , Rb^Gvs      , Rb^Gvs      , Rb^Gvs      , Rb^Gvs      , Gg          
Rb^Gvs      , Rb^Gvs      , Rb^Gvs      , Rb^Gvs      , Gg          , Gg          , Gg          , Gg^Es       , Rb^Gvs      , Gg          , Gg^Efm      , Gg          , Re          , Re          , Rb^Gvs      , Gg          , Rb^Gvs      , Gg          , Gg          , Gg^Efm      , Gg          , Gg          , Rb^Gvs      , Rb^Gvs      , Rrc         , Rrc         , Rb^Gvs      , Gg          , Gg          , Gg          , Gg          , Gg          , Ss          , Ss          , Ww          , Ss          , Rb^Gvs      , Gg          , Re^Vh       , Re          , Re^Vh       , Rb^Gvs      , Rb^Gvs      , Rb^Gvs      , Rb^Gvs      , Gg          
Gg          , Gg          , Rb^Gvs      , Gg          , Gg^Efm      , Rb^Gvs      , Rb^Gvs      , Rb^Gvs      , Rb^Gvs      , Rb^Gvs      , Rb^Gvs      , Gg          , Re          , Rb^Gvs      , Rb^Gvs      , Rb^Gvs      , Rb^Gvs      , Rb^Gvs      , Gg          , Gg          , Rb^Gvs      , Rb^Gvs      , Re^Vh       , Rb^Gvs      , Rrc         , Rb^Gvs      , Rb^Gvs      , Rb^Gvs      , Gg          , Gg^Efm      , Gg          , Ss          , Ww          , Ww          , Rb^Gvs      , Rb^Gvs      , Rb^Gvs      , Rb^Gvs      , Re          , Re          , Rb^Gvs      , Gg          , Gg          , Gg^Es       , Gg          , Gg          
Gg          , Rb^Gvs      , Rb^Gvs      , Gg          , Gg          , Rb^Gvs      , Rb^Gvs      , Rb^Gvs      , Re^Vh       , Rb^Gvs      , Re          , Re          , Re^Vh       , Rb^Gvs      , Rb^Gvs      , Rb^Gvs      , Rb^Gvs      , Rb^Gvs      , Gg^Efm      , Gg^Em       , Gg          , Rb^Gvs      , Rb^Gvs      , Rrc         , Re^Vh       , Rb^Gvs      , Rb^Gvs      , Rb^Gvs      , Gg          , Gg          , Ss          , Ww          , Gg          , Rb^Gvs      , Rb^Gvs      , Rb^Gvs      , Rb^Gvs      , Rb^Gvs      , Re          , Re^Vh       , Rb^Gvs      , Rb^Gvs      , Rb^Gvs      , Gg^Em       , Gg          , Hh^Fds      
Rb^Gvs      , Rb^Gvs      , Rb^Gvs      , Rb^Gvs      , Rb^Gvs      , Gg          , Gg          , Rb^Gvs      , Re          , Re          , Gg          , Re          , Re          , Rb^Gvs      , Rb^Gvs      , Rb^Gvs      , Gg          , Gg          , Gg          , Gg          , Gg          , Rb^Gvs      , Rb^Gvs      , Rrc         , Rb^Gvs      , Rb^Gvs      , Rb^Gvs      , Rb^Gvs      , Gg          , Gg          , Ww          , Ww          , Gg          , Gg^Es       , Rb^Gvs      , Rb^Gvs      , Re          , Re          , Rb^Gvs      , Rb^Gvs      , Rb^Gvs      , Rb^Gvs      , Rb^Gvs      , Gg          , Hh^Fds      , Hh^Fds      
Gg          , Rb^Gvs      , Rb^Gvs      , Rb^Gvs      , Rb^Gvs      , Gg          , Re          , Re          , Rb^Gvs      , Gg          , Gg^Efm      , Gg^Es       , Rb^Gvs      , Re          , Re          , Gg          , Re          , Re          , Re          , Gg^Es       , Gg          , Gg          , Rrc         , Rrc         , Gg          , Rb^Gvs      , Gg          , Gg          , Gg          , Ss          , Ww          , Gg          , Gg^Efm      , Gg          , Gg          , Re          , Gg^Vwm      , Rb^Gvs      , Rb^Gvs      , Rb^Gvs      , Rb^Gvs      , Rb^Gvs      , Hh^Fds      , Hh^Fds      , Hh^Fds      , Hh^Fds      
Rb^Gvs      , Rb^Gvs      , Rb^Gvs      , Re^Vh       , Rr          , Re          , Rb^Vwm      , Rb^Gvs      , Rb^Gvs      , Rb^Gvs      , Gg          , Rb^Gvs      , Rb^Gvs      , Re^Vh       , Rb^Gvs      , Re          , Rb^Gvs      , Re^Vh       , Rb^Gvs      , Re          , Re          , Rrc         , Rb^Gvs      , Rb^Gvs      , Rb^Gvs      , Gg          , Gg          , Gg^Efm      , Ww          , Ww          , Rb^Gvs      , Rb^Gvs      , Rb^Gvs      , Gg          , Re          , Re          , Gg          , Rb^Gvs      , Rb^Gvs      , Rb^Gvs      , Rb^Gvs      , Rb^Gvs      , Hh^Fms      , Hh^Fds      , Hh^Fds      , Hh^Fds      
Gg          , Gg          , Rr          , Rr          , Re^Vh       , Rr          , Re^Vh       , Rb^Gvs      , Rb^Gvs      , Rb^Gvs      , Gg          , Rb^Gvs      , Rb^Gvs      , Rb^Gvs      , Re          , Re          , Rb^Gvs      , Rb^Gvs      , Rb^Gvs      , Rb^Gvs      , Gg          , Rrc         , Rrc         , Re^Vh       , Rb^Gvs      , Rb^Gvs      , Ss          , Gg          , Ww          , Rb^Gvs      , Rb^Gvs      , Rb^Gvs      , Rb^Gvs      , Re          , Rb^Gvs      , Rb^Gvs      , Rb^Gvs      , Gg^Efm      , Gg          , Gg          , Hh^Fds      , Hh^Fds      , Hh^Fms      , Hh^Fms      , Hh^Fds      , Hh^Fds      
Rr          , Rr          , Rb^Gvs      , Rb^Gvs      , Rb^Gvs      , Rr          , Rr          , Rb^Gvs      , Rb^Gvs      , Rb^Gvs      , Gg          , Rb^Gvs      , Rb^Gvs      , Rb^Gvs      , Re          , Gg          , Gg          , Rb^Gvs      , Rb^Gvs      , Rb^Gvs      , Rb^Gvs      , Rb^Gvs      , Rb^Gvs      , Rrc         , Rrc         , Rb^Gvs      , Ww          , Ww          , Gg          , Rb^Gvs      , Rb^Gvs      , Rb^Gvs      , Re^Vh       , Re          , Re^Vh       , Rb^Gvs      , Rb^Gvs      , Rb^Gvs      , Rb^Gvs      , Hh^Fds      , Hh^Fds      , Hh^Fds      , Hh^Fds      , Hh^Fds      , Hh^Fms      , Hh^Fds      
Gg          , Rb^Gvs      , Rb^Gvs      , Rb^Gvs      , Rb^Gvs      , Rb^Gvs      , Rr          , Rb^Gvs      , Rb^Gvs      , Rb^Gvs      , Gg^Efm      , Gg^Em       , Gg          , Rb^Gvs      , Rb^Gvs      , Re          , Re          , Rb^Gvs      , Re^Vh       , Rb^Gvs      , Rb^Gvs      , Rb^Gvs      , Rb^Gvs      , Rb^Gvs      , Ww          , Ww^Bsb\     , Rrc         , Ch          , Ch          , Gg          , Gg          , Rb^Gvs      , Re          , Re          , Rb^Gvs      , Rb^Gvs      , Rb^Gvs      , Rb^Gvs      , Rb^Gvs      , Hh^Fds      , Hh^Fds      , Hh^Fms      , Hh^Fms      , Hh^Fms      , Hh^Fds      , Hh^Fms      
Gg          , Gg          , Rb^Gvs      , Rb^Gvs      , Rb^Gvs      , Rb^Gvs      , Re^Vh       , Rr          , Gg          , Gg          , Rb^Gvs      , Rb^Gvs      , Rb^Gvs      , Rb^Gvs      , Rb^Gvs      , Re^Vh       , Rb^Gvs      , Re          , Re          , Rb^Gvs      , Ww          , Ww          , Ww          , Ww          , Ch          , Ch          , Rrc         , Rrc         , Rrc         , Ch          , Re          , Re          , Rb^Gvs      , Gg          , Gg          , Rb^Gvs      , Rb^Gvs      , Rb^Gvs      , Gg^Es       , Gg          , Gg          , Hh^Fms      , Hh^Fds      , Hh^Fds      , Hh^Fds      , Hh^Fds      
Re^Vh       , Gg          , Gg^Efm      , Rb^Gvs      , Rb^Gvs      , Rb^Gvs      , Rb^Gvs      , Rr          , Rr          , Rb^Gvs      , Rb^Gvs      , Rb^Gvs      , Rb^Gvs      , Rb^Gvs      , Rb^Gvs      , Rb^Gvs      , Rb^Gvs      , Rb^Gvs      , Ss          , Re          , Ww^Bsb\     , Ss          , Ch          , Ch          , Rrc         , Rrc         , Rrc         , Rrc         , Rrc         , Ch          , Re          , Re^Vh       , Rb^Gvs      , Rb^Gvs      , Rb^Gvs      , Gg          , Gg          , Gg          , Hh^Fds      , Hh^Fds      , Hh^Fms      , Hh^Fms      , Hh^Fds      , Hh^Fds      , Hh^Fms      , Hh^Fds      
Rb^Gvs      , Rb^Gvs      , Rb^Gvs      , Gg^Efm      , Gg          , Gg          , Rb^Gvs      , Rb^Gvs      , Rb^Gvs      , Rr          , Rr          , Re^Vh       , Rb^Gvs      , Gg          , Ss          , Ss          , Ww          , Ww          , Ww          , Ww          , Ch          , Rrc         , Rrc         , Rrc         , Rrc         , Rrc         , Rrc^Vhc     , Rrc         , Rrc         , Re          , Ch          , Rb^Gvs      , Rb^Gvs      , Rb^Gvs      , Gg          , Gg^Efm      , Gg          , Hh^Fds      , Hh^Fms      , Hh^Fms      , Hh^Fds      , Hh^Fms      , Hh^Fms      , Hh^Fms      , Hh^Fds      , Hh^Fds      
Rb^Gvs      , Rb^Gvs      , Rb^Gvs      , Rb^Gvs      , Gg          , Rb^Gvs      , Rb^Gvs      , Rb^Gvs      , Rb^Gvs      , Rb^Gvs      , Rb^Gvs      , Rr          , Rr          , Gg          , Ww          , Ww          , Ch          , Ch          , Ww^Ewl      , Ch          , Rrc         , Rrc         , Rrc         , Rrc^Vhc     , Rrc         , Rrc         , Rrc         , Rrc         , Rrc         , Rrc         , Ch          , Rb^Gvs      , Hh^Fms      , Hh^Fms      , Hh^Fms      , Gg          , Hh^Fms      , Hh^Fms      , Mm^Fds      , Mm^Fds      , Mm^Fds      , Mm^Fds      , Mm^Fms      , Mm^Fds      , Mm^Fds      , Mm^Fds      
Rb^Gvs      , Rb^Gvs      , Gg          , Rb^Gvs      , Gg          , Gg          , Gg          , Rb^Gvs      , Ss          , Rb^Gvs      , Ww          , Ss          , Ww          , Ww^Bsb\     , Rrc         , Ch          , Rrc         , Rrc         , Rrc         , Ww^Ewl      , Rrc         , Rrc^Vhc     , Rrc         , Rrc         , Rrc         , Rrc         , Rrc         , Rrc         , Rrc         , Rrc         , Hh^Fms      , Hh^Fms      , Hh^Fms      , Hh^Fms      , Hh^Fms      , Hh^Fms      , Mm^Fms      , Mm^Fds      , Mm^Fds      , Mm^Fds      , Mm          , Mm^Fds      , Mm^Fds      , Mm^Fds      , Mm          , Mm          
Gg          , Rb^Gvs      , Gg          , Gg^Em       , Gg          , Gg          , Ss          , Ss          , Ww          , Ww          , Gg^Es       , Ww          , Ch          , Ch          , Rrc         , Rrc         , Rrc         , Rrc         , Rrc         , Ww^Bsb/     , Rrc^Vhc     , Rrc         , Rrc         , Rrc^Vhc     , Rrc         , Rrc         , Rrc         , Rrc^Vhc     , Rrc         , Rrc         , Hh^Fms      , Mm^Fms      , Mm^Fms      , Mm^Fms      , Mm^Fms      , Mm^Fms      , Mm^Fms      , Mm^Fms      , Mm          , Mm          , Mm          , Mm          , Mm          , Mm          , Mm^Xm       , Mm^Xm       
Gg          , Gg^Es       , Gg^Efm      , Gg          , Ww          , Ww          , Ww          , Ww          , Gg          , Gg          , Gg          , Ch          , Rrc         , Rrc         , Rrc         , Rrc         , Rrc^Vhc     , Rrc         , Rrc^Vhc     , Ww^Ewl      , Ww^Ewl      , Rrc         , Rrc^Vhc     , Rrc         , Rrc         , Rrc         , Rrc         , Rrc         , Rrc^Vhc     , Hh^Fms      , Mm^Fms      , Mm^Fms      , Mm^Fds      , Mm^Fms      , Mm^Fms      , Mm^Fms      , Mm          , Mm          , Mm          , Mm          , Mm          , Mm          , Mm^Xm       , Mm^Xm       , Mm^Xm       , Mm^Xm       
Ww          , Gg          , Ww          , Ww          , Ss          , Ss          , Rb^Gvs      , Rb^Gvs      , Gg          , Gg^Efm      , Ch          , Ch          , Rrc         , Rrc^Vhc     , Rrc         , Rrc         , Rrc         , Rrc         , Ww^Ewf      , Ww^Ewl      , Ww^Ewl      , Ww^Ewl      , Rrc         , Rrc         , Rrc         , Rrc^Vhc     , Rrc         , Rrc         , Rrc         , Hh^Fms      , Hh^Fms      , Mm^Fms      , Mm^Fds      , Mm^Fms      , Mm          , Mm          , Mm          , Mm          , Mm^Xm       , Mm          , Mm^Xm       , Mm^Xm       , Mm^Xm       , Mm^Xm       , Mm^Xm       , Mm^Xm       
Hh^Fms      , Ww          , Hh^Fms      , Hh^Fms      , Rb^Gvs      , Rb^Gvs      , Rb^Gvs      , Rb^Gvs      , Ch          , Ch          , Rrc         , Rrc         , Rrc         , Rrc         , Rrc^Vhc     , Rrc         , Rrc^Vhc     , Rrc         , Ww^Ewl      , Ww^Ewl      , Ww^Ewf      , Ww^Ewl      , Rrc^Vhc     , Rrc         , Rrc         , Rrc         , Rrc         , Rrc         , Rrc^Vhc     , Rrc         , Rrc         , Mm^Fds      , Ch          , Mm          , Mm^Xm       , Mm          , Mm^Xm       , Mm^Xm       , Mm^Xm       , Mm^Xm       , Mm^Xm       , Mm^Xm       , Mm^Xm       , Mm^Xm       , Mm^Xm       , Mm^Xm       
Hh^Fms      , Hh^Fms      , Rrc         , Hh^Fms      , Rb^Gvs      , Rb^Gvs      , Rb^Gvs      , Rb^Gvs      , Ch          , Rrc         , Rrc         , Rrc         , Rrc^Vhc     , Rrc         , Rrc         , Rrc         , Rrc         , Rrc         , Rrc^Vhc     , Ww^Ewl      , Ww^Ewl      , Ww^Ewl      , Rrc         , Rrc         , Rrc^Vhc     , Rrc         , Rrc         , Rrc         , Rrc         , Rrc         , Rrc         , Ch          , Kh          , Mm^Xm       , Mm^Xm       , Mm^Xm       , Mm^Xm       , Mm^Xm       , Mm^Xm       , Mm^Xm       , Mm^Xm       , Mm^Xm       , Mm^Xm       , Mm^Xm       , Mm^Xm       , Mm^Xm       
Rrc         , Rrc         , Hh^Fms      , Rrc         , Rrc         , Re^Vh       , Ch          , Ch          , Rrc         , Rrc         , Rrc         , Rrc         , Rrc         , Rrc         , Rrc         , Rrc^Vhc     , Rrc         , Rrc         , Rrc         , Rrc         , Rrc         , Rrc         , Rrc         , Rrc         , Rrc         , Rrc         , Rrc^Vhc     , Rrc         , Rrc         , Rrc         , Ch          , Rrc         , Rrc         , Xol         , Xol         , Xol         , Xol         , Xol         , Xol         , Xol         , Xol         , Xol         , Xol         , Xol         , Xol         , Xol         
Hh^Fms      , Hh^Fms      , Hh^Fms      , Hh^Fms      , Ch          , Rrc         , Rrc^Vhc     , Rrc         , Rrc         , Rrc         , Rrc^Vhc     , Rrc         , Rrc         , Rrc^Vhc     , Rrc         , Rrc         , Rrc         , Rrc^Vhc     , Rrc         , Rrc         , Rrc         , Rrc^Vhc     , Rrc         , Rrc         , Rrc         , Rrc         , Rrc^Vhc     , Rrc         , Rrc         , Ch          , Mm^Xm       , Kh          , Xol         , Rrc         , Rrc         , Rrc         , Rrc         , Xol         , Rrc         , Rrc         , Rrc         , Xol         , Rrc         , Xol         , Xol         , Xol         
Hh^Fds      , Hh^Fms      , Hh^Fds      , Hh^Fds      , Ch          , Rrc         , Rrc         , Rrc         , Rrc         , Rrc         , Rrc         , Rrc         , Mm^Fms      , Rrc         , Rrc         , Rrc^Vhc     , Rrc         , Rrc         , Rrc         , Rrc^Vhc     , Rrc         , Rrc         , Rrc         , Rrc^Vhc     , Rrc         , Rrc         , Rrc         , Rrc         , Rrc         , Mm          , Mm^Xm       , Mm^Xm       , Xol         , Xol         , Rrc         , Rrc         , Rrc         , Rrc         , Rrc         , Rrc         , Rrc         , Rrc         , Rrc         , Rrc         , Xol         , Xol         
Mm^Fds      , Mm^Fds      , Mm^Fds      , Hh^Fds      , Ch          , Rrc         , Rrc         , Rrc^Vhc     , Rrc         , Rrc         , Mm^Fms      , Mm^Fms      , Mm^Fms      , Mm^Fms      , Mm^Fms      , Rrc         , Rrc         , Rrc         , Rrc^Vhc     , Rrc         , Rrc         , Rrc         , Rrc^Vhc     , Rrc         , Rrc         , Rrc         , Rrc         , Rrc^Vhc     , Rrc         , Rrc         , Rrc         , Mm^Xm       , Xol         , Xol         , Rrc         , Rrc         , Rrc         , Rrc         , Rrc         , Rrc         , Rrc         , Rrc         , Rrc         , Xol         , Xol         , Xol         
Mm^Fds      , Mm^Fds      , Mm^Fds      , Mm^Fds      , Ch          , Rrc         , Rrc         , Rrc         , Mm^Fms      , Mm^Fms      , Mm^Fms      , Mm^Fms      , Mm          , Mm^Fms      , Mm^Fms      , Rrc         , Rrc         , Rrc         , Rrc         , Rrc         , Rrc         , Rrc         , Mm          , Mm          , Mm          , Mm          , Mm          , Rrc         , Rrc         , Rrc^Vhc     , Rrc         , Mm^Xm       , Xol         , Rrc         , Rrc         , Rrc         , Rrc         , Rrc         , Rrc         , Rrc         , Rrc         , Rrc         , Rrc         , Xol         , Xol         , Xol         
Mm^Xm       , Mm          , Mm^Xm       , Mm^Xm       , Mm^Xm       , Ch          , Rrc         , Ch          , Mm          , Mm          , Mm          , Mm          , Mm          , Mm          , Mm^Xm       , Ch          , Ch          , Rrc         , Ch          , Ch          , Mm^Xm       , Mm^Xm       , Mm^Xm       , Mm          , Mm^Xm       , Mm          , Mm^Xm       , Rrc         , Rrc         , Rrc         , Mm^Xm       , Mm^Xm       , Xol         , Xol         , Xol         , Rrc         , Xol         , Xol         , Xol         , Xol         , Xol         , Xol         , Xol         , Xol         , Xol         , Xol         
Mm^Xm       , Mm^Xm       , Mm^Xm       , Mm^Xm       , Mm^Xm       , Kh          , Rrc         , Kh          , Mm^Xm       , Mm^Xm       , Mm^Xm       , Mm^Xm       , Mm^Xm       , Mm^Xm       , Mm^Xm       , Mm^Xm       , Kh          , Rrc         , Kh          , Mm^Xm       , Mm^Xm       , Mm^Xm       , Mm^Xm       , Mm^Xm       , Mm^Xm       , Mm^Xm       , Mm^Xm       , Mm^Xm       , Mm^Xm       , Mm^Xm       , Kh          , Kh          , Iwr         , Iwr         , Iwr         , Xol         , Xol         , Xol         , Xol         , Xol         , Xol         , Xol         , Xol         , Xol         , Xol         , Xol         
Xol         , Xol         , Xol         , Xol         , Xol         , Xol         , Rrc         , Xol         , Xol         , Xol         , Xol         , Xol         , Xol         , Xol         , Xol         , Xol         , Xol         , Rrc         , Xol         , Xol         , Xol         , Xol         , Xol         , Xol         , Xol         , Xol         , Xol         , Xol         , Xol         , Xol         , Xol         , Iwr         , Iwr         , Iwr         , Iwr         , Iwr         , Iwr         , Iwr         , Iwr         , Iwr         , Iwr         , Iwr         , Iwr         , Xol         , Xol         , Xol         
Xol         , Xol         , Rrc         , Rrc         , Rrc         , Rrc         , Rrc         , Xol         , Xol         , Xol         , Rrc         , Xol         , Xol         , Xol         , Rrc         , Rrc         , Rrc         , Rrc         , Xol         , Xol         , Xol         , Xol         , Xol         , Xol         , Xol         , Xol         , Xol         , Xol         , Xol         , Xol         , Xol         , Iwr         , Iwr         , Iwr         , Iwr         , Iwr         , Iwr         , Iwr         , Iwr         , Iwr         , Iwr         , Iwr         , Iwr         , Xol         , Xol         , Xol         
Xol         , Xol         , Rrc         , Rrc         , Rrc         , Rrc         , Rrc         , Xol         , Xol         , Rrc         , Rrc         , Rrc         , Rrc         , Rrc         , Rrc         , Rrc         , Rrc         , Xol         , Xol         , Xol         , Xol         , Xol         , Xol         , Xol         , Iwr         , Iwr         , Iwr         , Iwr         , Iwr         , Iwr         , Iwr         , Xol         , Iwr         , Iwr         , Iwr         , Iwr         , Iwr         , Iwr         , Iwr         , Iwr         , Iwr         , Iwr         , Iwr         , Iwr         , Xol         , Xol         
Xol         , Xol         , Rrc         , Rrc         , Rrc         , Rrc         , Rrc         , Xol         , Xol         , Rrc         , Rrc         , Rrc         , Rrc         , Rrc         , Rrc         , Rrc         , Rrc         , Xol         , Xol         , Xol         , Iwr         , Xol         , Iwr         , Iwr         , Iwr         , Iwr         , Iwr         , Iwr         , Iwr         , Iwr         , Iwr         , Iwr         , Iwr         , Iwr         , Iwr         , Iwr         , Iwr         , Iwr         , Iwr         , Iwr         , Iwr         , Iwr         , Iwr         , Iwr         , Xol         , Xol         
Xol         , Xol         , Xol         , Rrc         , Rrc         , Rrc         , Xol         , Xol         , Xol         , Rrc         , Rrc         , Rrc         , Rrc         , Rrc         , Rrc         , Rrc         , Rrc         , Rrc         , Rrc         , Iwr         , Iwr         , Iwr         , Iwr         , Iwr         , Iwr         , Iwr         , Iwr         , Iwr         , Iwr         , Iwr         , Iwr         , Iwr         , Iwr         , Iwr         , Iwr         , Iwr         , Iwr         , Iwr         , Iwr         , Iwr         , Iwr         , Iwr         , Iwr         , Iwr         , Xol         , Xol         
Xol         , Xol         , Xol         , Rrc         , Rrc         , Rrc         , Xol         , Xol         , Xol         , Xol         , Xol         , Rrc         , Rrc         , Rrc         , Rrc         , Rrc         , Rrc         , Rrc         , Iwr         , Iwr         , Iwr         , Iwr         , Iwr         , Iwr         , Iwr         , Iwr         , Iwr         , Iwr         , Iwr         , Iwr         , Iwr         , Iwr         , Iwr         , Iwr         , Iwr         , Iwr         , Iwr         , Iwr         , Iwr         , Iwr         , Iwr         , Iwr         , Iwr         , Iwr         , Xol         , Xol         
Xol         , Xol         , Xol         , Rrc         , Xol         , Xol         , Xol         , Xol         , Xol         , Xol         , Xol         , Xol         , Xol         , Rrc         , Xol         , Rrc         , Xol         , Xol         , Xol         , Xol         , Xol         , Xol         , Xol         , Xol         , Xol         , Iwr         , Iwr         , Iwr         , Iwr         , Iwr         , Xol         , Xol         , Xol         , Iwr         , Xol         , Iwr         , Xol         , Iwr         , Iwr         , Iwr         , Iwr         , Iwr         , Xol         , Xol         , Xol         , Xol         
Xol         , Xol         , Xol         , Xol         , Xol         , Xol         , Xol         , Xol         , Xol         , Xol         , Xol         , Xol         , Xol         , Xol         , Xol         , Xol         , Xol         , Xol         , Xol         , Xol         , Xol         , Xol         , Xol         , Xol         , Xol         , Xol         , Xol         , Xol         , Xol         , Xol         , Xol         , Xol         , Xol         , Xol         , Xol         , Xol         , Xol         , Xol         , Xol         , Xol         , Xol         , Xol         , Xol         , Xol         , Xol         , Xol         
