border_size=1
usage=map

Gll^Fds     , Gll^Fds     , Gll^Fds     , Gll^Fds     , Gll^Fds     , Gg^Fds      , Gg^Fds      , Gg^Fds      , Gg          , Gg          , Gg^Es       , Gg          , Gg          , Gg          , Gg          , Gg          , Gg          , Gg          , Gg          , Gg          , Gg          , Rr          , Gg          , Gg          , Gg^Fds      , Gll^Fds     , Hh^Fds      , Gg^Fds      , Gg          , Gg^Fds      , Gll^Fds     , Gll^Fds     , Gll^Fds     , Gll^Fds     , Gg^Fds      , Gg^Fds      , Ss          , Ww          , Ss          , Gg^Fds      , Gll^Fds     , Gg^Fds      , Gg          , Gg          , Gg          , Gg          
Gll^Fds     , Gll^Fms     , Gll^Fms     , Gll^Fds     , Gll^Fms     , Gg^Fds      , Gg^Fds      , Gg^Fds      , Gg          , Gg^Es       , Gg^Es       , Gg^Es       , Gg          , Gg          , Gg^Fds      , Gg^Fds      , Gg^Fds      , Gg          , Gg^Fds      , Gg^Es       , Gg          , Rr          , Gg          , Gg^Es       , Gg          , Hh^Fms      , Hh^Fms      , Gg^Fds      , Gg^Es       , Gg^Fds      , Gll^Fds     , Gll^Fds     , Gll^Fds     , Gg^Fds      , Gg^Fds      , Ss          , Ww          , Ww          , Ss          , Gg^Fds      , Gll^Fds     , Gg^Fds      , Gg          , Gg          , Gg^Efm      , Gg          
Gll^Fms     , Gll^Fds     , Gll^Fds     , Gll^Fds     , Gg^Fds      , Gg^Fds      , Gg          , Gg          , Gg^Efm      , Gg          , Gg          , Gg          , Gg          , Gg^Fds      , Hh^Fds      , Gll^Fms     , Hh^Fms      , Gll^Fds     , Gg^Fds      , Gg          , Gg          , Rr          , Gg^Vl       , Gg^Efm      , Gg^Es       , Gg^Fds      , Gg^Efm      , Gg          , Gg          , Gg^Fds      , Gll^Fds     , Gll^Fms     , Gg^Fds      , Gg^Fds      , Ss          , Ss          , Ww          , Ss          , Gg^Fds      , Gll^Fds     , Gll^Fds     , Gg^Fds      , Gg          , Gg          , Gg^Efm      , Gg          
Gg^Fds      , Gg^Fds      , Gg          , Gg^Fds      , Gg^Es       , Gg          , Gg          , Gg^Efm      , Gg^Efm      , Gg^Es       , Gg          , Gg^Efm      , Gg          , Gg^Fds      , Gg^Fds      , Hh^Fds      , Gg^Fds      , Gg^Fds      , Gg          , Gg^Es       , Rr          , Rr          , Gll^Fds     , Gg^Fds      , Gg          , Gg          , Gg^Es       , Gg^Es       , Gg          , Gg^Fds      , Gll^Fds     , Gll^Fds     , Gg^Fds      , Gg^Fds      , Ww          , Ww          , Ss          , Ss          , Gll^Fds     , Gll^Fds     , Gll^Fds     , Gg^Fds      , Gg^Fds      , Gg          , Gg^Efm      , Gg          
Gg          , Gg^Es       , Gg          , Gg          , Gg^Es       , Gg^Es       , Gg          , Gg          , Gg^Es       , Gg^Es       , Gg          , Gg^Efm      , Gg          , Gg^Fds      , Gg          , Gg^Fds      , Gg^Fds      , Gg          , Rr          , Rr          , Gll^Fds     , Hh^Fds      , Hh^Fms      , Gg^Fds      , Hh^Fds      , Gg^Es       , Gg          , Gg^Efm      , Gll^Fds     , Gll^Fds     , Gg^Fds      , Gg^Fds      , Gs^Fds      , Wwf^Fds     , Ww          , Ss          , Gg^Fds      , Gg^Fds      , Gll^Fds     , Gll^Fms     , Gll^Fds     , Gg^Fds      , Gg^Efm      , Gg^Es       , Gg^Efm      , Gg          
Gg          , Gg^Fds      , Gg^Fds      , Gg          , Gg^Fds      , Gg          , Gg          , Gg^Es       , Gg          , Gg          , Gg          , Gg          , Gg          , Gg^Es       , Gg          , Gg          , Rr          , Rr          , Hh^Fds      , Hh^Fds      , Hh^Fds      , Hh^Fms      , Mm^Fms      , Hh^Fds      , Hh^Fds      , Hh^Fds      , Gg^Fds      , Gll^Fds     , Gll^Fms     , Gll^Fds     , Ss          , Ss          , Ww          , Ww          , Ss          , Ss          , Gg^Fds      , Gg^Fds      , Gll^Fds     , Gll^Fds     , Gg^Fds      , Gg^Fds      , Gg^Efm      , Gg^Efm      , Re          , Re          
Gg^Fds      , Gg^Fds      , Gll^Fms     , Gg^Fds      , Gg^Fds      , Gg          , Gg          , Gg^Es       , Gg          , Gg          , Gg          , Gg^Fds      , Gg^Fds      , Gg^Es       , Rr          , Rr          , Gg^Es       , Gg^Es       , Gg^Fds      , Hh^Fds      , Hh^Fds      , Mm^Fds      , Mm^Fds      , Mm^Fms      , Gg^Fds      , Gg^Fds      , Hh^Fds      , Gll^Fds     , Gg^Fds      , Ss          , Ss          , Wwf         , Ww          , Wwf         , Gg^Fds      , Gg^Fds      , Gll^Fds     , Gll^Fds     , Gg^Fds      , Gll^Fds     , Gg^Fds      , Gg^Es       , Gg^Efm      , Re          , Gg          , Gg          
Gll^Fds     , Gll^Fms     , Gll^Fms     , Gll^Fds     , Gg^Fds      , Gg          , Gg          , Gg          , Gg^Fds      , Gg          , Gll^Fds     , Gg^Fds      , Gll^Fds     , Rr          , Gg^Fds      , Gg^Fds      , Gg^Fds      , Gg^Fds      , Gg^Fds      , Hh^Fds      , Hh^Fms      , Mm^Fds      , Chr         , Mm^Fms      , Khr         , Hh^Fms      , Hh^Fds      , Gll^Fds     , Ss          , Ss          , Wwf         , Ww          , Wwf         , Ss          , Gg^Fds      , Gll^Fms     , Gll^Fds     , Gll^Fds     , Gg^Fds      , Gg^Fds      , Gg          , Gg          , Gg          , Re          , Gg          , Gg^Es       
Gg^Fds      , Gll^Fds     , Gg^Fds      , Gg^Fds      , Gg          , Gg^Es       , Gg          , Gg^Fds      , Gg^Fds      , Gg^Fds      , Hh^Fds      , Hh^Fms      , Ce          , Rr          , Ce          , Gll^Fds     , Gll^Fms     , Gg^Fds      , Hh^Fds      , Hh^Fms      , Mm^Fms      , Mm^Fds      , Mm^Fds      , Chr         , Hh^Fds      , Hh^Fds      , Gg^Fds      , Gg^Fds      , Wwf^Fds     , Wwf         , Ww          , Ww          , Ss          , Ss          , Gll^Fds     , Gll^Fds     , Gll^Fds     , Gll^Fds     , Gg          , Gg          , Re          , Gg          , Re          , Re          , Gg^Vl       , Gg          
Gg^Fds      , Gg^Fds      , Ss^Fds      , Gg^Fds      , Gg          , Gg          , Gg^Efm      , Gg^Efm      , Gg^Fds      , Gg^Fds      , Hh^Fds      , Hh^Fds      , Gll^Fds     , Rr          , Gll^Fds     , Gll^Fds     , Gll^Fds     , Hh^Fds      , Hh^Fds      , Hh          , Hh^Fms      , Mm^Fms      , Mm^Fds      , Hh^Fds      , Hh^Fms      , Hh^Fds      , Gg^Fds      , Gg^Fds      , Wwf         , Ww          , Ww          , Ss          , Gg^Fds      , Gg^Fds      , Gll^Fds     , Gll^Fms     , Gg^Fds      , Gg^Fds      , Re          , Re          , Gg          , Re          , Gg          , Gg          , Gg^Fds      , Gg^Fds      
Wwf         , Wwf         , Wwf         , Gg^Fds      , Gg^Fds      , Gg          , Gg          , Gg^Efm      , Gg^Efm      , Gg^Fds      , Gg^Fds      , Gg^Fds      , Gll^Fds     , Rr          , Gll^Fds     , Gll^Fms     , Gll^Fds     , Gg^Fds      , Hh^Fds      , Hh^Fds      , Hh^Fds      , Mm^Fds      , Mm^Fds      , Hh^Vhh      , Gg^Fds      , Gg^Fds      , Ss          , Gg^Fds      , Ww          , Ww          , Gg^Fds      , Ss          , Gg^Fds      , Gll^Fds     , Gll^Fds     , Gll^Fds     , Gg          , Gg          , Re          , Gg^Es       , Gg          , Gg          , Gg^Fds      , Gg^Fds      , Gg^Fds      , Gg^Fds      
Gg^Fds      , Ss^Fds      , Gg^Fds      , Wwf         , Wwf         , Ss          , Ss          , Gg^Es       , Gg          , Gg          , Gg          , Gg^Fds      , Gg^Vl       , Rr          , Rr          , Gll^Fds     , Gg^Fds      , Gg^Fds      , Gg^Es       , Hh^Fds      , Gg^Es       , Gg^Fds      , Hh^Fds      , Hh^Fds      , Gg^Fds      , Gg^Fds      , Ss          , Ww          , Wwf         , Wwf         , Gg^Fds      , Gg^Fds      , Gll^Fds     , Gll^Fds     , Gll^Fds     , Gll^Fds     , Gg^Fds      , Gg^Efm      , Re          , Gg          , Gg          , Gg^Fds      , Gg^Fds      , Gg^Fds      , Gg^Fds      , Gg^Fds      
Gg^Fds      , Gg^Fds      , Gg^Fds      , Gg^Fds      , Gg^Fds      , Wwf         , Wwf         , Wwf         , Wwf         , Gg^Es       , Gg^Efm      , Gg          , Gg^Es       , Re          , Gg^Es       , Rr          , Rr          , Gg^Es       , Rr          , Rr          , Rr          , Gg^Fds      , Gg^Fds      , Gll^Fds     , Gg^Fds      , Ss          , Wwf         , Ww          , Ss          , Ss          , Gg^Fds      , Gg^Fds      , Gll^Fms     , Gll^Fds     , Gg^Fds      , Gg^Fds      , Gg          , Gg          , Re          , Gg          , Gg^Es       , Gg          , Gg^Fds      , Gg^Fds      , Gll^Fms     , Gg^Fds      
Gg^Fds      , Gll^Fds     , Gll^Fms     , Gll^Fds     , Gll^Fds     , Gg^Fds      , Gg^Fds      , Ss          , Gg          , Wwf         , Gg^Efm      , Gg          , Re          , Re          , Gg^Es       , Gg^Es       , Gg^Fds      , Rr          , Gg^Fds      , Gg^Fds      , Gg^Fds      , Rr          , Rr          , Gg^Fds      , Gg^Fds      , Wwf         , Ww          , Ww          , Ss          , Ss          , Gll^Fds     , Gll^Fds     , Gg^Fds      , Gg^Fds      , Gg          , Gg          , Re          , Re          , Gg          , Gg          , Gg          , Gg^Fds      , Gg^Fds      , Gg^Fds      , Gg^Fds      , Gg^Fds      
Gg^Fds      , Gll^Fds     , Gll^Fds     , Gll^Fds     , Gll^Fms     , Gg^Fds      , Gg          , Gg          , Gg          , Wwf         , Wwf^Bw/r    , Re          , Gg          , Gg^Es       , Gg^Es       , Gg^Fds      , Gll^Fds     , Gll^Fds     , Gll^Fms     , Gg^Fds      , Gg^Fds      , Gg^Fds      , Ss          , Rr          , Ww^Bsb\     , Ww          , Gg^Fds      , Gg^Fds      , Gg^Fds      , Gg^Fds      , Gll^Fds     , Gll^Fds     , Gg^Fds      , Gg^Fds      , Gg          , Re          , Gg          , Gg          , Gg^Es       , Gg^Efm      , Gg^Efm      , Gg^Efm      , Gg^Efm      , Gg^Fds      , Gg^Fds      , Gg^Fds      
Gg          , Gg^Fds      , Gg^Fds      , Gg^Fds      , Gg^Fds      , Gg^Fds      , Gg          , Gg^Es       , Re          , Re          , Ss          , Wwf         , Gg          , Gg          , Gll^Fds     , Gg^Fds      , Gll^Fds     , Gll^Fds     , Gg^Fds      , Gg^Fds      , Ss          , Ss          , Ww          , Ww          , Wwf         , Wwf^Bsb\    , Rr          , Gg^Vl       , Gg^Fds      , Gg^Fds      , Gg^Efm      , Gg^Fds      , Gg          , Gg^Es       , Re          , Re          , Gg^Efm      , Gg          , Gg          , Gg          , Gg          , Gg^Efm      , Gg          , Gg          , Gg          , Gg          
Gg          , Gg          , Gg          , Gg          , Gg          , Gg          , Gg          , Re          , Gg          , Gg          , Gg          , Wwf         , Gll^Fds     , Gll^Fms     , Gll^Fds     , Gll^Fds     , Gg^Fds      , Gg^Fds      , Ss          , Ss          , Wwf         , Ww          , Wwf         , Wwf         , Rr          , Rr          , Gg^Fds      , Gg^Fds      , Gg^Fds      , Gg^Efm      , Gg          , Gg^Efm      , Gg          , Re          , Gg^Efm      , Gg^Efm      , Gg^Fds      , Gg^Fds      , Gg^Fds      , Gg^Fds      , Gg^Fds      , Gg^Fds      , Gg          , Gg^Efm      , Gg^Efm      , Gg          
Gg          , Gg          , Gg          , Gg^Es       , Gg          , Gg^Efm      , Gg^Efm      , Re          , Gg          , Gg^Es       , Gg^Fds      , Wwf         , Ss^Fds      , Ss^Fds      , Gg^Fds      , Gg^Fds      , Gg^Fds      , Gg^Fds      , Ss          , Wwf         , Ww          , Ww          , Gll^Fds     , Rr          , Gll^Fds     , Gll^Fds     , Gll^Fds     , Gll^Fds     , Gg^Fds      , Gg^Efm      , Gg^Fds      , Gg^Fds      , Gg          , Re          , Re          , Gg^Efm      , Gg          , Gg^Fds      , Gg^Fds      , Gg^Fds      , Gg^Fds      , Gg^Fds      , Gg          , Gg          , Gg^Efm      , Gg^Efm      
Gg^Fds      , Gg          , Gg^Fds      , Gg          , Gg^Efm      , Gg^Efm      , Gg^Efm      , Re          , Gg          , Gg          , Gg^Fds      , Wwf         , Wwf         , Gg^Fds      , Ss          , Gg^Fds      , Ss          , Ss          , Ww          , Ww          , Wwf^Fds     , Gll^Fds     , Re          , Rr          , Rr          , Gll^Fds     , Gll^Fds     , Gll^Fms     , Gll^Fds     , Gg^Fds      , Gll^Fds     , Gll^Fds     , Gg^Eff      , Gg^Eff      , Re          , Gg          , Gg^Fds      , Gll^Fms     , Gg^Fds      , Gg^Fds      , Gg^Fds      , Gg^Fds      , Gg          , Gg^Es       , Gg^Efm      , Gg^Efm      
Gll^Fds     , Gll^Fds     , Gll^Fds     , Gg^Fds      , Gg          , Gg^Efm      , Re          , Re          , Gll^Fms     , Gg^Fds      , Gg^Fds      , Gg^Fds      , Wwf         , Wwf^Fds     , Ww          , Wwf^Fds     , Ww          , Ww          , Wwf         , Wwf         , Re          , Re          , Gll^Fds     , Gll^Fds     , Gll^Fds     , Rr          , Rr          , Gll^Fds     , Gg^Eff      , Gll^Fds     , Gg^Eff      , Gg^Eff      , Rb^Gvs      , Rb^Gvs      , Re          , Gg^Eff      , Gg^Eff      , Gg^Fds      , Gg^Eff      , Gg^Fds      , Gg^Fds      , Gg          , Gg          , Gg^Efm      , Gg          , Gg          
Gg^Fds      , Gll^Fms     , Gg^Fds      , Gll^Fds     , Gg          , Re          , Gg^Efm      , Gg^Fds      , Gll^Fds     , Gll^Fds     , Gg^Fds      , Ss          , Ww          , Ww          , Ss          , Ww          , Wwf         , Wwf         , Re          , Re          , Gg          , Gg^Fds      , Gg^Fds      , Gll^Fds     , Gg^Fds      , Gll^Fds     , Gg^Eff      , Rr          , Rr          , Gg^Eff      , Rb^Gvs      , Rb^Gvs      , Rb^Gvs      , Rb^Gvs      , Re          , Gg          , Rb^Gvs      , Gg^Eff      , Rb^Gvs      , Gg^Eff      , Gg^Eff      , Gg          , Gg          , Gg          , Gg^Fds      , Gg^Fds      
Gg          , Gg^Fds      , Gg^Fds      , Gg^Fds      , Re          , Re          , Gg^Efm      , Gll^Fds     , Gll^Fds     , Gg^Fds      , Gg^Fds      , Ww          , Wwf         , Ss          , Gg          , Ss          , Re          , Re          , Gg          , Gg^Efm      , Gg^Es       , Gg          , Gg          , Gg^Fds      , Gg^Eff      , Gg^Eff      , Rb^Gvs      , Rb^Gvs      , Rb^Vc       , Rr          , Rr          , Rb^Vc       , Rb^Gvs      , Rb^Gvs      , Re          , Rb^Gvs      , Rb^Gvs      , Rb^Gvs      , Rb^Gvs      , Rb^Gvs      , Gg          , Gg^Eff      , Gg^Eff      , Gg          , Gg^Fds      , Gll^Fms     
Gg^Efm      , Gg          , Gg^Es       , Gg          , Re          , Gg^Efm      , Gg^Efm      , Gll^Fds     , Gll^Fds     , Gg^Fds      , Ss          , Ww          , Ss          , Ss          , Re          , Re          , Gg^Fds      , Gg          , Gg          , Gg          , Gg          , Gg          , Gg          , Gg          , Gg^Eff      , Gg^Eff      , Rb^Gvs      , Rb^Gvs      , Rb^Gvs      , Rb^Gvs      , Rr          , Gg          , Gg          , Gg          , Re          , Rb^Gvs      , Rb^Gvs      , Rb^Gvs      , Rb^Vc       , Gg          , Gg          , Gg          , Rb^Gvs      , Gg^Eff      , Gg^Eff      , Gg^Fds      
Re          , Gg^Efm      , Gg          , Gg^Vl       , Re          , Gg          , Gg^Efm      , Gll^Fms     , Gg^Fds      , Gg^Fds      , Ww          , Ww          , Re          , Re          , Gg^Fds      , Gg^Fds      , Gll^Fds     , Gg^Fds      , Gg          , Gg          , Gg^Fds      , Gg          , Gll^Fds     , Gg^Eff      , Gll^Eff     , Rb^Gvs      , Rb^Gvs      , Rb^Gvs      , Gg          , Gg          , Rb^Gvs      , Rr          , Rr          , Re          , Gg          , Rb^Gvs      , Rb^Gvs      , Rb^Gvs      , Re          , Gg          , Rb^Gvs      , Rb^Gvs      , Rb^Gvs      , Rb^Gvs      , Rb^Gvs      , Gg^Eff      
Gg          , Re          , Re          , Re          , Re          , Gg^Es       , Gg          , Gg^Fds      , Gg^Fds      , Ss          , Ww          , Wwf^Fds     , Re          , Gg^Fds      , Gll^Fds     , Gll^Fds     , Gll^Fms     , Gg^Fds      , Gg          , Gg          , Gg          , Gg^Fds      , Gll^Fds     , Gll^Fms     , Gg^Fds      , Gg^Eff      , Gg^Eff      , Rb^Gvs      , Gg          , Rb^Gvs      , Rb^Gvs      , Rb^Vc       , Rr          , Gg^Es       , Gg          , Gg^Wm       , Gg          , Gg          , Re          , Rb^Gvs      , Rb^Vc       , Rb^Gvs      , Rb^Gvs      , Rb^Gvs      , Gg^Eff      , Gg^Eff      
Gg^Fds      , Gg          , Gg          , Gg^Es       , Gg          , Re          , Re          , Gg^Fds      , Gg^Fds      , Ss          , Ww          , Wwf         , Re          , Gg^Fds      , Gll^Fms     , Gll^Fds     , Gg^Fds      , Gg          , Gg^Efm      , Gg          , Gg          , Gg          , Gg          , Gg^Fds      , Gg          , Gg^Eff      , Gg^Eff      , Gg          , Rb^Gvs      , Rb^Gvs      , Rb^Gvs      , Rb^Gvs      , Rr          , Gg          , Gg          , Gg          , Re          , Re          , Gg          , Rb^Gvs      , Re          , Rb^Gvs      , Rb^Gvs      , Rb^Gvs      , Gg          , Gg^Eff      
Gll^Fds     , Gg^Fds      , Gg^Fds      , Gg          , Gg          , Gg          , Gg          , Re          , Re          , Ss          , Ss          , Ww          , Re          , Gg^Fds      , Gll^Fds     , Gll^Fds     , Gg^Fds      , Gg          , Gg          , Gg          , Gg          , Gg          , Gg^Efm      , Gg^Es       , Gg          , Gg^Eff      , Gg^Eff      , Rb^Gvs      , Rb^Gvs      , Rb^Gvs      , Rb^Gvs      , Rb^Gvs      , Gg          , Rr          , Rr          , Re^Vh       , Gg          , Gg          , Gg          , Gg          , Re^Vh       , Gg          , Gg          , Gg          , Re          , Re          
Gll^Fds     , Gll^Fms     , Gg^Fds      , Gg^Efm      , Gg          , Gg^Es       , Gg^Fds      , Gg^Fds      , Gll^Fds     , Re          , Re          , Ww          , Re          , Gg^Fds      , Gg^Fds      , Gg^Fds      , Gg          , Gg          , Gg          , Gg^Es       , Gg          , Gg          , Gg          , Gg          , Gg          , Gg          , Gg^Eff      , Gg^Eff      , Gg          , Rb^Vc       , Re          , Gg          , Re^Vh       , Re          , Gg          , Rr          , Rr          , Gg^Es       , Re          , Re          , Re          , Gg          , Re          , Re          , Rb^Gvs      , Rb^Gvs      
Gll^Fms     , Gll^Fds     , Gg          , Gg          , Gg          , Gg          , Gg^Fds      , Gll^Fds     , Gll^Fds     , Gg^Fds      , Gg^Fds      , Ww^Bw\      , Re          , Re          , Re          , Gg^Fds      , Gg          , Gg^Efm      , Gg          , Gg^Fds      , Gg^Fds      , Gg^Fds      , Gg^Fds      , Gg^Fds      , Gg          , Gg^Eff      , Re          , Re          , Re          , Re          , Gg          , Re          , Gg          , Re          , Re          , Gg          , Re^Vh       , Rr          , Gg          , Gg          , Re          , Re          , Gg          , Rb^Vc       , Rb^Gvs      , Rb^Gvs      
Gg^Fds      , Gg^Fds      , Gg          , Gg^Es       , Gg          , Gg^Fds      , Gll^Fds     , Gll^Fds     , Gg^Fds      , Gg^Fds      , Ss          , Ww          , Ss          , Gg^Fds      , Gg^Fds      , Re          , Re          , Gg          , Gg^Fds      , Gll^Fds     , Gll^Fms     , Gll^Fms     , Gg^Fds      , Gg^Fds      , Re          , Re          , Gg^Eff      , Rb^Gvs      , Rb^Gvs      , Rb^Gvs      , Rb^Gvs      , Rb^Vc       , Rb^Gvs      , Gg^Es       , Gg          , Re          , Gg^Es       , Rp          , Rr          , Gg^Es       , Re^Vh       , Gg          , Gg          , Gg          , Rb^Gvs      , Rb^Gvs      
Gg          , Gg^Fds      , Gg          , Gg          , Gll^Fds     , Gll^Fds     , Gll^Fds     , Gll^Fds     , Gg^Fds      , Wwf^Fds     , Ww          , Ww          , Ss          , Gg^Fds      , Gg^Fds      , Gg^Fds      , Gg^Vl       , Re          , Re          , Gg^Fds      , Gg^Fds      , Gg^Fds      , Re          , Re          , Gg^Eff      , Gg^Eff      , Rb^Gvs      , Rb^Gvs      , Rb^Gvs      , Rb^Gvs      , Rb^Gvs      , Rb^Gvs      , Gg          , Gg          , Re^Vh       , Re          , Re          , Gg          , Rp          , Re          , Gg          , Gg          , Rb^Gvs      , Rb^Gvs      , Gg          , Rb^Gvs      
Gg          , Gg          , Gg          , Gg^Efm      , Gll^Fds     , Gg^Fds      , Gg^Fds      , Gg^Fds      , Ww          , Ww          , Wwf         , Wwf         , Ss          , Gg^Fds      , Gll^Fds     , Gg^Fds      , Gg^Fds      , Gg          , Gg          , Re          , Re          , Re          , Gg          , Gg          , Gg          , Gg^Eff      , Gg^Eff      , Gg          , Rb^Gvs      , Rb^Gvs      , Gg          , Rb^Gvs      , Rb^Gvs      , Gg          , Rb^Gvs      , Gg          , Gg          , Rr^Vh       , Gg^Es       , Gg          , Rb^Gvs      , Rb^Gvs      , Rb^Gvs      , Rb^Gvs      , Rb^Gvs      , Gg          
Gg          , Gg          , Gg          , Gg          , Gg^Fds      , Gg^Fds      , Ss          , Ss          , Ww          , Wwf         , Wwf^Fds     , Ss          , Gg^Fds      , Gll^Fds     , Gll^Fms     , Gg^Fds      , Gg^Fds      , Gg          , Gg^Es       , Gg          , Re          , Gg          , Gg^Efm      , Gg^Es       , Gg          , Gg          , Gg          , Gg^Eff      , Gg^Eff      , Gg          , Rb^Gvs      , Gg          , Rb^Gvs      , Rb^Gvs      , Rb^Gvs      , Rb^Vc       , Re          , Rp          , Rr          , Gg          , Gg          , Rb^Vc       , Rb^Gvs      , Rb^Gvs      , Rb^Gvs      , Rb^Gvs      
Gg          , Gg^Efm      , Gg          , Gg          , Gg^Fds      , Ss          , Wwf         , Wwf         , Ww          , Wwf         , Gg^Fds      , Gg^Fds      , Gll^Fds     , Gll^Fds     , Gll^Fds     , Gll^Fds     , Gg^Fds      , Gg          , Re          , Re          , Gg^Efm      , Gg          , Gg          , Gg          , Gg          , Gg          , Gll^Fds     , Gll^Fds     , Gg^Fds      , Gg^Eff      , Gg^Eff      , Rb^Gvs      , Rb^Gvs      , Rb^Gvs      , Rb^Gvs      , Rb^Gvs      , Gg          , Gg^Es       , Rp          , Gg          , Gg          , Rb^Gvs      , Rb^Gvs      , Rb^Gvs      , Gg          , Gg          
Gg          , Gg          , Gg          , Gg^Fds      , Gg^Fds      , Ss          , Ww          , Ww          , Ss          , Gg^Fds      , Gg^Fds      , Gll^Fds     , Gll^Fds     , Gll^Fds     , Gll^Fds     , Gll^Fds     , Gg^Fds      , Gg          , Re          , Gg^Efm      , Gg^Efm      , Gg          , Gg          , Gg^Es       , Gg          , Gg^Fds      , Gg^Fds      , Gll^Fds     , Gg^Fds      , Gg^Fds      , Gg^Eff      , Rb^Eff      , Rb^Gvs      , Rb^Gvs      , Rb^Gvs      , Rb^Gvs      , Gg^Eff      , Gg^Eff      , Gg^Eff      , Rp          , Gg^Eff      , Gg^Eff      , Gg^Eff      , Gg          , Gg^Eff      , Gg^Eff      
