border_size=1
usage=map

Gg^Efm      , Gg^Efm      , Gg^Efm      , Gg^Efm      , Gg^Efm      , Gg          , Gg          , Gg          , Gg          , Gg          , Rb^Gvs      , Rb^Gvs      , Rb^Gvs      , Rrc         , Re^Vh       , Rb^Gvs      , Rb^Gvs      , Rb^Gvs      , Sm          , Ww          , Gg          , Rb^Gvs      , Rb^Gvs      , Rb^Gvs      , Rb^Gvs      , Rb^Gvs      , Rb^Gvs      , Gg          , Gs^Fds      , Gs^Fds      , Hh^Fds      , Mm^Fds      , Mm^Fds      , Mm^Fms      , Mm^Fms      
Gg^Efm      , Gg^Efm      , Gg^Efm      , Gg^Efm      , Gg          , Gg          , Gg          , Gg          , Gg          , Gg          , Rb^Gvs      , Rb^Gvs      , Rb^Gvs      , Rrc         , Rb^Gvs      , Rb^Gvs      , Rb^Gvs      , Rb^Gvs      , Ww          , Ww          , Gg          , Rb^Gvs      , Rb^Gvs      , Rb^Gvs      , Gg          , Gg          , Gg          , Gs^Fds      , Gs^Fds      , Gs^Fds      , Hh^Fds      , Hh^Fms      , Hh^Fms      , Mm^Fms      , Mm^Fms      
Gg^Efm      , Gg^Efm      , Gg          , Gg          , Gs^Fds      , Gs^Fds      , Gs^Fds      , Gg^Es       , Rb^Gvs      , Gg          , Gg          , Rb^Gvs      , Rb^Gvs      , Rrc         , Gg          , Rb^Gvs      , Ww          , Ww          , Sm          , Sm          , Gg          , Gg          , Gg          , Gg          , Gs^Fds      , Gs^Fds      , Gs^Fds      , Gs^Fds      , Gs^Fds      , Gs^Fds      , Gs^Fds      , Hh^Fds      , Hh^Fds      , Mm^Fms      , Mm^Fms      
Gg          , Gg          , Gs^Fds      , Gs^Fds      , Gs^Fds      , Gs^Fds      , Gs^Fds      , Gs^Fds      , Rb^Gvs      , Rb^Gvs      , Re^Vh       , Gg          , Re          , Rrc         , Rrc         , Gg          , Ww          , Sm          , Rb^Gvs      , Rb^Gvs      , Rb^Gvs      , Rb^Gvs      , Gg          , Gg^Es       , Gs^Fds      , Gs^Fds      , Gs^Fds      , Gs^Fds      , Gs^Fds      , Gs^Fds      , Gs^Fds      , Hh^Fds      , Hh^Fds      , Hh^Fms      , Hh^Fms      
Gg          , Gg          , Gs^Fds      , Gs^Fds      , Gs^Fds      , Gs^Fds      , Gs^Fds      , Gs^Fds      , Rb^Gvs      , Rb^Gvs      , Re          , Re          , Rb^Gvs      , Rb^Gvs      , Rrc         , Gg          , Ww          , Sm          , Rb^Gvs      , Rb^Gvs      , Gg          , Gg          , Gg^Efm      , Gg^Efm      , Gg^Efm      , Gs^Fds      , Gs^Fds      , Gs^Fds      , Gs^Fds      , Gs^Fds      , Gs^Fds      , Gs^Fds      , Gs^Fds      , Hh^Fms      , Hh^Fms      
Gg          , Gg          , Gs^Fds      , Gs^Fds      , Gs^Fds      , Gs^Fds      , Gs^Fds      , Gg          , Rb^Gvs      , Rb^Gvs      , Re          , Rb^Gvs      , Rb^Gvs      , Rb^Gvs      , Gg          , Rrc         , Ww^Bsb\     , Re^Vh       , Rb^Gvs      , Rb^Gvs      , 1 Kh        , Gg          , Gg          , Gg^Efm      , Gg^Efm      , Gg^Efm      , Gg          , Gs^Fds      , Rb^Gvs      , Gs^Fds      , Gg          , Gs^Fds      , Gs^Fds      , Hh^Fds      , Hh^Fms      
Gg          , Gs^Fds      , Gs^Fds      , Gs^Fds      , Gs^Fds      , Gs^Fds      , Gg          , Rb^Gvs      , Gg          , Rb^Gvs      , Re          , Re^Vh       , Rb^Gvs      , Rb^Gvs      , Gg          , Gg          , Ww          , Rrc         , Rrc         , Ch          , Ch          , Ch          , Ch          , Gg          , Gg          , Gg          , Rb^Gvs      , Rb^Gvs      , Rb^Gvs      , Gg          , Rb^Gvs      , Gs^Fds      , Gg          , Gs^Fds      , Hh^Fds      
Gg^Efm      , Gg          , Gg          , Gg          , Gg          , Gg          , Rb^Gvs      , Gg^Es       , Re          , Re          , Rb^Gvs      , Rb^Gvs      , Gg          , Gg          , Gg          , Gg^Es       , Ww          , Sm          , Sm          , Rrc         , Rrc         , Ch          , Ch          , Gg          , Gg          , Gg^Es       , Re^Vh       , Rb^Gvs      , Rb^Gvs      , Rb^Gvs      , Gg          , Gg          , Gg          , Gs^Fds      , Gs^Fds      
Gg^Efm      , Gg^Efm      , Gg          , Gg          , Rb^Gvs      , Rb^Gvs      , Rb^Gvs      , Re          , Re^Vh       , Rb^Gvs      , Rb^Gvs      , Rb^Gvs      , Gg          , Gg          , Gs^Fds      , Gg          , Gs^Fds      , Ww          , Ww          , Sm          , Sm          , Rrc         , Rrc         , Gg          , Gg          , Rb^Gvs      , Re          , Re          , Re          , Rb^Gvs      , Gg          , 2 Gg        , Rb^Gvs      , Gg          , Gg          
Gg          , Gg          , Rb^Gvs      , Rb^Gvs      , Rb^Gvs      , Rb^Gvs      , Re^Vh       , Re          , Rb^Gvs      , Rb^Gvs      , Rb^Gvs      , Rb^Gvs      , Gs^Fds      , Gs^Fds      , Gs^Fds      , Gs^Fds      , Gs^Fds      , Gs^Fds      , Sm          , Ww          , Ww          , Gs^Fds      , Rrc         , Re          , Re          , Re          , Rb^Gvs      , Gg          , Gs^Fds      , Re          , Re          , Rb^Gvs      , Rb^Gvs      , Rb^Gvs      , Rb^Gvs      
Re          , Gg          , Re          , Rb^Gvs      , Rb^Gvs      , Rb^Gvs      , Re          , Re          , Rb^Gvs      , Rb^Gvs      , Rb^Gvs      , Gg          , Gs^Fds      , Gs^Fds      , Gs^Fds      , Gs^Fds      , Gs^Fds      , Gs^Fds      , Ss          , Sm          , Ww          , Gs^Fds      , Rrc         , Re^Vh       , Rb^Gvs      , Rb^Gvs      , Rb^Gvs      , Gs^Fds      , Gs^Fds      , Gg          , Gs^Fds      , Re          , Rb^Gvs      , Rb^Gvs      , Rb^Gvs      
Gg          , Re          , Rb^Gvs      , Re          , Re          , Rb^Gvs      , Re          , Rb^Gvs      , Rb^Gvs      , Rb^Gvs      , Gg          , Gg          , Gg          , Gs^Fds      , Gs^Fds      , Gs^Fds      , Gs^Fds      , Gs^Fds      , Sm          , Sm          , Ww          , Gs^Fds      , Rrc         , Rb^Gvs      , Rb^Gvs      , Rb^Gvs      , Gs^Fds      , Gs^Fds      , Gs^Fds      , Gs^Fds      , Gg          , Re          , Re^Vh       , Rb^Gvs      , Rb^Gvs      
Rb^Gvs      , Rb^Gvs      , Rb^Gvs      , Re^Vh       , Rb^Gvs      , Re          , Re          , Gg          , Gg          , Gg          , Gg^Es       , Gg          , Gg          , Gs^Fds      , Gs^Fds      , Gs^Fds      , Gs^Fds      , Gs^Fds      , Ww          , Ww          , Gs^Fds      , Gs^Fds      , Rrc         , Rb^Gvs      , Rb^Gvs      , Gg          , Gg          , Gs^Fds      , Gs^Fds      , Gs^Fds      , Gg          , Re          , Re          , Rb^Gvs      , Rb^Gvs      
Rb^Gvs      , Rb^Gvs      , Rb^Gvs      , Rb^Gvs      , Rb^Gvs      , Rb^Gvs      , Gg          , Re          , Re          , Gg          , Rb^Gvs      , Rb^Gvs      , Rb^Gvs      , Gg          , Gs^Fds      , Gs^Fds      , Ww          , Ww          , Gs^Fds      , Gs^Fds      , Gs^Fds      , Rrc         , Gs^Fds      , Gg          , Rb^Gvs      , Rb^Gvs      , Rb^Gvs      , Gs^Fds      , Rb^Gvs      , Rb^Gvs      , Re          , Re          , Gg^Efm      , Re          , Re          
Gg          , Gg          , Gg          , Rb^Gvs      , Gg          , Rb^Gvs      , Gg          , Gg          , Gg          , Re          , Rb^Gvs      , Rb^Gvs      , Rb^Gvs      , Rb^Gvs      , Gg          , Gs^Fds      , Ww          , Sm          , Gs^Fds      , Gs^Fds      , Rrc         , Rrc         , Gs^Fds      , Gg^Em       , Rb^Gvs      , Rb^Gvs      , Re^Vh       , Rb^Gvs      , Re          , Re          , Rb^Gvs      , Gg          , Gg^Efm      , Gg^Efm      , Gg^Efm      
Rb^Gvs      , Gg          , Rb^Gvs      , Gg          , Gg          , Gg          , Gg          , Gg^Efm      , Gg          , Re          , Re^Vh       , Rb^Gvs      , Rb^Gvs      , Rb^Gvs      , Gg          , Ww          , Sm          , Gs^Fds      , Gs^Fds      , Gs^Fds      , Rrc         , Gs^Fds      , Gs^Fds      , Gs^Fds      , Gg          , Rb^Gvs      , Re          , Re          , Rb^Gvs      , Rb^Gvs      , Gg          , Gg          , Gg          , Gg^Efm      , Gg^Efm      
Rb^Gvs      , Rb^Gvs      , Rb^Gvs      , Gg          , Gs^Fds      , Gs^Fds      , Gs^Fds      , Gs^Fds      , Gs^Fds      , Re          , Re          , Rb^Gvs      , Rb^Gvs      , Rb^Gvs      , Gg          , Ww          , Gs^Fds      , Gs^Fds      , Gs^Fds      , Gs^Fds      , Rrc         , Gs^Fds      , Gs^Fds      , Gs^Fds      , Gg          , Rb^Gvs      , Re          , Re^Vh       , Rb^Gvs      , Gg          , Gs^Fds      , Gs^Fds      , Gs^Fds      , Gs^Fds      , Gg          
Rb^Gvs      , Rb^Gvs      , Gg          , Gg          , Gs^Fds      , Gs^Fds      , Gs^Fds      , Gs^Fds      , Gs^Fds      , Gg          , Rb^Gvs      , Re          , Re          , Gg          , Rb^Gvs      , Ww          , Ww          , Gs^Fds      , Sm          , Gs^Fds      , Gs^Fds      , Rrc         , Rrc         , Gs^Fds      , Gs^Fds      , Gg          , Re          , Rb^Gvs      , Rb^Gvs      , Gg          , Gs^Fds      , Gs^Fds      , Gs^Fds      , Gs^Fds      , Gg          
Rb^Gvs      , Gg          , Gg^Efm      , Gg^Efm      , Gs^Fds      , Gs^Fds      , Gs^Fds      , Gs^Fds      , Gs^Fds      , Rb^Gvs      , Rb^Gvs      , Re^Vh       , Re          , Gg          , Re^Vh       , Rb^Gvs      , Rb^Gvs      , Ww          , Ww          , Ww          , Ww          , Gs^Fds      , Gs^Fds      , Rrc         , Rrc         , Re          , Re          , Gg          , Gs^Fds      , Gs^Fds      , Gs^Fds      , Gs^Fds      , Gg          , Gg^Es       , Gg          
Gg          , Gg          , Gg          , Gg^Efm      , Gg          , Gs^Fds      , Gs^Fds      , Gs^Fds      , Gs^Fds      , Rb^Gvs      , Rb^Gvs      , Rb^Gvs      , Rb^Gvs      , Re          , Rb^Gvs      , Rb^Gvs      , Re          , Rb^Gvs      , Re          , Sm          , Ss          , Ww          , Gs^Fds      , Gs^Fds      , Rrc         , Rb^Gvs      , Re^Vh       , Re          , Re          , Gg          , Rb^Gvs      , Rb^Gvs      , Rb^Gvs      , Rb^Gvs      , Gg          
Gg          , Gg          , Rb^Gvs      , Rb^Gvs      , Gg          , Gs^Fds      , Rb^Gvs      , Rb^Gvs      , Gg          , Gg          , Rb^Gvs      , Rb^Gvs      , Rb^Gvs      , Re          , Re          , Re          , Gg^Es       , Re          , Gg^Em       , Re          , Re          , Ww          , Ww^Bsb/     , Rrc         , Rb^Gvs      , Rb^Gvs      , Rb^Gvs      , Rb^Gvs      , Rb^Gvs      , Re          , Re          , Re^Vh       , Rb^Gvs      , Rb^Gvs      , Gg          
Gg          , Rb^Gvs      , Rb^Gvs      , Rb^Gvs      , Rb^Gvs      , Rb^Gvs      , Rb^Gvs      , Rb^Gvs      , Rb^Gvs      , Rb^Gvs      , Rb^Gvs      , Gg^Es       , Re          , Re          , Rb^Gvs      , Gg          , Gg          , Gg          , Ch          , Ch          , Rrc         , Rrc         , Gg          , Ww          , Ww          , Rb^Gvs      , Gs^Fds      , Rb^Gvs      , Gs^Fds      , Gg          , Gg          , Re          , Gg          , Rb^Gvs      , Gg          
Gg          , Rb^Gvs      , Rb^Gvs      , Rb^Gvs      , Rb^Gvs      , Rb^Gvs      , Rb^Gvs      , Rb^Gvs      , Rb^Gvs      , Re^Vh       , Re          , Re          , Rb^Gvs      , Rb^Gvs      , Rb^Gvs      , Rb^Gvs      , Gg          , Ch          , 4 Kh        , Ch          , Rrc         , Gg          , Gg^Es       , Gg          , Ww          , Gs^Fds      , Gs^Fds      , Gs^Fds      , Gs^Fds      , Gs^Fds      , Gg          , Re          , Re          , Gg          , Gg          
Re          , Rb^Gvs      , Rb^Gvs      , Re^Vh       , Rb^Gvs      , Rb^Gvs      , Gg          , Rb^Gvs      , Re          , Re          , Re          , Re^Vh       , Rb^Gvs      , Rb^Gvs      , Rb^Gvs      , Gg          , Gg          , Ch          , Gs^Fds      , Ch          , Rrc         , Gg          , Gg          , Gg          , Ww          , Sm          , Ss          , Gs^Fds      , Gs^Fds      , Gs^Fds      , Rb^Gvs      , Rb^Gvs      , Re          , Rb^Gvs      , Rb^Gvs      
Gg          , Re          , Re          , Re          , Re          , Gg          , Re          , Re          , Rb^Gvs      , Re^Vh       , Rb^Gvs      , Re          , Re          , Rb^Gvs      , Rb^Gvs      , Gg          , Gs^Fds      , Gs^Fds      , Gs^Fds      , Gs^Fds      , Rrc         , Gg          , Gg          , Gg          , Ss          , Ww          , Ww          , Gs^Fds      , Gs^Fds      , Gs^Fds      , Rb^Gvs      , Rb^Gvs      , Re          , Re^Vh       , Rb^Gvs      
Gg          , Rb^Gvs      , Rb^Gvs      , Re^Vh       , Rb^Gvs      , Re          , Gg          , Rb^Gvs      , Rb^Gvs      , Rb^Gvs      , Rb^Gvs      , Rb^Gvs      , Re          , Rb^Gvs      , Gg          , Gg          , Gs^Fds      , Gs^Fds      , Gs^Fds      , Gs^Fds      , Rrc         , Gg          , Rb^Gvs      , Rb^Gvs      , Rb^Gvs      , Sm          , Ww          , Gs^Fds      , Gs^Fds      , Gs^Fds      , Rb^Gvs      , Re^Vh       , Re          , Rb^Gvs      , Rb^Gvs      
Gg          , Rb^Gvs      , Rb^Gvs      , Rb^Gvs      , Rb^Gvs      , Rb^Gvs      , Gg          , Gg          , Gg          , Rb^Gvs      , Rb^Gvs      , Rb^Gvs      , Gg          , Re          , Gg          , Gg^Es       , Gg          , Gs^Fds      , Gs^Fds      , Gs^Fds      , Gs^Fds      , Rrc         , Rrc         , Re^Vh       , Rb^Gvs      , Sm          , Sm          , Ww          , Gg          , Gg          , Rb^Gvs      , Rb^Gvs      , Re          , Rb^Gvs      , Rb^Gvs      
Gg          , Gg          , Rb^Gvs      , Rb^Gvs      , Rb^Gvs      , Gg          , Gs^Fds      , Gs^Fds      , Gs^Fds      , Gs^Fds      , Gs^Fds      , Gg          , Gg          , Re          , Re          , Rb^Gvs      , Rb^Gvs      , Gg          , Gs^Fds      , Gs^Fds      , Gs^Fds      , Gs^Fds      , Rrc         , Rb^Gvs      , Rb^Gvs      , Sm          , Ww          , Ww          , Gg^Es       , Gg          , Gg          , Rb^Gvs      , Re          , Rb^Gvs      , Rb^Gvs      
Gg^Efm      , Gg^Efm      , Gg          , Rb^Gvs      , Gg          , Gg          , Gs^Fds      , Gs^Fds      , Gs^Fds      , Gs^Fds      , Gs^Fds      , Gs^Fds      , Gg          , Rb^Gvs      , Re          , Rb^Gvs      , Rb^Gvs      , Rb^Gvs      , Gg          , Gs^Fds      , Gs^Fds      , Gs^Fds      , Rrc         , Rb^Gvs      , Rb^Gvs      , Sm          , Ww          , Sm          , Rb^Gvs      , Rb^Gvs      , Rb^Gvs      , Re          , Gg          , Gg          , Gg          
Gg^Efm      , Gg^Efm      , Gg^Efm      , Gg          , Gg^Es       , Gg          , Gs^Fds      , Gs^Fds      , Gs^Fds      , Gs^Fds      , Gs^Fds      , Gs^Fds      , Rb^Gvs      , Rb^Gvs      , Re          , Re^Vh       , Rb^Gvs      , Rb^Gvs      , Rp          , Gg          , Rp          , Rp          , Rrc         , Gg          , Ww          , Ww          , Gg          , Rb^Gvs      , Rb^Gvs      , Rb^Gvs      , Re^Vh       , Re          , Rb^Gvs      , Gg          , Gg          
Gg^Efm      , Gg^Efm      , Gg^Efm      , Gg          , Gg^Efm      , Gg          , Gg          , Gs^Fds      , Gs^Fds      , Gs^Fds      , Gg          , Rb^Gvs      , Rb^Gvs      , Rb^Gvs      , Re          , Rb^Gvs      , Rp          , Rp          , Rb^Gvs      , Rp          , Rb^Gvs      , Rb^Gvs      , Ww          , Ww^Bsb\     , Rrc         , Gg          , Gg          , Rb^Gvs      , Rb^Gvs      , Rb^Gvs      , Re          , Re          , Rb^Gvs      , Rb^Gvs      , Gg          
Gg^Efm      , Gg^Efm      , Gg^Efm      , Gg^Efm      , Gg          , Gg          , Gg^Es       , Gg          , Gg^Em       , Gg          , Gg          , Rb^Gvs      , Rp          , Re^Vh       , Rp          , Rp          , Rb^Gvs      , Rb^Gvs      , Rb^Gvs      , Rb^Gvs      , Ww          , Ww          , Gg          , Gg          , Gg          , Rrc         , Gg          , Gg          , Re          , Re          , Rb^Gvs      , Re^Vh       , Rb^Gvs      , Rb^Gvs      , Gg          
Gg^Efm      , Gg^Efm      , Gg^Efm      , Gg^Efm      , Gg          , Gg          , Gg          , Gg          , Gg          , Gg          , Rp          , Rp          , Rb^Gvs      , Rp          , Rb^Gvs      , Re^Vh       , Sm          , Sm          , Ww          , Ww          , Gs^Fds      , Gs^Fds      , Gs^Fds      , Gg          , Gg          , Rrc         , Rrc         , Re          , Gg          , Re          , Re          , Rb^Gvs      , Rb^Gvs      , Rb^Gvs      , Gg          
Gg^Efm      , Gg^Efm      , Gg^Efm      , Gg          , Gs^Fds      , Gs^Fds      , Gs^Fds      , Gs^Fds      , Rp          , Rp          , Gs^Fds      , Re^Vh       , Rb^Gvs      , Rb^Gvs      , Rb^Gvs      , Rb^Gvs      , Sm          , Ww          , Sm          , Sm          , Gs^Fds      , Gs^Fds      , Gs^Fds      , Gg          , Ch          , Ch          , Rrc         , Re^Vh       , Rb^Gvs      , Gg^Es       , Gg          , Re          , Rb^Gvs      , Rb^Gvs      , Gg          
Gg^Efm      , Gg^Efm      , Gg          , Gs^Fds      , Gs^Fds      , Gs^Fds      , Rp          , Rp          , Gs^Fds      , Gs^Fds      , Gs^Fds      , Rb^Gvs      , Rb^Gvs      , Rb^Gvs      , Gg          , Sm          , Ww          , Ww          , Sm          , Gs^Fds      , Gs^Fds      , Gs^Fds      , Gs^Fds      , Ch          , 5 Kh        , Ch          , Rrc         , Rb^Gvs      , Rb^Gvs      , Rb^Gvs      , Rb^Gvs      , Re          , Re          , Gg^Es       , Gg          
Gg          , Gg          , Gg          , Gs^Fds      , Gs^Fds      , Rp          , Gs^Fds      , Gs^Fds      , Gs^Fds      , Gs^Fds      , Gs^Fds      , Rb^Gvs      , Rb^Gvs      , Rb^Gvs      , Gg          , Ww          , Sm          , Sm          , Gs^Fds      , Gs^Fds      , Gs^Fds      , Gs^Fds      , Gs^Fds      , Gg          , Gg          , Ch          , Rrc         , Rb^Gvs      , Rb^Gvs      , Rb^Gvs      , Rb^Gvs      , Re^Vh       , Re          , Rb^Gvs      , Rb^Gvs      
Rb^Gvs      , Gg^Es       , Gs^Fds      , Gs^Fds      , Gs^Fds      , Rp          , Chr         , Gs^Fds      , Gs^Fds      , Gs^Fds      , Gs^Fds      , Gs^Fds      , Gg          , Gg          , Gg          , Ww          , Ww          , Sm          , Gg          , Gs^Fds      , Gs^Fds      , Gs^Fds      , Gg          , Gg^Em       , Rb^Gvs      , Gg          , Rrc         , Rb^Gvs      , Rb^Gvs      , Rb^Gvs      , Rb^Gvs      , Rb^Gvs      , Re          , Rb^Gvs      , Rb^Gvs      
Rb^Gvs      , Rb^Gvs      , Rb^Gvs      , Gs^Fds      , Rp          , Rp          , Khr         , Ch          , Chr         , Gg          , Gg          , Gg          , Gg          , Gg          , Gg^Es       , Gg          , Ww          , Sm          , Gg^Efm      , Gg^Efm      , Gg^Efm      , Gg          , Rb^Gvs      , Rb^Gvs      , Rb^Gvs      , Rrc         , Gg          , Rb^Gvs      , Gg          , Rb^Gvs      , Rb^Gvs      , Rb^Gvs      , Re          , Rb^Gvs      , Rb^Gvs      
Rb^Gvs      , Rb^Gvs      , Rp          , Rp          , Gg          , Ch          , Gg          , Ch          , Rb^Gvs      , Rb^Gvs      , Rb^Gvs      , Rb^Gvs      , Rb^Gvs      , Gg          , Rb^Gvs      , Gg          , Gg          , Ww          , Ww          , Gg^Efm      , Gg^Efm      , Gg          , Rb^Gvs      , Rb^Gvs      , Rb^Gvs      , Rrc         , Gg          , Gg          , Gs^Fds      , Rb^Gvs      , Gs^Fds      , Rb^Gvs      , Re          , Re^Vh       , Rb^Gvs      
Rp          , Rp          , Rb^Gvs      , Re          , Re          , Gg          , Re          , Re          , Re          , Rb^Gvs      , Re          , Re^Vh       , Rb^Gvs      , Gg          , Rb^Gvs      , Rb^Gvs      , Rb^Gvs      , Sm          , Ww          , Gg^Efm      , Gg^Efm      , Gg          , Rb^Gvs      , Rb^Gvs      , Re^Vh       , Rrc         , Gg          , Gs^Fds      , Gs^Fds      , Gs^Fds      , Gs^Fds      , Gs^Fds      , Gg          , Re          , Re          
Gg          , Rb^Gvs      , Rb^Gvs      , Re^Vh       , Rb^Gvs      , Re          , Gg          , Gg          , Gs^Fds      , Re          , Gs^Fds      , Re          , Re          , Rb^Gvs      , Rb^Gvs      , Rb^Gvs      , Rb^Gvs      , Sm          , Sm          , Ww          , Ww          , Gg          , Gg          , Rb^Gvs      , Rrc         , Rrc         , Gg^Efm      , Gs^Fds      , Gs^Fds      , Gs^Fds      , Gs^Fds      , Gs^Fds      , Gs^Fds      , Gg          , Gg^Efm      
Gs^Fds      , Rb^Gvs      , Rb^Gvs      , Rb^Gvs      , Rb^Gvs      , Rb^Gvs      , Gg          , Gg          , Gs^Fds      , Gs^Fds      , Gs^Fds      , Gs^Fds      , Gs^Fds      , Re          , Re^Vh       , Rb^Gvs      , Rb^Gvs      , Gg          , Gg          , Gg          , Ww          , Sm          , Rrc         , Rrc         , Rb^Gvs      , Re          , Gg^Efm      , Gg^Efm      , Gs^Fds      , Gs^Fds      , Gs^Fds      , Gs^Fds      , Gs^Fds      , Gg          , Gg^Efm      
Gs^Fds      , Gg          , Gg          , Rb^Gvs      , Gg          , Gg          , Gg^Es       , Gs^Fds      , Gs^Fds      , Gs^Fds      , Gs^Fds      , Gs^Fds      , Gs^Fds      , Re          , Re          , Gg          , Gg          , Ch          , Ch          , Gg          , Rrc         , Ww^Bsb/     , Ww          , Rb^Gvs      , Rb^Gvs      , Re          , Re          , Gg^Efm      , Gs^Fds      , Gs^Fds      , Gs^Fds      , Gs^Fds      , Rb^Gvs      , Gg          , Gg^Efm      
Gs^Fds      , Gg          , Gg          , Gg          , Gg          , Gg          , Gg          , Gg          , Rb^Gvs      , Gs^Fds      , Gs^Fds      , Gs^Fds      , Gs^Fds      , Gs^Fds      , Re          , Gg^Es       , Gg          , Ch          , Ch          , Ch          , Rrc         , Gg          , Sm          , Ww          , Sm          , Rb^Gvs      , Re^Vh       , Re          , Gg          , Gg          , Rb^Gvs      , Rb^Gvs      , Rb^Gvs      , Gg          , Gg^Efm      
Gs^Fds      , Gs^Fds      , Gs^Fds      , Gg          , Gg          , Gg          , Gg          , Rb^Gvs      , Rb^Gvs      , Rb^Gvs      , Rb^Gvs      , Gs^Fds      , Gg          , Gg          , Re          , Re          , Re          , 3 Kh        , Ch          , Rrc         , Rb^Gvs      , Gg          , Gg          , Ww          , Ww          , Rb^Gvs      , Rb^Gvs      , Re          , Re          , Gg          , Rb^Gvs      , Rb^Gvs      , Rb^Gvs      , Rb^Gvs      , Gg          
Gs^Fds      , Gs^Fds      , Gs^Fds      , Gg          , Gg          , Gg          , Gg          , Rb^Gvs      , Rb^Gvs      , Rb^Gvs      , Re^Vh       , Rb^Gvs      , Re          , Re          , Re^Vh       , Gg          , Gg          , Re          , Re          , Rrc         , Re^Vh       , Rb^Gvs      , Rb^Gvs      , Gg          , Ww          , Gg          , Gg          , Gg^Es       , Rb^Gvs      , Re          , Re          , Rb^Gvs      , Re^Vh       , Rb^Gvs      , Gg          
Gs^Fds      , Gs^Fds      , Gs^Fds      , Gs^Fds      , Gg^Es       , Gg          , Gg          , Gg          , Rb^Gvs      , Rb^Gvs      , Re          , Re          , Rb^Gvs      , Rb^Gvs      , Rb^Gvs      , Rb^Gvs      , Rb^Gvs      , Gg          , Gg          , Rrc         , Rb^Gvs      , Rb^Gvs      , Rb^Gvs      , Gg          , Ww          , Sm          , Gg          , Gg          , Rb^Gvs      , Rb^Gvs      , Re^Vh       , Re          , Re          , Rb^Gvs      , Gg          
Gs^Fds      , Gs^Fds      , Gg          , Gg          , Gg          , Gg          , Gg          , Gg          , Gg          , Re          , Gg          , Rb^Gvs      , Rb^Gvs      , Rb^Gvs      , Rb^Gvs      , Rb^Gvs      , Gg          , Gg          , Gg          , Rrc         , Rb^Gvs      , Rb^Gvs      , Gg          , Gg          , Ww          , Sm          , Gg          , Rb^Gvs      , Rb^Gvs      , Rb^Gvs      , Rb^Gvs      , Rb^Gvs      , Rb^Gvs      , Re          , Gg          
