border_size=1
usage=map

Hh^Fms      , Hh^Fms      , Mm          , Mm          , Mm          , Mm^Xm       , Mm^Xm       , Mm^Xm       , Mm^Xm       , Mm^Xm       , Mm^Xm       , Mm^Xm       , Mm^Xm       , Mm^Xm       , Mm^Xm       , Mm^Xm       , Mm^Xm       , Mm^Xm       , Mm^Xm       , Mm^Xm       , Mm^Xm       , Mm^Xm       , Mm^Xm       , Mm^Xm       , Mm^Xm       , Mm^Xm       , Mm^Xm       , Mm^Xm       , Mm^Xm       , Mm^Xm       , Mm^Xm       , Mm^Xm       , Mm^Xm       , Mm^Xm       , Mm^Xm       , Mm          , Mm^Xm       , Mm^Xm       , Mm^Xm       , Mm^Xm       , Mm^Xm       , Mm^Xm       , Mm^Xm       , Mm^Xm       , Mm^Xm       , Mm^Xm       , Mm^Xm       , Mm^Xm       , Mm^Xm       
Gs^Fds      , Hh^Fms      , Hh^Fms      , Mm          , Mm^Fms      , Mm          , Mm          , Mm          , Mm          , Mm^Xm       , Mm^Xm       , Mm^Xm       , Mm^Xm       , Mm^Xm       , Mm^Xm       , Mm^Xm       , Mm^Xm       , Mm^Xm       , Mm^Xm       , Mm^Xm       , Mm          , Mm          , Mm          , Mm          , Mm^Xm       , Mm^Xm       , Mm^Xm       , Mm^Xm       , Mm          , Mm          , Mm          , Mm^Xm       , Mm          , Mm          , Mm^Xm       , Mm^Xm       , Mm^Xm       , Mm^Xm       , Mm^Xm       , Mm^Xm       , Mm^Xm       , Mm^Xm       , Mm^Xm       , Mm^Xm       , Mm^Xm       , Mm^Xm       , Mm^Xm       , Mm^Xm       , Mm^Xm       
Gs^Fds      , Gs^Fds      , Hh^Fms      , Hh^Fms      , Hh^Fms      , Mm^Fms      , Mm^Fms      , Mm          , Mm^Fms      , Mm          , Mm          , Mm^Xm       , Mm          , Mm^Xm       , Mm^Xm       , Mm^Xm       , Mm          , Mm^Xm       , Mm          , Mm          , Mm^Fms      , Mm^Fms      , Mm          , Mm          , Mm          , Mm^Xm       , Mm^Xm       , Mm^Xm       , Mm          , Mm          , Mm^Fms      , Mm^Fms      , Mm^Fms      , Mm          , Mm          , Mm^Xm       , Mm^Xm       , Mm^Xm       , Mm^Xm       , Mm^Xm       , Mm          , Mm          , Mm          , Mm          , Mm          , Mm^Xm       , Mm^Xm       , Mm^Xm       , Mm^Xm       
Gs^Fds      , Gs^Fds      , Gs^Fds      , Gs^Fds      , Gg^Efm      , Hh^Fds      , Hh^Fms      , Mm^Fms      , Hh^Fms      , Mm^Fms      , Mm^Fms      , Mm^Fms      , Mm^Fms      , Mm          , Mm          , Mm          , Mm          , Mm          , Hh^Fds      , Mm^Fms      , Mm^Fms      , Mm^Fms      , Hh^Fms      , Mm          , Mm          , Mm          , Hh^Fms      , Mm          , Mm^Fms      , Mm^Fms      , Hh^Fms      , Hh^Fms      , Hh^Fms      , Mm^Fms      , Hh^Fms      , Mm          , Mm^Fms      , Mm          , Mm          , Mm          , Mm          , Mm          , Mm          , Mm          , Mm          , Mm          , Mm          , Mm^Xm       , Mm^Xm       
Gs^Fds      , Gs^Fds      , Gg          , Gg          , Gg^Es       , Gg^Efm      , Gg^Es       , Hh^Fds      , Hh^Fds      , Hh^Fds      , Hh^Fds      , Hh^Fms      , Hh^Fds      , Mm^Fms      , Hh^Fms      , Mm          , Hh^Fds      , Hh^Fds      , Rrc         , Hh^Fms      , Rrc         , Hh^Fds      , Hh^Fms      , Hh^Fms      , Hh^Fms      , Hh^Fds      , Hh^Fds      , Hh^Fms      , Hh^Fms      , Hh^Fds      , Hh^Fms      , Hh^Fds      , Gg^Efm      , Hh^Fds      , Hh^Fms      , Mm^Fms      , Hh^Fds      , Mm^Fms      , Hh^Fms      , Mm          , Hh^Fds      , Hh^Fms      , Hh^Fms      , Hh^Fms      , Hh^Fms      , Mm          , Mm          , Mm^Xm       , Mm^Xm       
Gs^Fds      , Gs^Fds      , Gg          , Gg^Es       , Gg          , Gg          , Gg          , Gg          , Gg          , Gg^Efm      , Gg          , Hh^Fms      , Hh^Fms      , Hh^Fms      , Rrc         , Hh^Fms      , Rrc         , Rrc         , Rrc         , Rrc         , Rrc^Vhc     , Rrc         , Rrc^Vhc     , Rrc         , Rrc         , Hh^Fms      , Rrc         , Rrc         , Rrc         , Rrc         , Ch          , Gg^Efm      , Gg          , Gg^Efm      , Gg^Efm      , Hh^Fds      , Gg          , Hh^Fds      , Hh^Fms      , Hh^Fds      , Hh^Fms      , Hh^Fms      , Gg^Efm      , Hh^Fds      , Hh^Fds      , Mm^Fms      , Mm          , Mm^Xm       , Mm^Xm       
Gg          , Gg          , Gg          , Gg^Es       , Gg          , Gg          , Rb^Gvs      , Rb^Gvs      , Gg          , Gg^Es       , Gg          , Ch          , Rrc         , Rrc^Vhc     , Rrc         , Rrc         , Rrc^Vhc     , Rrc         , Rrc         , Rrc         , Wwg         , Rrc         , Rrc         , Rrc         , Rrc^Vhc     , Rrc         , Rrc         , Rrc^Vhc     , Rrc         , Rrc         , Rrc         , Ch          , Gg^Es       , Gg          , Gg          , Gg^Es       , Gg          , Gg^Es       , Rb^Gvs      , Gg          , Rb^Gvs      , Gg^Efm      , Rb^Gvs      , Rb^Gvs      , Hh^Fms      , Mm^Fms      , Mm^Fms      , Mm          , Mm^Xm       
Rr          , Rr          , Rr          , Gg          , Gg          , Rb^Gvs      , Rb^Gvs      , Rb^Gvs      , Rb^Gvs      , Gg          , Ch          , Ch          , Rrc         , Rrc         , Rrc^Vhc     , Rrc         , Rrc         , Rrc         , Wwg^Bsb\    , Wwg^Ewf     , Ch          , Wwg         , Wwg^Bsb/    , Rrc         , Rrc         , Rrc         , Rrc^Vhc     , Rrc         , Rrc         , Rrc^Vhc     , Rrc         , Ch          , Gg          , Gg          , Gg          , Gg          , Rb^Gvs      , Gg          , Rb^Gvs      , Rb^Gvs      , Rb^Gvs      , Rb^Vh       , Rb^Gvs      , Rb^Gvs      , Hh^Fds      , Hh^Fds      , Mm          , Mm^Xm       , Mm^Xm       
Gg          , Gg          , Gg          , Rr          , Rr          , Rb^Vh       , Rb^Gvs      , Rb^Gvs      , Ch          , Ch          , Rrc         , Rrc         , Wwg^Ewf     , Wwg^Ewf     , Wwg         , Rrc         , Rrc         , Wwg         , Ch          , Ch          , Kh          , Ch          , Wwg^Ewf     , Rrc         , Rrc^Vhc     , Rrc         , Rrc         , Rrc         , Rrc         , Rrc         , Rrc         , Ch          , Gg          , Rb^Gvs      , Rb^Gvs      , Rb^Gvs      , Rb^Gvs      , Gg          , Rb^Gvs      , Rb^Gvs      , Rr          , Rr          , Rb^Gvs      , Rb^Gvs      , Hh^Fms      , Hh^Fms      , Mm          , Mm^Xm       , Mm^Xm       
Gg          , Gg          , Gg          , Gg^Es       , Rb^Gvs      , Rr          , Rr          , Ch          , Rrc         , Rrc^Vhc     , Wwg^Ewf     , Wwg         , Rrc         , Rrc         , Rrc         , Wwg^Bsb/    , Wwg         , Wwg^Ewl     , Ch          , Kh          , Kh          , Ch          , Wwg         , Rrc         , Rrc         , Rrc         , Rrc^Vhc     , Rrc         , Rrc         , Rrc^Vhc     , Rrc         , Ch          , Gg^Es       , Rb^Gvs      , Rb^Gvs      , Rb^Vh       , Rr          , Rr          , Rr          , Rr          , Rb^Gvs      , Rb^Vh       , Hh^Fms      , Hh^Fds      , Hh^Fms      , Mm          , Mm          , Mm^Xm       , Mm^Xm       
Gs^Fds      , Gg          , Gg          , Gg          , Rb^Gvs      , Rb^Vh       , Rb^Gvs      , Rrc         , Rrc         , Rrc         , Wwg^Bsb\    , Rrc         , Rrc^Vhc     , Rrc         , Rrc^Vhc     , Rrc         , Rrc         , Rrc         , Rrc         , Ch          , Ch          , Ch          , Wwg^Ewl     , Rrc         , Rrc         , Rrc         , Rrc         , Rrc         , Rrc^Vhc     , Rrc         , Rrc         , Ch          , Gg          , Rb^Gvs      , Rr          , Rr          , Rb^Gvs      , Rb^Gvs      , Rr          , Rb^Vh       , Rb^Gvs      , Rb^Gvs      , Hh^Fms      , Hh^Fds      , Mm          , Mm          , Mm^Xm       , Mm^Xm       , Mm^Xm       
Gs^Fds      , Gg          , Gg          , Gg          , Rb^Gvs      , Rb^Gvs      , Rb^Gvs      , Ch          , Ch          , Rrc         , Wwg         , Rrc         , Rrc         , Rrc         , Rrc         , Rrc         , Rrc^Vhc     , Rrc         , Rrc^Vhc     , Rrc         , Rrc         , Rrc         , Rrc         , Wwg^Bsb/    , Wwg         , Wwg^Ewf     , Wwg^Bsb/    , Rrc         , Rrc         , Rrc         , Ch          , Rrc         , Rr          , Rr          , Rb^Gvs      , Rb^Gvs      , Rb^Vh       , Rb^Gvs      , Rr          , Rb^Gvs      , Gg          , Hh^Fds      , Hh^Fds      , Mm^Fms      , Mm          , Mm^Xm       , Mm^Xm       , Mm^Xm       , Mm^Xm       
Gs^Fds      , Gs^Fds      , Gg          , Gg^Es       , Gg          , Rb^Gvs      , Gg          , Gg          , Ch          , Rrc         , Wwg^Ewl     , Rrc         , Rrc^Vhc     , Rrc         , Rrc^Vhc     , Rrc         , Rrc         , Rrc         , Rrc         , Rrc         , Rrc         , Rrc         , Rrc         , Rrc         , Rrc         , Rrc         , Rrc         , Wwg         , Wwg         , Ch          , Gg          , Gg          , Gg^Es       , Gg^Efm      , Gg          , Rb^Gvs      , Gg^Es       , Gg^Efm      , Rr          , Rb^Gvs      , Gg          , Hh^Fms      , Hh^Fms      , Mm^Fms      , Mm          , Mm          , Mm          , Mm^Xm       , Mm^Xm       
Gs^Fds      , Gs^Fds      , Gs^Fds      , Gg          , Gg          , Gg          , Gg          , Gg^Es       , Gg          , Ch          , Wwg         , Rrc         , Rrc         , Rrc         , Rrc         , Rrc         , Rrc^Vhc     , Rrc         , Rrc         , Rrc         , Rrc         , Rrc         , Rrc^Vhc     , Rrc         , Rrc         , Rrc         , Ch          , Ch          , Gg          , Wwg         , Wwg         , Gg          , Gg          , Gg          , Rb^Gvs      , Rb^Gvs      , Rb^Gvs      , Rr          , Gg          , Gg^Es       , Rb^Gvs      , Gg^Efm      , Gg^Es       , Hh^Fds      , Hh^Fds      , Mm          , Mm          , Mm          , Mm^Xm       
Gs^Fds      , Gs^Fds      , Gs^Fds      , Gg^Es       , Gg          , Gg          , Gg^Es       , Gg          , Gg          , Wwg         , Rb^Gvs      , Ch          , Ch          , Rrc         , Rrc         , Rrc         , Rrc         , Rrc^Vhc     , Rrc         , Rrc         , Rrc         , Rrc         , Rrc         , Rrc         , Ch          , Rrc         , Rr          , Gg          , Gg^Es       , Gg          , Gg          , Wwg         , Gg          , Rb^Gvs      , Rb^Gvs      , Rb^Gvs      , Rb^Gvs      , Rr          , Rb^Vh       , Rb^Gvs      , Rb^Gvs      , Gg          , Gg          , Gg          , Hh^Fds      , Hh^Fms      , Mm          , Mm^Xm       , Mm^Xm       
Gs^Fds      , Gs^Fds      , Gs^Fds      , Gg          , Wwg         , Gg          , Gg          , Gg          , Wwg         , Wwg         , Rb^Gvs      , Rb^Gvs      , Rr          , Rrc         , Ch          , Rrc         , Rrc         , Rrc         , Rrc         , Rrc^Vhc     , Rrc         , Rrc         , Ch          , Ch          , Gg          , Gg          , Rr          , Gg          , Rb^Gvs      , Gg          , Gg          , Wwg         , Wwrg        , Rb^Gvs      , Rb^Gvs      , Rb^Vh       , Rb^Gvs      , Rr          , Rb^Gvs      , Rb^Gvs      , Rb^Gvs      , Rb^Gvs      , Gg          , Hh^Fms      , Hh^Fms      , Mm          , Mm          , Mm^Xm       , Mm^Xm       
Gs^Fds      , Gs^Fds      , Wwg         , Wwg         , Gg          , Wwg         , Wwg         , Wwg         , Gg          , Gg^Efm      , Rb^Vh       , Rb^Gvs      , Rr          , Rb^Gvs      , Rb^Gvs      , Ch          , Ch          , Ch          , Ch          , Rrc         , Ch          , Rrc         , Gg          , Gg          , Rb^Vh       , Rb^Gvs      , Rr          , Rb^Gvs      , Rb^Gvs      , Rb^Gvs      , Rb^Gvs      , Gg          , Gg          , Wwg         , Rb^Gvs      , Rb^Gvs      , Rb^Vh       , Rr          , Rb^Gvs      , Rb^Gvs      , Gg          , Gg          , Gg^Es       , Gg          , Hh^Fms      , Mm          , Mm^Xm       , Mm^Xm       , Mm^Xm       
Wwg         , Wwg         , Gs^Fds      , Gg          , Gg^Efm      , Gg          , Gg^Es       , Gg          , Rb^Gvs      , Rb^Gvs      , Rb^Gvs      , Rr          , Gg^Es       , Rb^Vh       , Rb^Gvs      , Rb^Gvs      , Rb^Gvs      , Gg          , Gg          , Ch          , Gg^Es       , Rr          , Rr          , Rb^Gvs      , Rb^Gvs      , Rb^Gvs      , Rr          , Rb^Gvs      , Rb^Gvs      , Rb^Vh       , Rb^Gvs      , Gg          , Gg^Es       , Wwg         , Wwg         , Rb^Gvs      , Rb^Gvs      , Rr          , Rb^Vh       , Rb^Gvs      , Rb^Gvs      , Rb^Gvs      , Gg          , Gg^Efm      , Hh^Fds      , Mm          , Mm          , Mm^Xm       , Mm^Xm       
Gs^Fds      , Gs^Fds      , Gs^Fds      , Gg          , Gg^Efm      , Gg^Efm      , Gg          , Gg^Efm      , Gg          , Gg^Es       , Rb^Gvs      , Rr          , Rb^Gvs      , Rb^Gvs      , Rb^Gvs      , Gg          , Gg          , Gg^Es       , Gg          , Rb^Gvs      , Rb^Gvs      , Rb^Gvs      , Rb^Gvs      , Rr          , Rr          , Rr          , Rb^Gvs      , Rr          , Rr          , Rb^Gvs      , Rb^Gvs      , Gg          , Rb^Gvs      , Rb^Gvs      , Rb^Gvs      , Wwg         , Wwg^Bw/     , Rr          , Rb^Gvs      , Rb^Gvs      , Rb^Gvs      , Rb^Gvs      , Gg          , Hh^Fms      , Hh^Fms      , Mm^Fms      , Mm          , Mm^Xm       , Mm^Xm       
Gs^Fds      , Gs^Fds      , Gg^Es       , Gg^Efm      , Gg^Efm      , Gg^Efm      , Gg          , Rb^Gvs      , Rb^Gvs      , Rb^Gvs      , Rr          , Rr          , Rb^Vh       , Rb^Gvs      , Rb^Gvs      , Rb^Gvs      , Gg          , Rb^Gvs      , Rb^Gvs      , Rb^Gvs      , Rb^Gvs      , Rb^Vh       , Rr          , Rr          , Rb^Gvs      , Rb^Vh       , Rb^Gvs      , Rb^Gvs      , Rr          , Rb^Gvs      , Gg          , Rb^Gvs      , Rb^Gvs      , Rb^Gvs      , Rb^Gvs      , Rr          , Wwg         , Rb^Gvs      , Gg          , Rb^Gvs      , Gg          , Rb^Gvs      , Gg^Es       , Gg          , Gg          , Mm^Fms      , Mm^Fms      , Mm^Xm       , Mm^Xm       
Gs^Fds      , Gs^Fds      , Gs^Fds      , Gg^Efm      , Gg^Efm      , Gg^Efm      , Gg          , Rb^Gvs      , Rb^Gvs      , Rb^Vh       , Rr          , Rb^Gvs      , Rb^Gvs      , Rb^Gvs      , Rr          , Gg          , Gg^Es       , Gg          , Rr          , Rb^Gvs      , Rr          , Rr          , Rb^Gvs      , Rb^Gvs      , Rb^Gvs      , Rb^Gvs      , Rb^Gvs      , Rb^Gvs      , Gg          , Rr          , Rr          , Rb^Vh       , Rr          , Rb^Gvs      , Rr          , Rr          , Gg          , Wwg         , Gg          , Gg^Es       , Gg          , Gg          , Gg^Efm      , Gg^Efm      , Hh^Fms      , Hh^Fds      , Mm^Fms      , Mm          , Mm^Xm       
Gs^Fds      , Gs^Fds      , Gs^Fds      , Gg          , Gg          , Gg          , Gg^Es       , Rb^Gvs      , Rr          , Rr          , Rr          , Rb^Gvs      , Rr          , Rr          , Gg^Es       , Rr          , Rr          , Rr          , Rb^Gvs      , Rr          , Rb^Gvs      , Rb^Vh       , Rb^Gvs      , Rb^Gvs      , Gg          , Gg          , Gg^Es       , Gg          , Gg          , Gg          , Gg          , Rr          , Gg          , Rr          , Gg^Es       , Gg          , Wwg         , Wwrg        , Gg          , Gg          , Gg          , Gg          , Gg^Es       , Gg          , Hh^Fms      , Hh^Fds      , Mm          , Mm          , Mm^Xm       
Gs^Fds      , Gs^Fds      , Gs^Fds      , Gg          , Rb^Gvs      , Rb^Gvs      , Rb^Gvs      , Gg          , Rr          , Rb^Gvs      , Rb^Gvs      , Rr          , Rb^Gvs      , Gg          , Hh^Fms      , Gg^Efm      , Hh^Fms      , Hh^Fms      , Hh^Fms      , Rb^Gvs      , Hh^Fms      , Rb^Gvs      , Hh^Fms      , Gg          , Hh^Fms      , Gg          , Gg          , Gg          , Gg          , Gg^Es       , Gg          , Rp          , Gg^Es       , Gg          , Wwg         , Wwg         , Gg          , Gg^Es       , Gg          , Gg          , Hh^Fms      , Hh^Fds      , Hh^Fms      , Hh^Fds      , Mm^Fms      , Mm          , Mm          , Mm^Xm       , Mm^Xm       
Gs^Fds      , Gs^Fds      , Gg          , Gg          , Gg          , Rb^Vh       , Rb^Gvs      , Rr          , Rb^Gvs      , Rb^Vh       , Rb^Gvs      , Rb^Gvs      , Hh^Fds      , Hh^Fms      , Hh^Fds      , Hh^Fms      , Hh^Fms      , Hh^Fds      , Mm^Fms      , Hh^Fds      , Hh^Fds      , Hh^Fds      , Hh^Fds      , Hh^Fds      , Hh^Fms      , Hh^Fds      , Hh^Fms      , Gg          , Hh^Fms      , Gg          , Gg          , Rp          , Rp          , Gg          , Wwg         , Gg          , Gg          , Gg          , Hh^Fms      , Hh^Fms      , Hh^Fds      , Hh^Fms      , Mm^Fms      , Mm^Fms      , Mm^Fms      , Mm          , Mm          , Mm^Xm       , Mm^Xm       
Gs^Fds      , Gs^Fds      , Gs^Fds      , Gg^Es       , Gg          , Rb^Gvs      , Rb^Gvs      , Rb^Gvs      , Gg          , Rb^Gvs      , Hh^Fms      , Hh^Fms      , Hh^Fms      , Hh^Fms      , Mm          , Hh^Fms      , Mm^Fms      , Mm          , Mm          , Mm^Fms      , Mm^Fms      , Hh^Fms      , Mm          , Hh^Fms      , Mm^Fms      , Hh^Fms      , Mm          , Hh^Fms      , Mm^Fms      , Hh^Fds      , Hh^Fms      , Gg          , 1 Rp        , Gg^Es       , Wwg         , Gg          , Hh^Fms      , Hh^Fms      , Mm^Fms      , Mm^Fms      , Mm^Fms      , Mm^Fms      , Mm          , Mm          , Mm          , Mm          , Mm^Xm       , Mm^Xm       , Mm^Xm       
Gs^Fds      , Gs^Fds      , Gs^Fds      , Gg          , Gg^Efm      , Gg          , Gg          , Gg^Efm      , Hh^Fms      , Hh^Fds      , Mm          , Mm^Fms      , Mm^Fms      , Mm^Fms      , Mm          , Mm          , Mm^Xm       , Mm          , Mm          , Mm          , Mm          , Mm          , Mm          , Mm^Fms      , Mm          , Mm          , Mm          , Mm          , Mm          , Mm^Fms      , Mm^Fms      , Gg          , Rp          , Gg          , Wwg         , Hh^Fds      , Mm          , Mm          , Mm          , Mm          , Mm          , Mm          , Mm          , Mm          , Mm^Xm       , Mm^Xm       , Mm^Xm       , Mm^Xm       , Mm^Xm       
Gs^Fds      , Gs^Fds      , Gs^Fds      , Gg          , Gg          , Gg^Es       , Hh^Fms      , Hh^Fms      , Mm^Fms      , Mm^Fms      , Mm          , Mm^Fms      , Mm^Xm       , Mm          , Mm^Xm       , Mm^Xm       , Mm^Xm       , Mm^Xm       , Mm^Xm       , Mm^Xm       , Mm^Xm       , Mm          , Mm^Xm       , Mm          , Mm^Xm       , Mm^Xm       , Mm^Xm       , Mm          , Mm^Xm       , Mm^Fms      , Mm^Fms      , Hh^Fms      , Rp          , Wwg         , Hh^Fms      , Hh^Fms      , Mm          , Mm          , Mm^Xm       , Mm^Xm       , Mm^Xm       , Mm^Xm       , Mm^Xm       , Mm^Xm       , Mm^Xm       , Mm^Xm       , Mm^Xm       , Mm^Xm       , Mm^Xm       
Gs^Fds      , Gs^Fds      , Gs^Fds      , Gs^Fds      , Gs^Fds      , Hh^Fms      , Hh^Fms      , Hh^Fms      , Mm^Fms      , Mm          , Mm^Xm       , Mm^Xm       , Mm^Xm       , Mm^Xm       , Mm^Xm       , Mm^Xm       , Mm^Xm       , Mm^Xm       , Mm^Xm       , Mm^Xm       , Mm^Xm       , Mm^Xm       , Mm^Xm       , Mm^Xm       , Mm^Xm       , Mm^Xm       , Mm^Xm       , Mm^Xm       , Mm^Xm       , Mm^Xm       , Mm          , Hh^Fms      , Rp          , Wwf         , Hh^Fms      , Mm^Fms      , Mm^Xm       , Mm^Xm       , Mm^Xm       , Mm^Xm       , Mm^Xm       , Mm^Xm       , Mm^Xm       , Mm^Xm       , Mm^Xm       , Mm^Xm       , Mm^Xm       , Mm^Xm       , Mm^Xm       
