border_size=1
usage=map

Gg          , Gg          , Gll^Fds     , Gg          , Gs^Fms      , Gs^Fms      , Gll^Fds     , Gll^Fds     , Gll^Fds     , Gs^Fms      , Gll^Fds     , Hh^Fds      , Hh^Fds      , Hh^Fms      , Mm          , Mm          , Mm          , Mm          , Mm          , Mm          , Mm          , Mm          , Mm          , Mm          , Mm          , Mm          , Mm          , Hh^Fds      , Gs^Fms      , Gs^Fms      , Re          , Hh^Fds      , Wwg         , Hh^Fds      , Hh^Fds      , Hh^Fds      , Hh^Fds      , Hh^Fds      , Hh^Fds      , Hh^Fds      , Mm          , Mm          , Mm          , Mm          , Mm          , Mm          , Mm          , Mm          , Hh^Fds      , Hh^Fds      , Hh^Fms      , Hh^Fds      , Hh^Fds      , Gs^Fms      , Gs^Fms      , Gs^Fms      , Gs^Fms      , Gs^Fms      , Gs^Fms      
Gll^Fds     , Gll^Fds     , Gg^Vc       , Gll^Fds     , Ww          , Gs^Fms      , Ww          , Ww          , Ww          , Gg          , Gg^Em       , Hh^Fms      , Hh^Fds      , Mm          , Mm          , Mm          , Mm          , Mm          , Mm          , Mm          , Mm          , Mm          , Mm          , Mm          , Mm          , Mm          , Hh^Fds      , Hh^Fds      , Gs^Fms      , Gll^Fds     , Re          , Hh^Fds      , Wwg         , Hh^Fds      , Hh^Fds      , Hh^Fds      , Gll^Fds     , Hh^Fds      , Hh^Fds      , Hh^Fds      , Mm          , Mm          , Mm          , Mm          , Mm          , Mm          , Hh^Fds      , Hh^Fms      , Hh^Fms      , Hh^Fms      , Gll^Fds     , Hh^Fms      , Gll^Fds     , Gll^Fds     , Gll^Fds     , Gs^Fms      , Gs^Fms      , Gll^Fds     , Gs^Fms      
Gll^Fds     , Gll^Fds     , Ww          , Ww          , Hh^Fds      , Ww          , Hh^Fds      , Gs^Fms      , Hh^Fms      , Ww          , Ww          , Hh^Fms      , Hh^Fms      , Hh^Fds      , Hh^Fds      , Mm          , Mm          , Mm          , Mm          , Mm          , Mm          , Mm          , Mm          , Mm          , Mm          , Hh^Fds      , Gll^Fds     , Gg^Vl       , Re          , Re          , Gll^Fds     , Gs^Fms      , Wwg         , Gs^Fms      , Gll^Fds     , Gll^Fds     , Hh^Fds      , Hh^Fds      , Mm          , Mm          , Mm          , Mm          , Mm          , Mm          , Mm          , Hh^Fds      , Hh^Vl       , Hh^Fms      , Hh^Fds      , Gs^Fms      , Gs^Fms      , Gs^Fms      , Gll^Fds     , Gll^Fds     , Gg^Vl       , Gg          , Gs^Fms      , Gs^Fms      , Gll^Fds     
Gll^Fds     , Gll^Fds     , Ww          , Hh^Fds      , Hh^Fds      , Hh^Fds      , Hh^Fms      , Hh^Fms      , Chr         , Khr         , Chr         , Ww          , Hh^Fms      , Hh^Fms      , Hh^Fms      , Hh^Fds      , Mm          , Mm          , Mm          , Mm          , Mm          , Mm          , Mm          , Mm          , Hh^Fds      , Hh^Fds      , Hh^Fds      , Re          , Hh^Fms      , Gll^Fds     , Gll^Fds     , Hh^Fds      , Wwg         , Gs^Fms      , Gg          , Gs^Fms      , Hh^Fds      , Hh^Fds      , Hh^Fds      , Mm          , Mm          , Mm          , Mm          , Mm          , Hh^Fds      , Hh^Fds      , Hh^Fds      , Hh^Fds      , Gll^Fds     , Hh^Fds      , Hh^Fds      , Hh^Fds      , Hh^Fms      , Gll^Fds     , Gll^Fds     , Gs^Fms      , Hh^Fds      , Gs^Fms      , Ch          
Gll^Fds     , Gll^Fds     , Ww          , Hh^Fds      , Gs^Fms      , Hh^Fds      , Hh^Fds      , Hh^Fds      , Hh^Fds      , Chr         , Gll^Fds     , Ww          , Ww          , Hh^Fms      , Hh^Fms      , Hh^Fms      , Hh^Fms      , Mm          , Mm          , Mm          , Mm          , Mm          , Mm          , Mm          , Hh^Fds      , Gll^Fds     , Chr         , Re          , Hh^Fms      , Gll^Fds     , Wwg         , Wwg         , Gs^Fms      , Gs^Fms      , Gg          , Gs^Efm      , Hh^Fds      , Hh^Fds      , Hh^Fds      , Mm          , Mm          , Mm          , Mm          , Mm          , Hh^Fds      , Hh^Fds      , Hh^Fds      , Hh^Fds      , Hh^Fds      , Hh^Fds      , Gg          , Hh^Fms      , Gll^Fds     , Gg          , Hh^Fms      , Hh^Fds      , Ch          , Ch          , Gg          
Gll^Fds     , Gll^Fds     , Ww          , Gs^Fms      , Gs^Fms      , Gs^Fms      , Gg          , Hh^Fds      , Hh^Fds      , Hh^Fms      , Hh^Fms      , Gll^Fds     , Ww          , Gg^Vc       , Gg^Em       , Hh^Fms      , Hh^Fms      , Hh^Fms      , Mm          , Mm          , Mm          , Mm          , Mm          , Mm          , Hh^Fms      , Hh^Fds      , 3 Khr       , Chr         , Hh^Fds      , Gll^Fds     , Wwg         , Hh^Fms      , Hh^Fms      , Gs^Fms      , Gs^Fms      , Gg^Vl       , Hh^Fds      , Hh^Fds      , Chr         , Mm          , Mm          , Mm          , Mm          , Mm          , Hh^Fds      , Hh^Fds      , Gs^Fms      , Gll^Fds     , Gll^Fds     , Gs^Fms      , Gg^Efm      , Gg^Em       , Gg          , Gs^Fms      , Hh^Fms      , Hh^Fds      , Ch          , Gs^Fms      , Gll^Fds     
Rp          , Gs^Fms      , Ww          , Gg          , Hh^Fms      , Gg^Efm      , Rp          , Gll^Fds     , Gll^Fds     , Hh^Fms      , Gll^Fds     , Hh^Fms      , Ww          , Gll^Fds     , Gg          , Gg          , Gs^Fms      , Hh^Fds      , Hh^Fds      , Mm          , Mm          , Mm          , Mm          , Mm          , Hh^Fms      , Hh^Fds      , Chr         , Chr         , Re          , Gll^Fds     , Wwg         , Gll^Fds     , Gll^Fds     , Hh^Fms      , Hh^Fms      , Gs^Fms      , Hh^Fds      , Chr         , Khr         , Mm          , Mm          , Mm          , Mm          , Hh^Fds      , Hh^Fms      , Gll^Fds     , Gs^Fms      , Gs^Fms      , Hh^Fds      , Gll^Fds     , Hh^Fds      , Gs^Fms      , Gll^Fds     , Gs^Fms      , Gll^Fds     , Hh^Fds      , 1 Kh        , Gs^Fms      , Rr          
Ww          , Ww^Bw\r     , Rp          , Hh^Fds      , Rp          , Rp          , Hh^Fms      , Rp          , Rp          , Rp          , Rp          , Gll^Fds     , Gs^Fms      , Ww          , Rp          , Rp          , Rp          , Hh^Fms      , Hh^Fds      , Mm          , Mm          , Mm          , Mm          , Mm          , Hh^Fms      , Hh^Fds      , Hh^Fds      , Gs^Fms      , Gg^Efm      , Re          , Wwg         , Gs^Fms      , Hh^Fms      , Hh^Fms      , Gg^Es       , Gll^Fds     , Gll^Fds     , Chr         , Chr         , Mm          , Mm          , Mm          , Mm          , Hh^Fds      , Gg          , Gll^Fds     , Gll^Fds     , Hh^Fds      , Gg          , Hh^Fds      , Hh^Fds      , Hh^Fds      , Gg^Vl       , Gll^Fds     , Rr          , Rr          , Rr          , Rr          , Gg          
Gg          , Gg          , Gg^Efm      , Rp          , Hh^Fds      , Hh^Fms      , Hh^Fms      , Hh^Fms      , Hh^Fms      , Hh^Fms      , Hh^Fms      , Rp          , Rp          , Ww^Bw/r     , Ww          , Gll^Fds     , Rp          , Hh^Fds      , Hh^Fms      , Hh^Fds      , Hh^Fds      , Mm          , Mm          , Mm          , Mm          , Hh^Fds      , Hh^Fds      , Hh^Fds      , Gg          , Re          , Re          , Wwg         , Wwg         , Hh^Fms      , Gll^Fds     , Gll^Fds     , Gs^Fms      , Gll^Fds     , Gll^Fds     , Mm          , Mm          , Mm          , Hh^Fds      , Hh^Fds      , Rr          , Gg^Vl       , Gg          , Gg^Efm      , Gg          , Hh^Fds      , Rr          , Hh^Fds      , Rr          , Rr          , Gll^Fds     , Gll^Fds     , Kh          , Gg          , Gg          
Gg          , Gg          , Gll^Fds     , Gg          , Gg          , Hh^Fds      , Hh^Fds      , Hh^Fms      , Hh^Fms      , Hh^Fms      , Hh^Fms      , Re          , Hh^Fms      , Gg          , Hh^Fds      , Ww          , Gll^Fds     , Rp          , Rp          , Hh^Fms      , Hh^Fms      , Hh^Fds      , Mm          , Mm          , Mm          , Mm          , Mm          , Hh^Fds      , Gg          , Gg^Vl       , Re          , Gll^Fds     , Gll^Fds     , Wwg         , Gll^Fds     , Gll^Fds     , Gll^Fds     , Gg          , Ww          , Ww          , Ww          , Hh^Fds      , Ww^Bw/r     , Ww^Bw/r     , Ww          , Rr          , Ww^Bw\      , Ww          , Ww^Bw/r     , Rr          , Gg^Es       , Rr          , Gg          , Gll^Fds     , Gg^Efm      , Gg          , Ch          , Gg          , Gll^Fds     
Gg          , Gll^Fds     , Gll^Fds     , Gll^Fds     , Gll^Fds     , Gg^Es       , Gg          , Hh^Fds      , Hh^Fds      , Hh^Fms      , Hh^Fms      , Re          , Re          , Hh^Fds      , Gg          , Ww          , Gll^Fds     , Gg^Vc       , Rp          , Hh^Fms      , Hh^Fms      , Hh^Fms      , Mm          , Mm          , Mm          , Mm          , Hh^Fds      , Hh^Fds      , Hh^Fds      , Gll^Fds     , Gg          , Re          , Re          , Wwg         , Wwg         , Gll^Fds     , Ww          , Ww          , Rp          , Rp          , Rp          , Ww^Bw/r     , Hh^Fds      , Hh^Fds      , Hh^Fms      , Ww          , Gs^Fms      , Re          , Ww          , Gg          , Hh^Fds      , Gg          , Gs^Fms      , Gs^Fms      , Gll^Fds     , Gs^Fms      , Ch          , Gs^Fms      , Gs^Fms      
Gg          , Gll^Fds     , Gs^Fms      , Gs^Fms      , Gs^Fms      , Gs^Fms      , Hh^Fms      , Gg          , Hh^Fms      , Hh^Fds      , Hh^Fms      , Hh^Fds      , Re          , Hh^Fds      , Hh^Fds      , Ww          , Ww          , Chr         , 6 Khr       , Rp          , Rp          , Hh^Fms      , Hh^Fms      , Mm          , Mm          , Mm          , Mm          , Mm          , Hh^Fds      , Gll^Fds     , Gll^Fds     , Gll^Fds     , Rp          , Rp          , Ww^Bw\r     , Ww          , Hh^Fms      , Hh^Fms      , Rp          , Hh^Fms      , Mm          , Mm          , Mm          , Mm          , Mm          , Hh^Fms      , Hh^Fms      , Re          , Re          , Ww          , Gll^Fds     , Gs^Fms      , Gll^Fds     , Gg          , Gg          , Gs^Fms      , Gg          , Ch          , Ch          
Gll^Fds     , Gll^Fds     , Gg          , Gll^Fds     , Gll^Fds     , Gs^Fms      , Chr         , Chr         , Chr         , Hh^Fms      , Hh^Fms      , Hh^Fms      , Re          , Hh^Fds      , Gll^Fds     , Gll^Fds     , Ww          , Chr         , Chr         , Chr         , Hh^Fms      , Rp          , Hh^Fms      , Hh^Fds      , Mm          , Mm          , Mm          , Mm          , Hh^Fds      , Hh^Fms      , Hh^Fds      , Rp          , Gg^Es       , Gg          , Ww          , Rp          , Rp          , Rp          , Hh^Fms      , Hh^Fms      , Mm          , Mm          , Mm          , Mm          , Mm          , Mm          , Mm          , Hh^Fds      , Re          , Ww          , Ww          , Hh^Fds      , Gll^Fds     , Gll^Fds     , Gs^Fms      , Gs^Fms      , Gg^Vl       , Gs^Fms      , Gs^Fms      
Gll^Fds     , Gll^Fds     , Gll^Fds     , Gg^Efm      , Gll^Fds     , Gll^Fds     , Chr         , 7 Khr       , Chr         , Gll^Fds     , Re          , Re          , Gll^Fds     , Hh^Fds      , Gll^Fds     , Gs^Fms      , Gg^Em       , Ww          , Ww          , Gll^Fds     , Gll^Fds     , Rp          , Hh^Fms      , Hh^Fds      , Hh^Fms      , Mm          , Mm          , Mm          , Mm          , Hh^Fds      , Mm          , Rp          , Chr         , Ww          , Gg          , Gll^Fds     , Hh^Fms      , Mm          , Mm          , Mm          , Mm          , Mm          , Mm          , Mm          , Mm          , Mm          , Mm          , Mm          , Hh^Fds      , Re          , Re          , Ww          , Gll^Fds     , Gll^Fds     , Gs^Fms      , Gll^Fds     , Gg^Es       , Gg          , Gg          
Gg          , Gll^Fds     , Gll^Fds     , Gll^Fds     , Gll^Fds     , Gll^Fds     , Gg^Efm      , Chr         , Gll^Fds     , Re          , Gll^Fds     , Re          , Re          , Gll^Fds     , Gg          , Gll^Fds     , Gg^Vc       , Hh^Fms      , Ww          , Hh^Fms      , Hh^Fms      , Rp          , Rp          , Hh^Fms      , Hh^Fms      , Hh^Fds      , Hh^Fds      , Mm          , Mm          , Mm          , Mm          , Rp          , Ww          , Ww          , Chr         , Hh^Fms      , Mm          , Mm          , Mm          , Mm          , Mm          , Mm          , Mm          , Mm          , Mm          , Mm          , Mm          , Mm          , Mm          , Hh^Fds      , Re          , Ww          , Gll^Fds     , Gll^Fds     , Hh^Fms      , Gll^Fds     , Gll^Fds     , Gs^Fms      , Gll^Fds     
Gs^Fms      , Gs^Fms      , Gg^Es       , Gg          , Gs^Fms      , Gg          , Gs^Fms      , Gs^Fms      , Gll^Fds     , Gg^Efm      , Gg          , Gll^Fds     , Gs^Fms      , Re          , Re          , Gg          , Gll^Fds     , Wwg         , Gs^Fms      , Ww          , Ww          , Hh^Fms      , Hh^Fms      , Rp          , Rp          , Hh^Fds      , Rp          , Hh^Fds      , Hh^Fms      , Mm          , Ww^Bw/r     , Ww^Bw|r     , Hh^Fds      , Khr         , Mm          , Hh^Fds      , Mm          , Mm          , Hh^Fds      , Mm          , Hh^Fds      , Hh^Fds      , Hh^Fds      , Hh^Fds      , Mm          , Mm          , Mm          , Mm          , Mm          , Hh^Fds      , Re          , Ww          , Ww          , Gll^Fds     , Gs^Fms      , Gll^Fds     , Gll^Fds     , Gll^Fds     , Gll^Fds     
Gg          , Gg          , Hh^Fds      , Gg          , Hh^Fds      , Gs^Fms      , Gs^Fms      , Gll^Fds     , Gll^Fds     , Gll^Fds     , Gg          , Gs^Fms      , Gs^Fms      , Gll^Fds     , Re          , Gll^Fds     , Gll^Fds     , Wwg         , Gll^Fds     , Gs^Fms      , Ww          , Hh^Fms      , Ww          , Gg^Vc       , Ww          , Rp          , Gg^Efm      , Rp          , Rp          , Rp          , Ww          , Hh^Fds      , Mm          , Mm          , Mm          , Mm          , Hh^Vhh      , Hh^Fds      , Hh^Fds      , Hh^Fds      , Gll^Fds     , Gg^Vc       , Wwg         , Hh^Fds      , Gs^Fms      , Hh^Fds      , Mm          , Mm          , Hh^Vl       , Re          , Gll^Fds     , Wwg         , Gll^Fds     , Wwg         , Wwg         , Gll^Fds     , Gll^Fds     , Gll^Fds     , Gll^Fds     
Gg          , Hh^Fds      , Hh^Fms      , Hh^Fms      , Hh^Fds      , Hh^Fds      , Hh^Fds      , Hh^Fds      , Hh^Fds      , Hh^Fds      , Gll^Fds     , Gll^Fds     , Re          , Re          , Gg          , Gs^Fms      , Wwg         , Wwg         , Gll^Fds     , Gll^Fds     , Gll^Fds     , Ww          , Gll^Fds     , Ww          , Chr         , Ww          , Ww          , Ww          , Ww          , Ww          , Hh^Fds      , Gg^Vc       , Ms          , Ms^Xm       , Ms^Xm       , Ms          , Hh^Fds      , Hh^Fms      , Hh^Fds      , Gll^Fds     , Wwg         , Wwg         , Gg^Em       , Wwg         , Wwg         , Hh^Fds      , Mm          , Mm          , Hh^Fms      , Re          , Gll^Fds     , Wwg         , Gll^Fds     , Gs^Fms      , Hh^Fms      , Wwg         , Wwg         , Gll^Fds     , Gll^Fds     
Gg          , Gg          , Gll^Fds     , Hh^Fds      , Gll^Fds     , Hh^Fms      , Chr         , Chr         , Chr         , Hh^Fds      , Gg^Es       , Gll^Fds     , Re          , Gll^Fds     , Gll^Fds     , Wwg         , Gg          , Gll^Fds     , Hh^Fms      , Gg^Em       , Hh^Fds      , Hh^Fms      , Hh^Vc       , Gll^Fds     , Chr         , 5 Khr       , Chr         , Chr         , Hh^Fds      , Hh^Fds      , Mm          , Mm          , Ms^Xm       , Ms^Xm       , Ms^Xm       , Hh^Fds      , Hh^Fds      , Hh^Fds      , Gg^Es       , Gll^Fds     , Wwg         , Hh^Fds      , Gs^Fms      , Gll^Fds     , Mm          , Wwg         , Mm          , Mm          , Hh^Fds      , Re          , Wwg^Bs\     , Wwg         , Gll^Fds     , Gs^Fms      , Hh^Fms      , Gg          , Gg          , Wwg         , Gll^Fds     
Gg          , Gll^Fds     , Gg          , Gll^Fds     , Gg          , Gll^Fds     , Chr         , Khr         , Gg          , Gll^Fds     , Gg          , Gg          , Gg          , Re          , Hh^Fds      , Wwg         , Hh^Fds      , Hh^Fms      , Hh^Fms      , Hh^Fms      , Mm          , Hh^Fds      , Hh^Fms      , Hh^Fms      , Hh^Fms      , Chr         , Gll^Fds     , Chr         , Hh^Fds      , Hh^Fds      , Mm          , Ms          , Ms^Xm       , Ms^Xm       , Ms^Xm       , Hh^Fms      , Gll^Fds     , Gll^Fds     , Wwg         , Wwg         , Hh^Fms      , Gg^Efm      , Gs^Fms      , Mm          , Mm          , Wwg         , Wwg         , Mm          , Wwg         , Wwg         , Re          , Re          , Gll^Fds     , Hh^Fms      , Gs^Fms      , Gg          , Gg^Vl       , Wwg         , Wwg         
Gll^Fds     , Gs^Fms      , Gs^Fms      , Gg^Efm      , Gll^Fds     , Gll^Fds     , Gs^Fms      , Gll^Fds     , Gs^Fms      , Gll^Fds     , Gs^Fms      , Gll^Fds     , Re          , Re          , Hh^Fms      , Wwg         , Mm          , Hh^Fms      , Hh^Fds      , Mm          , Ms^Xm       , Mm          , Mm          , Hh^Fds      , Hh^Fds      , Hh^Fds      , Hh^Fds      , Hh^Fds      , Mm          , Mm          , Ms^Xm       , Ms^Xm       , Ms^Xm       , Ms^Xm       , Ms^Xm       , Mm          , Mm          , Hh^Fds      , Wwg         , Gg          , Gll^Fds     , Gll^Fds     , Mm          , Mm          , Mm          , Mm          , Hh^Fds      , Wwg         , Re          , Re          , Gs^Fms      , Gs^Fms      , Gs^Fms      , Gs^Fms      , Hh^Fds      , Gg          , Gll^Fds     , Gll^Fds     , Gll^Fds     
Gg          , Gll^Fds     , Gll^Fds     , Gg^Vc       , Hh^Fds      , Gs^Fms      , Gll^Fds     , Gs^Fms      , Gg          , Gs^Fms      , Gs^Fms      , Gll^Fds     , Re          , Gg^Vc       , Hh^Fds      , Wwg         , Mm          , Mm          , Mm          , Mm          , Ms^Xm       , Ms^Xm       , Ms^Xm       , Mm          , Ms^Xm       , Hh^Fms      , Ms^Xm       , Hh^Fds      , Ms^Xm       , Ms^Xm       , Ms^Fpa      , Ms^Fpa      , Ms^Fpa      , Ms^Xm       , Ms^Xm       , Ms          , Hh^Fds      , Hh^Fds      , Gg          , Wwg         , Gs^Fms      , Gll^Fds     , Hh^Fds      , Mm          , Mm          , Mm          , Gg          , Re          , Hh^Fds      , Hh^Fms      , Gll^Fds     , Gg          , Gs^Fms      , Gs^Fms      , Gs^Fms      , Hh^Fds      , Gll^Fds     , Gll^Fds     , Gll^Fds     
Gg          , Gll^Fds     , Gs^Fms      , Gll^Fds     , Hh^Fms      , Hh^Fms      , Gll^Fds     , Hh^Fms      , Hh^Fms      , Hh^Fms      , Hh^Fds      , Gll^Fds     , Re          , Chr         , Chr         , Wwg         , Wwg         , Mm          , Mm          , Ms^Xm       , Ms^Xm       , Ms^Xm       , Ms          , Ms^Xm       , Ms^Xm       , Ms^Xm       , Ms          , Ms^Xm       , Ms^Fpa      , Ms          , Ha^Fpa      , Ha^Fpa      , Ms^Fpa      , Ms          , Ms^Xm       , Ms          , Hh^Fds      , Gll^Fds     , Gll^Fds     , Wwg         , Gll^Fds     , Gg^Vc       , Hh^Fms      , Mm          , Mm          , Mm          , Mm          , Re          , Re          , Hh^Fds      , Gll^Fds     , Gll^Fds     , Gg^Vl       , Gll^Fds     , Gll^Fds     , Gs^Fms      , Gg          , Gg          , Gll^Fds     
Gs^Fms      , Gll^Fds     , Gg          , Gll^Fds     , Hh^Fms      , Gs^Fms      , Mm          , Hh^Fds      , Hh^Fms      , Hh^Fds      , Hh^Fds      , Hh^Fds      , Hh^Fds      , Re          , Chr         , Khr         , Wwg         , Mm          , Mm          , Mm          , Mm          , Ms          , Mm          , Ms          , Ms^Fpa      , Ms          , Ms^Fpa      , Ms^Fpa      , Hh^Fp       , Ha^Fpa      , Ai          , Ha^Fpa      , Ha^Fpa      , Ms          , Ms^Xm       , Ms          , Mm          , Hh^Fds      , Gs^Fms      , Wwg         , Wwg         , Gll^Fds     , Hh^Fds      , Mm          , Mm          , Mm          , Mm          , Mm          , Re          , Hh^Fds      , Hh^Fds      , Hh^Fms      , Hh^Fms      , Gs^Fms      , Hh^Fms      , Gs^Fms      , Gll^Fds     , Gll^Fds     , Gll^Fds     
Gs^Fms      , Gll^Fds     , Gg^Efm      , Hh^Fms      , Hh^Fds      , Hh^Fms      , Mm          , Mm          , Mm          , Mm          , Mm          , Hh^Fms      , Hh^Fms      , Re          , Re          , Gll^Fds     , Gll^Fds     , Wwg         , Wwg         , Hh^Fms      , Hh^Fms      , Mm          , Hh^Fp       , Mm          , Hh^Fp       , Hh^Fp       , Gll^Fp      , Hh^Fp       , Wwg         , Wwg         , Wwg         , Ha^Vhh      , Ha^Fpa      , Ms^Fpa      , Ms          , Ms^Xm       , Ms          , Hh^Vhh      , Hh^Fds      , Gs^Fms      , Wwg         , Gll^Fds     , Hh^Fms      , Mm          , Mm          , Mm          , Mm          , Mm          , Re          , Hh^Fms      , Hh^Fms      , Hh^Fms      , Hh^Fms      , Hh^Fms      , Gll^Fds     , Gs^Fms      , Gs^Fms      , Gll^Fds     , Gll^Fds     
Gg          , Gg          , Gg^Vc       , Hh^Fds      , Mm          , Mm          , Mm          , Mm          , Mm          , Mm          , Mm          , Mm          , Mm          , Hh^Fds      , Hh^Fds      , Re          , Re          , Re          , Re          , Wwg         , Wwg         , Hh^Vhh      , Wwg         , Hh^Fp       , Wwg         , Gll^Fp      , Wwg         , Wwg         , Ch          , Wwg         , Wwg         , Ha^Fpa      , Ha^Fpa      , Ms          , Ms^Xm       , Ms^Xm       , Ms          , Mm          , Hh^Fds      , Hh^Fms      , Wwg         , Gll^Fds     , Gll^Fds     , Mm          , Chr         , Mm          , Re          , Re          , Mm          , Mm          , Mm          , Hh^Fds      , Hh^Fms      , Hh^Fms      , Hh^Fms      , Gg          , Gs^Fms      , Gg          , Gs^Fms      
Hh^Fms      , Hh^Fms      , Hh^Fds      , Hh^Fds      , Mm          , Mm          , Mm          , Mm          , Mm          , Mm          , Mm          , Mm          , Mm          , Mm          , Mm          , Hh^Fms      , Hh^Fms      , Hh^Fds      , Hh^Fms      , Re          , Re          , Wwg         , Gg^Es       , Wwg         , Re          , Wwg         , Re          , Ch          , 4 Khr       , Ch          , Hh^Fp       , Hh^Fp       , Mm          , Ms          , Ms^Xm       , Ms^Xm       , Ms^Xm       , Ms          , Mm          , Hh^Fms      , Hh^Fds      , Wwg         , Wwg         , Hh^Fms      , 2 Khr       , Chr         , Mm          , Mm          , Mm          , Mm          , Mm          , Mm          , Mm          , Hh^Fms      , Hh^Fds      , Hh^Fms      , Hh^Fms      , Gg          , Gs^Fms      
Hh^Fds      , Hh^Fds      , Hh^Fms      , Hh^Fds      , Hh^Fds      , Mm          , Mm          , Mm          , Mm          , Mm          , Mm          , Mm          , Mm          , Mm          , Mm          , Mm          , Mm          , Mm          , Mm          , Hh^Fms      , Mm          , Re          , Re          , Re          , Mm          , Re          , Hh^Fp       , Ch          , Hh^Fp       , Hh^Fp       , Mm          , Mm          , Ms          , Ms          , Ms^Xm       , Ms^Xm       , Ms^Xm       , Ms          , Ms          , Mm          , Mm          , Hh^Fds      , Hh^Fds      , Chw         , Chw         , Chr         , Mm          , Mm          , Mm          , Mm          , Mm          , Mm          , Mm          , Mm          , Hh^Fds      , Hh^Fms      , Hh^Fds      , Gs^Fms      , Gs^Fms      
Hh^Fms      , Hh^Fms      , Hh^Fms      , Hh^Fms      , Hh^Fds      , Mm          , Mm          , Mm          , Mm          , Mm          , Mm          , Mm          , Mm          , Mm          , Mm          , Mm          , Mm          , Mm          , Mm          , Mm          , Mm          , Mm          , Mm          , Mm          , Mm          , Mm          , Mm          , Mm          , Ms          , Mm          , Mm          , Ms          , Ms          , Ms^Xm       , Ms^Xm       , Ms^Xm       , Ms^Xm       , Ms^Xm       , Ms          , Ms          , Mm          , Mm          , Mm          , Mm          , Re          , Mm          , Mm          , Mm          , Mm          , Mm          , Mm          , Mm          , Mm          , Mm          , Hh^Fms      , Hh^Fms      , Hh^Fds      , Gll^Fds     , Gll^Fds     
