border_size=1
usage=map

Xol         , Xol         , Xol         , Xol         , Xol         , Xol         , Xol         , Xol         , Xol         , Xol         , Xol         , Xol         , Xol         , Xol         , Xol         , Xol         , Mm^Xm       , Mm^Xm       , Mm          , Mm          , Mm          , Mm          , Mm          , Mm          , Mm          , Mm          , Mm          , Hh^Fds      , Hh^Fms      , Hh^Fds      , Hh^Fms      , Hh^Fds      , Hh^Fms      , Hh^Fds      , Hh^Fms      , Hh^Fds      , Hh^Fds      , Hh^Fds      , Hh^Fds      , Hh^Fms      , Wwg         , Hh^Fms      , Hh^Fms      , Hh^Fds      , Hh^Fds      , Mm^Fms      
Xol         , Xol         , Xol         , Xol         , Xol         , Xol         , Iwr         , Iwr         , Iwr         , Xol         , Xol         , Xol         , Iwr         , Iwr         , Iwr         , Xol         , Mm^Xm       , Mm^Xm       , Mm          , Mm          , Mm          , Mm          , Mm          , Mm          , Mm          , Mm          , Hh^Fds      , Hh^Fms      , Hh^Fds      , Hh^Fms      , Hh^Fds      , Hh^Fms      , Hh^Fms      , Hh^Fms      , Hh^Fms      , Hh^Fms      , Gs^Fms      , Gs^Fms      , Gs^Fms      , Hh^Fds      , Wwg         , Hh^Fds      , Hh^Fds      , Hh^Fms      , Hh^Fds      , Mm^Fms      
Xol         , Xol         , Iwr         , Iwr         , Iwr         , Iwr         , Iwr         , Iwr         , Iwr         , Iwr         , Iwr         , Xol         , Iwr         , Iwr         , Iwr         , Xol         , Mm^Xm       , Mm^Xm       , Mm          , Mm          , Mm          , Mm          , Hh^Vhh      , Mm          , Hh^Fds      , Hh^Fds      , Hh^Fds      , Hh^Fds      , Gs^Fds      , Hh^Fds      , Gs^Fds      , Gs^Fds      , Ch          , 2 Kh        , Ch          , Ch          , Wwg         , Gs^Fds      , Wwg         , Wwg         , Gs^Fds      , Hh^Fms      , Hh^Fms      , Hh^Fms      , Mm^Fms      , Mm^Fms      
Xol         , Iwr         , Iwr         , Iwr         , Iwr         , Iwr         , Iwr         , Iwr         , Iwr         , Iwr         , Iwr         , Iwr         , Iwr         , Iwr         , Iwr         , Xol         , Mm^Xm       , Mm^Xm       , Mm          , Mm          , Mm          , Hh^Fds      , Hh^Fds      , Hh^Fds      , Hh^Fms      , Hh^Fds      , Gs^Fds      , Gs^Fds      , Gs^Fds      , Gs^Fds      , Wwg         , Wwg         , Wwg^Bsb/    , Ch          , Wwg         , Wwg         , Gs^Fds      , Wwg         , Gs^Fds      , Gs^Fds      , Hh^Fds      , Hh^Fds      , Hh^Fds      , Hh^Fms      , Mm^Fms      , Mm^Fms      
Xol         , Iwr         , Iwr         , Iwr         , Iwr         , Iwr         , Xol         , Iwr         , Iwr         , Iwr         , Xol         , Xol         , Xol         , Xol         , Xol         , Xol         , Mm^Xm       , Mm^Xm       , Mm          , Mm          , Hh^Fms      , Hh^Fms      , Hh^Fms      , Hh^Fms      , Hh^Fms      , Hh^Fms      , Gs^Fds      , Gs^Fds      , Gs^Fds      , Gs^Fds      , Wwg         , Rrc         , Gg          , Wwg         , Gs^Fds      , Gs^Fds      , Gs^Fds      , Gs^Fds      , Gs^Fds      , Hh^Fds      , Hh^Fds      , Hh^Fds      , Mm^Fms      , Mm^Fms      , Mm^Fms      , Mm^Fms      
Xol         , Iwr         , Iwr         , Iwr         , Iwr         , Iwr         , Xol         , Xol         , Iwr         , Iwr         , Xol         , Xol         , Mm^Xm       , Mm^Xm       , Mm^Xm       , Mm^Xm       , Mm^Xm       , Mm          , Mm          , Hh^Fds      , Hh^Fms      , Hh^Fms      , Gs^Fms      , Gs^Fms      , Gs^Fds      , Gs^Fds      , Gs^Fds      , Gs^Fms      , Wwg         , Wwg         , Gs^Fds      , Rrc         , Gs^Vl       , Gg          , Gs^Fds      , Gs^Fds      , Gs^Fds      , Hh^Fds      , Hh^Fds      , Hh^Fds      , Mm^Fms      , Mm^Fms      , Mm^Fms      , Mm^Fms      , Mm          , Mm          
Xol         , Xol         , Xol         , Iwr         , Xol         , Xol         , Xol         , Iwr         , Iwr         , Iwr         , Xol         , Xol         , Mm^Xm       , Mm^Xm       , Mm^Xm       , Mm^Xm       , Mm          , Mm          , Gg          , Hh^Fds      , Gg^Efm      , Gg          , Gs^Fds      , Gs^Fds      , Gs^Fds      , Gs^Fds      , Gs^Fms      , Gg^Es       , Wwg         , Gg          , Gs^Fms      , Rrc         , Gg^Es       , Gs^Fds      , Gs^Fds      , Gs^Fds      , Hh^Fms      , Hh^Fms      , Hh^Fms      , Hh^Vhh      , Mm^Fms      , Mm^Fms      , Mm          , Mm          , Mm          , Mm          
Xol         , Xol         , Xol         , Xol         , Xol         , Xol         , Xol         , Xol         , Iwr         , Iwr         , Xol         , Xol         , Mm^Xm       , Mm^Xm       , Mm^Xm       , Mm^Xm       , Mm          , Mm          , Gg          , Gg^Efm      , Gg^Efm      , Gs^Fds      , Gs^Fds      , Gs^Fms      , Gg          , Gg          , Wwg         , Gs^Fms      , Wwg         , Gg          , Rrc         , Rrc         , Gs^Fms      , Gs^Fms      , Gs^Fds      , Hh^Fms      , Hh^Fms      , Hh^Fms      , Mm^Fms      , Mm^Fms      , Mm^Fms      , Mm^Fms      , Mm          , Mm          , Mm          , Mm^Xm       
Xol         , Xol         , Xol         , Xol         , Xol         , Xol         , Xol         , Xol         , Rrc         , Xol         , Xol         , Xol         , Mm^Xm       , Mm^Xm       , Mm          , Mm          , Gg          , Gg          , Gg          , Gg          , Gg          , Gg          , Gg^Es       , Gs^Vl       , Wwg         , Wwg         , Gs^Fds      , Wwg         , Gs^Fms      , Gs^Fms      , Rrc         , Gg          , Gs^Fms      , Gs^Fms      , Hh^Fms      , Hh^Fds      , Hh^Fds      , Mm^Fms      , Mm^Fms      , Mm^Fms      , Mm          , Mm          , Mm          , Mm^Xm       , Mm^Xm       , Mm^Xm       
Mm^Xm       , Mm^Xm       , Mm^Xm       , Mm^Xm       , Mm^Xm       , Mm^Xm       , Mm^Xm       , Mm^Xm       , Rrc         , Mm^Xm       , Mm^Xm       , Mm^Xm       , Mm^Xm       , Mm          , Mm          , Mm          , Rb^Gvs      , Rb^Gvs      , Rb^Gvs      , Rb^Gvs      , Rb^Vh       , Gg          , Wwg         , Wwg         , Gs^Fms      , Gs^Fms      , Gs^Fds      , Gs^Fms      , Rrc         , Rrc         , Gs^Fms      , Gs^Fms      , Hh^Fds      , Hh^Fms      , Hh^Fms      , Hh^Fds      , Mm^Fms      , Mm^Fms      , Mm          , Mm          , Mm          , Mm          , Mm^Xm       , Mm^Xm       , Mm^Xm       , Mm^Xm       
Mm^Xm       , Mm^Xm       , Mm^Xm       , Mm^Xm       , Mm^Xm       , Ch          , Ch          , Kh          , Rrc         , Kh          , Ch          , Ch          , Mm          , Mm          , Mm          , Gg          , Rb^Gvs      , Rb^Gvs      , Rb^Gvs      , Rb^Gvs      , Rb          , Gg          , Wwg         , Gg          , Gg          , Gg          , Rrc         , Rrc         , Gs^Fms      , Gs^Fms      , Gs^Fms      , Gg^Es       , Hh^Fds      , Hh^Fms      , Mm^Fms      , Mm^Fms      , Mm          , Mm          , Mm          , Mm          , Mm^Xm       , Mm^Xm       , Mm^Xm       , Mm^Xm       , Mm          , Mm          
Mm^Xm       , Mm^Xm       , Mm^Xm       , Mm^Xm       , Mm          , Mm          , Mm          , Rrc         , Rrc^Vhc     , Rrc         , Rrc         , Rrc         , Rrc         , Mm          , Ch          , Gg          , Gg          , Rb^Gvs      , Gg          , Rb^Gvs      , Wwg         , Wwg^Bw\r    , Rb          , Gg          , Rrc         , Rrc         , Gg          , Gs^Fms      , Gg          , Gs^Fms      , Hh^Fds      , Hh^Fds      , Mm^Fms      , Mm^Fms      , Mm          , Mm          , Mm          , Mm          , Mm^Xm       , Mm^Xm       , Mm^Xm       , Mm^Xm       , Mm          , Mm          , Mm          , Mm          
Mm^Xm       , Mm^Xm       , Mm          , Mm          , Mm          , Mm          , Rrc         , Rrc         , Rrc         , Rrc         , Rrc         , Rrc^Vhc     , Rrc         , Rrc         , Rrc         , Ch          , Ch          , Gg^Es       , Wwg         , Wwg         , Rb^Gvs      , Rb^Gvs      , Rb^Vh       , Rrc         , Gg          , Gg^Es       , Gs^Fms      , Gs^Fms      , Hh^Fms      , Hh^Fms      , Hh^Fms      , Mm^Fms      , Mm^Fms      , Mm^Fms      , Mm          , Mm          , Mm^Xm       , Mm^Xm       , Mm^Xm       , Mm^Xm       , Mm          , Mm          , Mm          , Mm^Fms      , Mm^Fms      , Mm^Fms      
Mm^Xm       , Mm^Xm       , Mm          , Mm          , Rrc         , Rrc         , Rrc         , Rrc         , Rrc         , Rrc         , Rrc         , Rrc         , Rrc^Vhc     , Rrc         , Rrc         , Rrc^Vhc     , Rrc         , Ch          , Wwg         , Rb^Gvs      , Rb^Gvs      , Rb^Gvs      , Rb^Gvs      , Rrc         , Gg          , Gg^Efm      , Gg^Efm      , Gg          , Hh^Fms      , Hh^Fms      , Hh^Fms      , Mm^Fms      , Mm^Fms      , Mm          , Mm          , Mm^Xm       , Mm^Xm       , Mm^Xm       , Mm          , Mm          , Mm^Fms      , Mm^Fms      , Mm^Fms      , Mm^Fms      , Hh^Fds      , Hh^Fms      
Mm          , Mm          , Mm          , Mm          , Rrc         , Rrc^Vhc     , Rrc         , Rrc^Vhc     , Rrc         , Rrc         , Ww          , Rrc         , Rrc         , Rrc         , Rrc         , Rrc         , Wwg         , Wwg         , Ch          , Gg          , Gg^Es       , Rb^Gvs      , Rrc         , Rrc         , Gg          , Gg^Efm      , Gg^Efm      , Hh^Fms      , Hh^Fms      , Hh^Fms      , Mm^Fms      , Mm^Fms      , Mm          , Mm          , Mm^Xm       , Mm^Xm       , Mm          , Mm          , Mm          , Mm          , Mm^Fms      , Mm^Fms      , Hh^Fms      , Hh^Fms      , Hh^Fms      , Hh^Fms      
Mm          , Mm          , Hh^Fms      , Hh^Fms      , Rrc         , Rrc         , Rrc         , Rrc         , Ww^Bsb\     , Ww          , Ch          , Ww          , Ww^Bsb/     , Rrc         , Wwg         , Rrc         , Wwg^Bsb\    , Rrc         , Rrc         , Ch          , Rrc         , Rrc         , Rb^Gvs      , Gg          , Gg          , Gg          , Hh^Fms      , Hh^Fms      , Mm^Fms      , Mm^Fms      , Mm^Fms      , Mm          , Mm          , Mm^Xm       , Mm^Xm       , Mm          , Mm          , Mm          , Mm^Fms      , Mm^Fms      , Hh^Fds      , Hh^Fds      , Hh^Fds      , Hh^Fms      , Hh^Fds      , Gs^Fds      
Hh^Fds      , Hh^Fms      , Rrc         , Rrc         , Rrc         , Rrc^Vhc     , Rrc         , Ww          , Rrc         , Ch          , 1 Kh        , Ch          , Rrc         , Ww          , Rrc         , Wwg         , Rrc^Vhc     , Rrc         , Rrc         , Rrc         , Rb^Gvs      , Rb^Vh       , Rb^Gvs      , Rb^Gvs      , Rb^Gvs      , Gg^Es       , Hh^Fms      , Hh^Fms      , Mm^Fms      , Mm^Fms      , Mm          , Mm          , Mm^Xm       , Mm^Xm       , Mm          , Mm          , Mm^Fms      , Mm^Fms      , Hh^Fms      , Mm^Fms      , Hh^Fms      , Hh^Fms      , Hh^Fds      , Gs^Fds      , Gs^Fds      , Gs^Fds      
Hh^Fds      , Hh^Fds      , Ch          , Rrc         , Ch          , Rrc         , Rrc         , Ww          , Rrc         , Ch          , Ch          , Ch          , Rrc         , Ww          , Ww^Bsb/     , Rrc         , Rrc         , Rrc         , Rrc         , Ch          , Rb^Gvs      , Rb^Gvs      , Rb^Gvs      , Rb^Gvs      , Rb^Gvs      , Gg          , Gg          , Mm^Fms      , Mm          , Mm          , Mm^Xm       , Mm^Xm       , Mm^Xm       , Mm          , Mm^Fms      , Mm^Fms      , Hh^Fms      , Hh^Fms      , Hh^Fms      , Hh^Fms      , Gs^Fds      , Hh^Fms      , Gg^Es       , Gg^Vc       , Gs^Fds      , Gs^Fms      
Hh^Fds      , Hh^Fds      , Gg          , Rrc         , Gg          , Ch          , Ww          , Ww^Bsb\     , Rrc         , Rrc         , Rrc         , Rrc         , Rrc         , Rrc         , Rrc         , Ww          , Ww          , Ww          , Ww          , Ch          , Ww          , Rb^Gvs      , Rb^Gvs      , Rb^Gvs      , Rb^Gvs      , Rb^Gvs      , Rb^Gvs      , Hh^Fms      , Mm          , Mm          , Mm          , Mm^Xm       , Mm          , Mm^Fms      , Gs^Fds      , Hh^Fds      , Gs^Fds      , Hh^Fms      , Gs^Fds      , Gg^Vc       , Gs^Fds      , Gs^Fds      , Gg^Es       , Gs^Fds      , Gs^Fms      , Gs^Fms      
Hh^Fds      , Gg^Es       , Rb^Gvs      , Rrc         , Rb^Gvs      , Gg          , Ww          , Ch          , Rrc         , Rrc^Vhc     , Rrc         , Rrc         , Rrc         , Rrc         , Rrc^Vhc     , Rrc         , Rrc         , Rrc         , Ch          , Ww          , Rb^Gvs      , Ww          , Ww          , Gg          , Rb^Gvs      , Rb^Gvs      , Rb^Gvs      , Hh^Fms      , Hh^Fms      , Mm          , Rp          , Rp          , Rp          , Rp          , Rp          , Gs^Fds      , Rp          , Gs^Fds      , Gs^Fds      , Gg^Es       , Rp          , Gs^Fms      , Rp          , Gs^Fds      , Gs^Fms      , Gs^Fms      
Hh^Fds      , Gg          , Rb^Vh       , Rrc         , Rb^Gvs      , Rb^Gvs      , Ww          , Ch          , Ch          , Rrc         , Rrc         , Rrc         , Rrc         , Rrc         , Rrc         , Rrc         , Ch          , Ch          , Rb^Gvs      , Rb^Gvs      , Rb^Gvs      , Rb^Gvs      , Rb^Gvs      , Ww          , Ww          , Rb^Gvs      , Rb^Gvs      , Rb^Vh       , Rp          , Rp          , Kh          , Ch          , Ww          , Ww          , Ww          , Rp          , Ww          , Rp          , Rp          , Rp          , Gs^Fds      , Rp          , Gs^Fms      , Rp          , Rp          , Gs^Fms      
Rb^Gvs      , Rb^Gvs      , Rb^Gvs      , Rrc         , Rb^Gvs      , Rb^Gvs      , Rb^Gvs      , Ww          , Ch          , Rrc         , Rrc         , Rrc^Vhc     , Rrc         , Rrc         , Ch          , Rrc         , Rrc         , Gg          , Gg^Es       , Rb^Gvs      , Rb^Gvs      , Rb^Vh       , Rr          , Gg^Es       , Gg^Wm       , Ww          , Ww^Bw/      , Rr          , Gs^Fms      , Ch          , Ww          , Ww          , Kh          , Ch          , Ch          , Ww          , Rb          , Ww^Bw/      , Ww          , Gs^Fds      , Ww          , Gs^Fds      , Gs^Fds      , Gs^Fds      , Ww          , Rp          
Gg          , Rb^Gvs      , Rb^Gvs      , Rrc         , Rb^Vh       , Rb^Gvs      , Gg^Es       , Ww          , Ww^Bsb/     , Rrc         , Ch          , Rrc         , Ch          , Ch          , Gg          , Gg          , Gg          , Rrc         , Rrc         , Rb^Gvs      , Rr          , Rr          , Rb^Vh       , Rr          , Rr          , Rr          , Gg          , Ww          , Ww          , Ww          , Mm          , Ch          , Mm^Xm       , Mm          , Mm          , Hh^Fms      , Rb          , Gs^Fds      , Gs^Fms      , Ww          , Gs^Fms      , Ww          , Ww          , Ww          , Gs^Fds      , Ww          
Gg          , Rb^Gvs      , Gg^Es       , Rrc         , Rb^Gvs      , Rb^Gvs      , Rrc         , Rrc         , Ww          , Gg          , Gg          , Ch          , Gg          , Gg          , Gg          , Gg^Es       , Rb^Gvs      , Rb^Gvs      , Rb^Gvs      , Rrc         , Rb^Gvs      , Rb^Gvs      , Rb^Gvs      , Rb^Gvs      , Rb^Gvs      , Rb^Vh       , Rb^Gvs      , Gg          , Hh^Fds      , Hh^Fds      , Mm^Fms      , Mm          , Mm^Xm       , Mm^Xm       , Mm          , Hh^Fms      , Hh^Fds      , Rb          , Rb          , Gs^Fms      , Gs^Fds      , Gs^Fms      , Gs^Fms      , Gs^Fms      , Gs^Fds      , Ww          
Gg^Es       , Rb^Gvs      , Rb^Gvs      , Rrc         , Rrc         , Rrc         , Rb^Gvs      , Rb^Gvs      , Gg          , Ww          , Gg          , Gg^Es       , Rb^Gvs      , Rb^Gvs      , Rb^Gvs      , Rb^Gvs      , Rb^Gvs      , Rb^Gvs      , Rb^Gvs      , Rr          , Rb^Gvs      , Rb^Gvs      , Rb^Gvs      , Rb^Gvs      , Rb^Gvs      , Rb^Gvs      , Rb^Gvs      , Hh^Fds      , Hh^Fms      , Mm^Fms      , Mm^Fms      , Mm          , Mm^Xm       , Mm^Xm       , Mm^Fms      , Hh^Fms      , Hh^Fms      , Hh^Fms      , Hh^Fms      , Rb          , Rb          , Gs^Vc       , Rb          , Gs^Es       , Gs^Fds      , Gs^Fds      
Gg          , Rb^Gvs      , Rb^Vh       , Rrc         , Rb^Gvs      , Rb^Gvs      , Rb^Gvs      , Rb^Gvs      , Gg^Es       , Ww          , Rb^Gvs      , Rb^Gvs      , Rb^Gvs      , Rb^Gvs      , Rb^Gvs      , Rb^Gvs      , Rb^Gvs      , Rb^Vh       , Rr          , Rr          , Gg^Es       , Rb^Gvs      , Gg          , Gg          , Rb^Gvs      , Rb^Gvs      , Rb^Gvs      , Rb^Gvs      , Hh^Fms      , Hh^Fms      , Mm^Fms      , Mm^Fms      , Mm          , Mm^Xm       , Mm^Xm       , Hh^Fms      , Hh^Fms      , Hh^Fms      , Hh^Fds      , Hh^Fds      , Hh^Fms      , Rb          , Gs^Fms      , Rb          , Rb          , Rb          
Rb^Gvs      , Rb^Gvs      , Rb^Gvs      , Rrc         , Rb^Gvs      , Rb^Vh       , Rb^Gvs      , Rb^Gvs      , Rb^Gvs      , Ww          , Rb^Gvs      , Rb^Gvs      , Rb^Gvs      , Rb^Gvs      , Rb          , Rb^Gvs      , Rb          , Gg^Es       , Rr          , Rb^Vh       , Rb^Gvs      , Gg          , Rb^Gvs      , Gg          , Gg          , Rb^Gvs      , Gg^Efm      , Rb^Gvs      , Hh^Fms      , Hh^Fds      , Mm^Fms      , Mm^Fms      , Mm          , Mm^Xm       , Mm^Xm       , Mm^Fms      , Mm^Fms      , Hh^Fms      , Hh^Fms      , Hh^Fms      , Hh^Fms      , Hh^Fms      , Hh^Fds      , Gs^Fms      , Gs^Fms      , Gs^Fds      
Rb^Gvs      , Rb^Gvs      , Rb^Gvs      , Rrc         , Rrc         , Rb^Gvs      , Rb^Gvs      , Rb^Gvs      , Rb^Gvs      , Ww          , Rb^Gvs      , Rb^Gvs      , Rb^Gvs      , Rb^Vh       , Rb^Gvs      , Rb          , Gg^Es       , Rb          , Rr          , Rb^Gvs      , Rb^Gvs      , Rb^Gvs      , Rb^Gvs      , Gg^Es       , Gg          , Gg^Efm      , Gg^Efm      , Gg^Efm      , Hh^Fds      , Hh^Fds      , Hh^Fms      , Mm^Fms      , Mm^Fms      , Mm          , Mm          , Mm^Xm       , Mm^Xm       , Mm^Fms      , Mm^Fms      , Hh^Fms      , Hh^Fms      , Hh^Fms      , Hh^Fds      , Hh^Fds      , Hh^Fms      , Gs^Fds      
Gg          , Rb^Gvs      , Rr          , Rr          , Rrc         , Rb^Gvs      , Rb^Gvs      , Rb^Gvs      , Rb^Gvs      , Ww          , Gg          , Rb^Gvs      , Gg          , Rb^Gvs      , Rb^Gvs      , Rb^Gvs      , Rb^Vh       , Gg          , Rr          , Rb^Gvs      , Rb^Gvs      , Rb^Gvs      , Rb^Gvs      , Rb^Gvs      , Rb          , Gg          , Gg          , Gg          , Gg          , Hh^Fds      , Hh^Fds      , Hh^Fms      , Mm^Fms      , Mm          , Mm          , Mm          , Mm^Xm       , Mm^Xm       , Mm          , Mm^Fms      , Mm^Fms      , Hh^Fms      , Hh^Fms      , Hh^Fms      , Hh^Fms      , Hh^Fds      
Rr          , Rr          , Gg          , Gg          , Rrc         , Rb^Vh       , Rb^Gvs      , Rb^Gvs      , Ww          , Ww          , Rb^Gvs      , Gg          , Gg^Es       , Rb^Gvs      , Rb^Gvs      , Rb^Gvs      , Rb^Gvs      , Rr          , Gg          , Rb          , Rb          , Rb          , Rb          , Rb          , Rb^Gvs      , Rb          , Rb^Gvs      , Rb^Gvs      , Gg          , Gg          , Hh^Fms      , Hh^Fms      , Mm^Fms      , Mm          , Mm          , Mm          , Mm^Xm       , Mm^Xm       , Mm^Xm       , Mm          , Mm          , Mm^Fms      , Mm^Fms      , Hh^Fms      , Hh^Fds      , Hh^Fds      
Gg          , Rb^Gvs      , Rb^Vh       , Gg          , Gg          , Rrc         , Rrc         , Ww          , Gg          , Gg          , Rb^Gvs      , Rb^Gvs      , Rb^Gvs      , Gg          , Gg          , Gg^Wm       , Rr          , Rr          , Rb^Vh       , Rb^Gvs      , Rb^Gvs      , Rb^Gvs      , Rb^Es       , Gg          , Rb^Gvs      , Rb^Vh       , Rb^Gvs      , Rb^Gvs      , Rb^Gvs      , Gg^Es       , Hh^Fms      , Hh^Fms      , Mm^Fms      , Mm^Fms      , Mm          , Mm          , Mm          , Mm^Xm       , Mm^Xm       , Mm^Xm       , Mm^Xm       , Mm          , Mm          , Mm^Fms      , Mm^Fms      , Hh^Fms      
Rb^Gvs      , Rb^Gvs      , Rb^Gvs      , Rb^Gvs      , Gg          , Gg          , Gg          , Ww^Bsb\     , Rrc         , Rb^Gvs      , Rb^Gvs      , Rb^Gvs      , Rb^Vh       , Gg          , Rr          , Rr          , Gg          , Rb^Gvs      , Rb^Gvs      , Rb^Gvs      , Rb^Gvs      , Gg          , Rb          , Gg          , Rb^Gvs      , Rb^Gvs      , Rb^Gvs      , Rb^Gvs      , Rb^Gvs      , Gg          , Hh^Fms      , Hh^Fms      , Mm^Fms      , Mm^Fms      , Mm          , Mm          , Mm          , Mm          , Mm^Xm       , Mm^Xm       , Mm^Xm       , Mm^Xm       , Mm^Xm       , Mm          , Mm^Fms      , Mm^Fms      
Rb^Gvs      , Rb^Gvs      , Rb^Gvs      , 5 Rb^Gvs    , Gg          , Gg^Es       , Rb^Gvs      , Ww          , Gg          , Rrc         , Gg^Es       , Rb^Gvs      , Rr          , Rr          , Rb^Gvs      , Rb^Vh       , 3 Rb^Gvs    , Gg^Es       , Gg          , Rb^Gvs      , Gg          , Gg^Es       , Rb^Vh       , Rb^Gvs      , Gg          , 4 Rb^Gvs    , Gg          , Rb^Gvs      , Gg          , Gg          , Hh^Fms      , Hh^Fms      , Mm^Fms      , Mm^Fms      , Mm          , Mm          , Mm          , Mm          , Mm^Xm       , Mm^Xm       , Mm          , Mm^Xm       , Mm^Xm       , Mm^Xm       , Mm^Xm       , Mm          
Gg          , Rb^Gvs      , Gg^Es       , Rb^Gvs      , Gg          , Rb^Gvs      , Rb^Gvs      , Ww          , Gg^Es       , Rrc         , Rrc         , Rr          , Gg^Es       , Rb^Gvs      , Rb^Gvs      , Rb^Gvs      , Rb^Gvs      , Rb^Gvs      , Gg          , Gg          , Rb^Gvs      , Rb^Gvs      , Rb^Gvs      , Rb^Gvs      , Rb^Gvs      , Gg          , Rb^Gvs      , Gg^Es       , Rb^Gvs      , Rb^Gvs      , Hh^Fms      , Hh^Fms      , Mm^Fms      , Mm^Fms      , Mm^Fms      , Mm          , Mm          , Mm          , Mm          , Mm^Xm       , Mm^Xm       , Mm^Xm       , Mm^Xm       , Mm^Xm       , Mm^Xm       , Mm^Xm       
Gg          , Gg          , Gg          , Gg          , Rb^Gvs      , Rb^Gvs      , Rb^Gvs      , Ww          , Gg          , Gg          , Rrc         , Gg          , Gg          , Gg          , Gg          , Rb^Gvs      , Gg          , Rb^Gvs      , Gg          , Gg          , Gg          , Rb^Gvs      , Rb^Gvs      , Rb^Gvs      , Rb^Gvs      , Gg          , Gg          , Rb^Gvs      , Rb^Gvs      , Rb^Gvs      , Hh^Fds      , Hh^Fms      , Hh^Fms      , Mm^Fms      , Mm^Fms      , Mm          , Mm          , Mm          , Mm          , Mm          , Mm          , Mm^Xm       , Mm^Xm       , Mm^Xm       , Mm^Xm       , Mm          
