border_size=1
usage=map

Mm^Xm       , Mm^Xm       , Mm^Xm       , Mm^Xm       , Mm^Xm       , Mm^Xm       , Mm^Xm       , Mm^Xm       , Md          , Md          , Mm^Xm       , Mm^Xm       , Mm^Xm       , Mm^Xm       , Mm^Xm       , Mm^Xm       , Mm^Xm       , Mm^Xm       , Mm^Xm       , Mm^Xm       , Mm^Xm       , Mm^Xm       , Mm^Xm       , Mm^Xm       , Mm^Xm       , Mm^Xm       , Mm^Xm       , Mm^Xm       , Mm^Xm       , Mm^Xm       , Mm^Xm       , Mm^Xm       , Md          , Md          , Hh^Fds      , Gg          , Ww          , Wwg         , Rrc         , Hh^Fds      , Md          , Md          , Mm^Xm       , Mm^Xm       , Mm^Xm       , Mm^Xm       
Mm^Xm       , Mm^Xm       , Mm^Xm       , Mm^Xm       , Mm^Xm       , Mm^Xm       , Mm^Xm       , Mm^Xm       , Mm^Xm       , Md          , Md          , Mm^Xm       , Md          , Mm^Xm       , Mm^Xm       , Mm^Xm       , Mm^Xm       , Mm^Xm       , Mm^Xm       , Mm^Xm       , Mm^Xm       , Mm^Xm       , Mm^Xm       , Mm^Xm       , Mm^Xm       , Mm^Xm       , Mm^Xm       , Mm^Xm       , Mm^Xm       , Mm^Xm       , Mm^Xm       , Md          , Md          , Hh^Fds      , Hh^Fms      , Gg          , Ww          , Rrc         , Ch          , Hh^Fds      , Md          , Md          , Md          , Mm^Xm       , Mm^Xm       , Mm^Xm       
Mm^Xm       , Mm^Xm       , Mm^Xm       , Mm^Xm       , Mm^Xm       , Mm^Xm       , Mm^Xm       , Mm^Xm       , Mm^Xm       , Mm^Xm       , Md          , Md          , Md          , Md          , Md          , Wwg         , Wwg         , Mm^Xm       , Mm^Xm       , Mm^Xm       , Mm^Xm       , Mm^Xm       , Mm^Xm       , Mm^Xm       , Mm^Xm       , Mm^Xm       , Mm^Xm       , Mm^Xm       , Mm^Xm       , Mm^Xm       , Md          , Md          , Hh^Fms      , Hh^Fms      , 2 Kh        , Ch          , Ww          , Ch          , 1 Kh        , Hh^Fds      , Hh^Fms      , Md          , Md          , Md          , Mm^Xm       , Mm^Xm       
Mm^Xm       , Mm^Xm       , Mm^Xm       , Mm^Xm       , Mm^Xm       , Mm^Xm       , Mm^Xm       , Mm^Xm       , Mm^Xm       , Mm^Xm       , Mm^Xm       , Mm^Xm       , Mm^Xm       , Mm^Xm       , Mm^Xm       , Mm^Xm       , Mm^Xm       , Wwg         , Mm^Xm       , Mm^Xm       , Mm^Xm       , Mm^Xm       , Mm^Xm       , Mm^Xm       , Mm^Xm       , Mm^Xm       , Mm^Xm       , Mm^Xm       , Mm^Xm       , Md          , Md          , Md          , Hh^Fms      , Hh^Fds      , Ch          , Ch          , Ww          , Ch          , Ch          , Hh^Fds      , Hh^Fms      , Md          , Md          , Md          , Mm^Xm       , Mm^Xm       
Mm^Xm       , Mm^Xm       , Mm^Xm       , Mm^Xm       , Mm^Xm       , Mm^Xm       , Mm^Xm       , Mm^Xm       , Mm^Xm       , Mm^Xm       , Mm^Xm       , Mm^Xm       , Mm^Xm       , Mm^Xm       , Mm^Xm       , Mm^Xm       , Mm^Xm       , Wwg         , Mm^Xm       , Mm^Xm       , Rrc^Xo      , Mm^Xm       , Mm^Xm       , Mm^Xm       , Mm^Xm       , Mm^Xm       , Mm^Xm       , Mm^Xm       , Md          , Md          , Md          , Hh^Fms      , Hh^Fms      , Hh^Fms      , Gg          , Ww          , Gg          , Rrc         , Gg          , Hh^Fds      , Hh^Fms      , Hh^Fms      , Md          , Md          , Md          , Mm^Xm       
Mm^Xm       , Mm^Xm       , Mm^Xm       , Mm^Xm       , Mm^Xm       , Mm^Xm       , Mm^Xm       , Mm^Xm       , Mm^Xm       , Mm^Xm       , Mm^Xm       , Mm^Xm       , Mm^Xm       , Mm^Xm       , Md          , Mm^Xm       , Md          , Wwg         , Rrc^Xo      , Rrc^Xo      , Rrc^Xo      , Rrc^Xo      , Rrc^Xo      , Mm^Xm       , Mm^Xm       , Mm^Xm       , Mm^Xm       , Mm^Xm       , Md          , Md          , Hh^Fms      , Hh^Fds      , Hh^Fms      , Hh^Fms      , Gs^Fds      , Ww          , Gg          , Rrc         , Gg          , Gg^Efm      , Hh^Fds      , Md          , Md          , Md          , Md          , Mm^Xm       
Mm^Xm       , Mm^Xm       , Mm^Xm       , Mm^Xm       , Mm^Xm       , Mm^Xm       , Mm^Xm       , Mm^Xm       , Mm^Xm       , Mm^Xm       , Mm^Xm       , Mm^Xm       , Mm^Xm       , Mm^Xm       , Md          , Md          , Wwg         , Wwg         , Rrc^Xo      , Rrc^Xo      , Rrc^Xo      , Rrc^Xo      , Rrc^Xo      , Mm^Xm       , Mm^Xm       , Mm^Xm       , Mm^Xm       , Mm^Xm       , Md          , Md          , Hh^Fms      , Hh^Fms      , Hh^Fms      , Gs^Fds      , Gs^Fds      , Ww          , Gs^Fds      , Rrc         , Gs^Vl       , Hh^Fms      , Hh^Fds      , Md          , Md          , Md          , Md          , Mm^Xm       
Mm^Xm       , Mm^Xm       , Mm^Xm       , Mm^Xm       , Mm^Xm       , Mm^Xm       , Mm^Xm       , Mm^Xm       , Mm^Xm       , Mm^Xm       , Md          , Md          , Md          , Md          , Rrc         , Md          , Wwg^Bsb/    , Rrc         , Rrc         , Rrc^Xo      , Rrc^Xo      , Rrc^Xo      , Rrc         , Mm^Xm       , Mm^Xm       , Mm^Xm       , Mm^Xm       , Mm^Xm       , Md          , Md          , Hh^Fms      , Hh^Fms      , Gs^Fds      , Gs^Fds      , Ww          , Ww          , Rrc         , Rrc         , Gs^Fds      , Hh^Fds      , Hh^Fms      , Md          , Md          , Md          , Mm^Xm       , Mm^Xm       
Mm^Xm       , Mm^Xm       , Mm^Xm       , Mm^Xm       , Mm^Xm       , Mm^Xm       , Mm^Xm       , Mm^Xm       , Md          , Md          , Md          , Md          , Kh          , Hh^Fms      , Rrc^Vhc     , Rrc         , Wwg         , Rrc         , Rrc         , Rrc         , Rrc         , Rrc         , Md          , Md          , Mm^Xm       , Mm^Xm       , Mm^Xm       , Md          , Md          , Md          , Hh^Fms      , Hh^Fms      , Gs^Fds      , Gs^Fds      , Ww          , Gs^Fds      , Rrc         , Gs^Fds      , Hh^Fds      , Hh^Fms      , Md          , Md          , Md          , Md          , Mm^Xm       , Mm^Xm       
Mm^Xm       , Mm^Xm       , Mm^Xm       , Mm^Xm       , Mm^Xm       , Mm^Xm       , Md          , Md          , Hh^Fms      , Hh^Fms      , Hh^Fms      , Ch          , Ch          , Rrc         , Wwg         , Wwg         , Rrc         , Rrc         , Rrc^Vhc     , Rrc         , Hh^Fms      , Hh^Fms      , Md          , Md          , Mm^Xm       , Mm^Xm       , Mm^Xm       , Md          , Md          , Md          , Hh^Fms      , Hh^Fms      , Gs^Fds      , Gs^Fds      , Ww          , Rrc         , Gs^Fds      , Gs^Fds      , Gs^Fds      , Hh^Fds      , Md          , Md          , Md          , Mm^Xm       , Mm^Xm       , Mm^Xm       
Mm^Xm       , Mm^Xm       , Mm^Xm       , Mm^Xm       , Mm^Xm       , Mm^Xm       , Md          , Md          , Hh^Fms      , Hh^Fms      , Rrc^Vhc     , Rrc         , Wwg         , Wwg^Bsb\    , Ch          , Rrc         , Kh          , Rrc         , Rrc         , Hh^Fms      , Hh^Fms      , Md          , Md          , Md          , Mm^Xm       , Mm^Xm       , Mm^Xm       , Md          , Md          , Md          , Hh^Fms      , Hh^Fms      , Gg          , Ww          , Gg          , Rrc         , Gs^Fds      , Hh^Fds      , Hh^Fms      , Hh^Fms      , Md          , Md          , Md          , Mm^Xm       , Mm^Xm       , Mm^Xm       
Mm^Xm       , Mm^Xm       , Mm^Xm       , Mm^Xm       , Mm^Xm       , Md          , Md          , Md          , Hh^Fms      , Rrc         , Wwg^Bsb\    , Wwg         , Rrc^Vhc     , Rrc         , Rrc         , Ch          , Ch          , Hh^Fms      , Hh^Fms      , Hh^Fms      , Md          , Md          , Md          , Md          , Mm^Xm       , Mm^Xm       , Mm^Xm       , Md          , Md          , Md          , Hh^Fms      , Hh^Fms      , Gg          , Ww          , Gg          , Rrc         , Hh^Fms      , Hh^Fms      , Hh^Fms      , Hh^Fms      , Md          , Md          , Md          , Mm^Xm       , Mm^Xm       , Mm^Xm       
Mm^Xm       , Mm^Xm       , Mm^Xm       , Mm^Xm       , Md          , Md          , Md          , Hh^Fms      , Hh^Fms      , Rrc         , Wwg         , Rrc         , Rrc         , Rrc         , Rrc^Vhc     , Rrc         , Hh^Fms      , Ch          , Md          , Md          , Md          , Md          , Mm^Xm       , Mm^Xm       , Mm^Xm       , Mm^Xm       , Mm^Xm       , Md          , Md          , Hh^Fms      , Hh^Fms      , Gs^Vl       , Gg          , Ww          , Gg          , Rrc         , Hh^Fms      , Hh^Fms      , Md          , Md          , Md          , Md          , Md          , Mm^Xm       , Mm^Xm       , Mm^Xm       
Mm^Xm       , Mm^Xm       , Mm^Xm       , Mm^Xm       , Mm^Xm       , Md          , Md          , Hh^Fms      , 4 Kh        , Rrc         , Wwg         , Rrc^Vhc     , Rrc         , Rrc         , Hh^Fms      , Hh^Fms      , Hh^Fms      , Md          , Md          , Md          , Md          , Mm^Xm       , Mm^Xm       , Mm^Xm       , Mm^Xm       , Mm^Xm       , Md          , Md          , Md          , Hh^Fms      , Hh^Fms      , Gs^Fds      , Gs^Fds      , Ww          , Gs^Fds      , Rrc         , Hh^Fms      , Hh^Fds      , Md          , Md          , Md          , Md          , Mm^Xm       , Mm^Xm       , Mm^Xm       , Mm^Xm       
Mm^Xm       , Mm^Xm       , Mm^Xm       , Mm^Xm       , Mm^Xm       , Md          , Md          , Ch          , Ch          , Ch          , Wwg^Bsb\    , Rrc         , 3 Kh        , Rrc         , Hh^Fms      , Hh^Fms      , Md          , Md          , Md          , Md          , Mm^Xm       , Mm^Xm       , Mm^Xm       , Mm^Xm       , Mm^Xm       , Mm^Xm       , Md          , Md          , Hh^Fms      , Hh^Fms      , Gs^Fds      , Gs^Fds      , Gs^Fds      , Ww          , Gs^Fds      , Rrc         , Hh^Fms      , Hh^Fms      , Md          , Md          , Md          , Md          , Mm^Xm       , Mm^Xm       , Mm^Xm       , Mm^Xm       
Mm^Xm       , Mm^Xm       , Mm^Xm       , Mm^Xm       , Md          , Md          , Hh^Fms      , Hh^Fds      , Rr          , Gg          , Wwg         , Ch          , Ch          , Ch          , Ch          , Hh^Fms      , Md          , Md          , Mm^Xm       , Mm^Xm       , Mm^Xm       , Mm^Xm       , Mm^Xm       , Mm^Xm       , Mm^Xm       , Md          , Md          , Md          , Hh^Fms      , Hh^Fms      , Gs^Fds      , Gs^Fds      , Ww          , Ww          , Rrc         , Rrc         , Hh^Fds      , Hh^Fms      , Md          , Md          , Md          , Mm^Xm       , Mm^Xm       , Mm^Xm       , Mm^Xm       , Mm^Xm       
Mm^Xm       , Mm^Xm       , Mm^Xm       , Md          , Md          , Md          , Hh^Fds      , Hh^Fds      , Rr          , Wwg         , Gg          , Gs^Fds      , Hh^Fms      , Hh^Fms      , Md          , Md          , Md          , Mm^Xm       , Mm^Xm       , Mm^Xm       , Mm^Xm       , Mm^Xm       , Mm^Xm       , Mm^Xm       , Mm^Xm       , Md          , Md          , Md          , Hh^Fms      , Gs^Fds      , Gs^Fds      , Gs^Fds      , Ww          , Gs^Fds      , Rrc         , Gs^Fds      , Gs^Fds      , Hh^Fms      , Hh^Fms      , Md          , Md          , Md          , Mm^Xm       , Mm^Xm       , Mm^Xm       , Mm^Xm       
Mm^Xm       , Mm^Xm       , Md          , Md          , Md          , Md          , Hh^Fds      , Hh^Fds      , Rr          , Wwg         , Gg^Efm      , Gs^Fds      , Hh^Fms      , Hh^Fms      , Md          , Md          , Mm^Xm       , Mm^Xm       , Mm^Xm       , Mm^Xm       , Mm^Xm       , Mm^Xm       , Mm^Xm       , Mm^Xm       , Mm^Xm       , Md          , Md          , Md          , Hh^Fms      , Hh^Fms      , Gg          , Gs^Fds      , Ww^Bsb/     , Rrc         , Gs^Fds      , Gs^Fds      , Gs^Fds      , Hh^Fms      , Hh^Fms      , Md          , Md          , Md          , Md          , Mm^Xm       , Mm^Xm       , Mm^Xm       
Mm^Xm       , Mm^Xm       , Mm^Xm       , Md          , Md          , Md          , Hh^Fds      , Hh^Fds      , Rr          , Wwg         , Gg^Es       , Gs^Fds      , Hh^Fms      , Hh^Fms      , Md          , Mm^Xm       , Mm^Xm       , Mm^Xm       , Mm^Xm       , Mm^Xm       , Mm^Xm       , Mm^Xm       , Mm^Xm       , Mm^Xm       , Mm^Xm       , Mm^Xm       , Md          , Md          , Hh^Fms      , Hh^Fms      , Gg          , Rrc         , Gg          , Ww          , Gs^Fds      , Gs^Fds      , Hh^Fds      , Hh^Fms      , Hh^Fms      , Md          , Md          , Md          , Md          , Mm^Xm       , Mm^Xm       , Mm^Xm       
Mm^Xm       , Mm^Xm       , Mm^Xm       , Md          , Hh^Fms      , Hh^Fms      , Hh^Fms      , Gs^Fds      , Rr          , Wwg         , Wwg         , Gg          , Hh^Fms      , Md          , Md          , Mm^Xm       , Mm^Xm       , Mm^Xm       , Mm^Xm       , Mm^Xm       , Mm^Xm       , Mm^Xm       , Mm^Xm       , Mm^Xm       , Md          , Md          , Md          , Md          , Md          , Hh^Fms      , Gg^Es       , Rrc         , Gg^Efm      , Ww          , Ww          , Gg          , Hh^Fds      , Hh^Fds      , Hh^Fms      , Md          , Md          , Md          , Md          , Md          , Mm^Xm       , Mm^Xm       
Mm^Xm       , Mm^Xm       , Mm^Xm       , Md          , Md          , Hh^Fms      , Hh^Fms      , Gs^Fds      , Gs^Fds      , Rr          , Wwg         , Gg          , Gs^Fds      , Hh^Fms      , Md          , Md          , Md          , Mm^Xm       , Md          , Mm^Xm       , Md          , Mm^Xm       , Mm^Xm       , Mm^Xm       , Mm^Xm       , Md          , Md          , Md          , Md          , Hh^Fms      , Gg          , Rrc         , Gg^Efm      , Gg^Efm      , Ww          , Gg          , Gs^Vl       , Hh^Fds      , Hh^Fds      , Hh^Fms      , Hh^Fms      , Md          , Md          , Md          , Md          , Mm^Xm       
Mm^Xm       , Mm^Xm       , Mm^Xm       , Mm^Xm       , Md          , Md          , Hh^Fms      , Hh^Fms      , Gs^Fds      , Rr          , Wwg^Bw\     , Gs^Vl       , Hh^Fms      , Hh^Fms      , Hh^Fms      , Md          , Md          , Md          , Md          , Md          , Md          , Md          , Md          , Md          , Md          , Mm^Xm       , Md          , Md          , Hh^Fms      , Hh^Fms      , Gs^Vl       , Rrc         , Rr          , Gg          , Ww          , Gg          , Ch          , Gg          , Gg          , Hh^Fds      , Hh^Fms      , Hh^Fms      , Md          , Md          , Md          , Mm^Xm       
Mm^Xm       , Mm^Xm       , Mm^Xm       , Mm^Xm       , Md          , Md          , Hh^Fds      , Gs^Fds      , Gs^Fds      , Wwg         , Gg          , Rr          , Ch          , Hh^Fms      , Hh^Fms      , Hh^Fms      , Hh^Fms      , Md          , Md          , Md          , Hh^Fms      , Md          , Md          , Md          , Md          , Md          , Md          , Md          , Hh^Fms      , Hh^Fms      , Gg          , Rrc         , Gg          , Rr          , Ww^Bw\      , Ch          , 5 Kh        , Ch          , Ch          , Gg          , Gs^Fds      , Hh^Fms      , Hh^Fms      , Md          , Md          , Md          
Mm^Xm       , Mm^Xm       , Mm^Xm       , Md          , Md          , Md          , Hh^Fms      , Hh^Fds      , Gs^Fds      , Wwg         , Wwg         , Ch          , Ch          , 7 Kh        , Hh^Fms      , Hh^Fms      , Hh^Fms      , Hh^Fds      , Hh^Fds      , Hh^Fds      , Hh^Fms      , Hh^Fms      , Hh^Fms      , Hh^Fms      , Hh^Fms      , Md          , Md          , Hh^Fms      , Hh^Fms      , Hh^Fms      , Rrc         , Rrc         , Gg^Efm      , Gg          , Ww          , Ch          , Ch          , Ch          , Gg          , Gg          , Gg          , Hh^Fms      , Hh^Fds      , Md          , Md          , Md          
Mm^Xm       , Mm^Xm       , Md          , Md          , Md          , Hh^Fds      , Hh^Fms      , Gs^Fds      , Gs^Fds      , Gg          , Wwg         , Gg          , Ch          , Ch          , Rr          , Hh^Fms      , Hh^Fms      , Hh^Fms      , Hh^Fds      , Hh^Fms      , Hh^Fds      , Hh^Fds      , Hh^Vl       , Hh^Fms      , Hh^Fms      , Hh^Fms      , Hh^Fms      , Hh^Fms      , Hh^Fms      , Gg          , Rrc         , Gg          , Ww          , Ww          , Gg          , Gg          , Gg          , Rr          , Rr          , Gg^Efm      , Gg^Efm      , Gs^Fds      , Hh^Fms      , Hh^Fms      , Md          , Md          
Mm^Xm       , Mm^Xm       , Md          , Md          , Hh^Fms      , Hh^Fds      , Hh^Fms      , Gs^Fds      , Gg^Efm      , Gg          , Wwg         , Gg          , Gg^Es       , Gg          , Wwg         , Rr          , Rr          , Gs^Fds      , Gs^Fds      , Hh^Fms      , Hh^Fds      , Hh^Fms      , Hh^Fms      , Hh^Fms      , Hh^Fds      , Hh^Fms      , Hh^Fms      , Hh^Fms      , Gs^Fds      , Gs^Fds      , Rrc         , Gg          , Ww          , Gg          , Gs^Vl       , Gg          , Gg^Es       , Gg          , Gg          , Rr          , Rr          , Gg          , Gs^Fds      , Hh^Fms      , Hh^Fds      , Md          
Mm^Xm       , Md          , Md          , Md          , Hh^Fms      , Hh^Fms      , Gs^Fds      , Gs^Fds      , Gg^Efm      , Gg^Efm      , Gg          , Wwg         , Wwg         , Wwg         , Gg          , Wwg         , Wwg^Bw/     , Rr          , Rr          , Hh^Fms      , Gs^Fds      , Hh^Fms      , Hh^Fms      , Hh^Fms      , Hh^Fds      , Md          , Md          , Hh^Fms      , Ch          , Gs^Fds      , Rrc         , Gs^Fds      , Ww          , Gg          , Gs^Fds      , Gs^Fds      , Gs^Fds      , Gs^Fds      , Gg          , Gg          , Rr          , Gg          , Gs^Vl       , Hh^Fms      , Hh^Fms      , Md          
Md          , Md          , Md          , Hh^Fds      , Hh^Fds      , Hh^Fms      , Gs^Fds      , Gs^Fds      , Gg^Efm      , Gg^Efm      , Gg          , Gg          , Gg          , Gg          , Rr          , Rr          , Gg          , Wwg         , Gg          , Rr          , Rr          , Hh^Fms      , Gs^Fds      , Hh^Fms      , Hh^Fms      , Md          , Md          , Hh^Fms      , 6 Kh        , Ch          , Rrc         , Gs^Fds      , Ww          , Gs^Fds      , Gs^Fds      , Gs^Fds      , Gs^Fds      , Gs^Fds      , Gs^Fds      , Gg          , Rr          , Gg          , Gg^Efm      , Hh^Fms      , Hh^Fms      , Hh^Fms      
Md          , Md          , Md          , Hh^Fds      , Hh^Fds      , Gs^Fds      , Gs^Fds      , Gg          , Gg          , Gg          , Gg          , Gs^Vl       , Gg          , Rr          , Hh^Fms      , Gs^Fds      , Gs^Fds      , Wwg         , Wwg         , Gg          , Rr          , Gs^Fds      , Gs^Fds      , Gs^Fds      , Hh^Fms      , Hh^Fms      , Hh^Fms      , Hh^Fms      , Ch          , Ch          , Rrc         , Gs^Fds      , Gs^Fds      , Ww          , Gs^Fds      , Gs^Fds      , Gs^Fds      , Gs^Fds      , Gs^Fds      , Gs^Fds      , Gg          , Rr          , Rr          , Gg          , Hh^Fms      , Hh^Fms      
Md          , Md          , Hh^Fds      , Hh^Fds      , Gs^Fds      , Gs^Fds      , Gg          , Gg^Efm      , Gg^Efm      , Gg          , Gg          , Gg          , Rr          , Rr          , Hh^Fms      , Hh^Fms      , Hh^Fms      , Gg          , Wwg         , Gg^Efm      , Gg^Efm      , Rr          , Rr          , Gs^Fds      , Gs^Fds      , Hh^Fms      , Hh^Fms      , Hh^Fms      , Gs^Fds      , Gg          , Gg          , Rrc         , Rrc         , Ww          , Gs^Fds      , Gs^Fds      , Gs^Fds      , Gs^Fds      , Hh^Fds      , Gs^Fds      , Gs^Fds      , Gg          , Rr          , Gg          , Gg          , Gs^Fds      
Hh^Fms      , Hh^Fms      , Hh^Fms      , Hh^Fds      , Gs^Fds      , Gs^Fds      , Gg          , Gg^Efm      , Gg^Efm      , Gg^Es       , Gg          , Gg          , Rr          , Gs^Fds      , Hh^Fms      , Hh^Fms      , Hh^Fms      , Gs^Fds      , Gs^Vl       , Wwg         , Wwg         , Gg          , Gg          , Rr          , Rr          , Hh^Fms      , Hh^Fms      , Hh^Fms      , Gs^Fds      , Gg^Efm      , Rr          , Rr          , Rrc         , Ww          , Ww          , Gs^Fds      , Gs^Fds      , Gs^Fds      , Hh^Fds      , Hh^Fds      , Gs^Fds      , Gg          , Rr          , Gg          , Gg          , Gs^Fds      
Hh^Fms      , Hh^Fds      , Hh^Fms      , Hh^Fms      , Gs^Fds      , Gg          , Gg          , Gg^Efm      , Gg^Efm      , Gg          , Rr          , Rr          , Gs^Fds      , Gs^Fds      , Gs^Fds      , Hh^Fds      , Hh^Fms      , Gs^Fds      , Gs^Fds      , Gg          , Gg          , Wwg         , Gg          , Gs^Vl       , Gg^Efm      , Rr          , Rr          , Hh^Fms      , Rr          , Rr          , Gg^Efm      , Gg^Efm      , Ww          , Ww^Bsb\     , Rrc         , Gg^Efm      , Gg          , Hh^Fds      , Hh^Fds      , Hh^Fds      , Hh^Fms      , Gg          , Gg          , Rr          , Rr          , Gg          
Hh^Fms      , Hh^Fms      , Hh^Fms      , Gs^Fds      , Gs^Fds      , Gg          , Gs^Vl       , Gg^Efm      , Gg          , Gg          , Rr          , Gg          , Gs^Fds      , Gs^Fds      , Hh^Fds      , Hh^Fds      , Hh^Fms      , Hh^Fms      , Gs^Fds      , Gs^Fds      , Gg          , Wwg         , Wwg         , Gg          , Gg^Efm      , Gg^Efm      , Gg          , Rr          , Gg          , Gs^Vl       , Gg          , Gg^Efm      , Ww          , Gg          , Gg^Es       , Rrc         , Gg          , Hh^Fds      , Hh^Fds      , Hh^Fds      , Hh^Fms      , Gs^Fds      , Gs^Fds      , Gs^Vl       , Gg          , Rr          
Hh^Fms      , Hh^Fms      , Gs^Fds      , Gs^Fds      , Gg          , Gg          , Gg          , Gg          , Gg          , Rr          , Gg^Efm      , Gg          , Gs^Fds      , Gs^Fds      , Hh^Fds      , Hh^Fds      , Hh^Fms      , Hh^Fds      , Gs^Fds      , Gs^Fds      , Gg          , Gg          , Gg^Es       , Wwg         , Wwg         , Ww          , Ww^Bw/      , Rr          , Gg          , Gg          , Ww          , Ww          , Gg          , Gg^Es       , Gg          , Rrc         , Hh^Fds      , Hh^Fds      , Hh^Fds      , Hh^Fds      , Hh^Fds      , Hh^Fms      , Hh^Fms      , Gs^Fds      , Gg          , Gg          
Hh^Fms      , Hh^Fms      , Gs^Fds      , Gs^Fds      , Gg          , Gg          , Gg          , Gg          , Gg          , Rr          , Gg          , Gg          , Gs^Fds      , Gs^Fds      , Gs^Fds      , Hh^Fds      , Hh^Fms      , Hh^Fds      , Gs^Fds      , Gs^Fds      , Gs^Fds      , Gg          , Gg          , Gg          , Gg          , Rr          , Gg          , Wwg         , Ww          , Ww          , Gg          , Gg          , Gg          , Gg^Es       , Gg          , Rrc         , Gg          , Hh^Fds      , Hh^Fds      , Hh^Fds      , Hh^Fds      , Hh^Fms      , Hh^Fms      , Gs^Fds      , Gg          , Gg          
