border_size=1
usage=map

Ms^Xm       , Ms^Xm       , Ms^Xm       , Ms^Xm       , Ms^Xm       , Ms          , Ms          , Ms          , Ms          , Ms          , Ha^Fma      , Ha^Fma      , Ha^Fma      , Ha^Fma      , Ha^Fma      , Ha^Fma      , Rr          , Wwg         , Ha^Fma      , Ha^Fma      , Ha^Fma      , Ha^Fma      , Ha^Fma      , Ha^Fma      , Ha^Fma      , Ha^Fma      , Ha^Fma      , Ms          , Ms          , Ms          , Ms          , Ms          , Ms          , Ms          , Ms          , Ms          , Ms          , Ms          , Ms          , Ms          , Ms          , Ms          , Ms^Xm       , Ms^Xm       , Ms^Xm       , Ms^Xm       
Ms^Xm       , Ms^Xm       , Ms          , Ms          , Ms          , Ms          , Ms          , Ms          , Ha^Fma      , Ms          , Ha^Fma      , Ha^Fma      , Gll^Fp      , Ha^Fma      , Ha^Fma      , Rr          , Gg          , Wwg         , Ha^Fma      , Aa^Fda      , Ha^Fma      , Aa^Fma      , Aa^Fpa      , Aa^Fpa      , Aa^Fma      , Aa^Fma      , Aa^Fma      , Aa^Fma      , Ms          , Ms          , Ha^Fma      , Ms          , Ms          , Ms          , Aa^Fpa      , Ha^Fma      , Aa^Fpa      , Ha^Fma      , Ha^Fma      , Ms          , Ms          , Ms          , Ms          , Ms^Xm       , Ms^Xm       , Ms^Xm       
Ms          , Ms^Xm       , Ms          , Ms          , Ms          , Ms          , Ha^Fma      , Ha^Fma      , Hh^Fp       , Ha^Fma      , Ha^Fma      , Gs^Fdw      , Gs^Fdw      , Gll^Fp      , Gg          , Rr          , Wwr         , Wwg         , Gd^Fmw      , Ha^Fma      , Hhd^Fdw     , Ha^Fma      , Gd^Fmw      , Hh^Fp       , Gd^Fmw      , Aa^Fma      , Aa^Fpa      , Aa^Fda      , Aa^Fda      , Aa^Fma      , Aa^Fma      , Aa^Fma      , Ha^Fma      , Ha^Fma      , Aa^Fma      , Ha^Fma      , Aa^Fda      , Aa^Fpa      , Aa^Fpa      , Aa^Fma      , Ha^Fma      , Ms          , Ms          , Ms          , Ms          , Ms^Xm       
Ms          , Ms          , Ms          , Ms          , Ha^Fma      , Ha^Fma      , Ha^Fma      , Ha^Fma      , Gs^Fdw      , Gs^Fdw      , Gll^Fp      , Ha^Fma      , Gll^Fp      , Gll^Fp      , Gg          , Rr          , Gg          , Wwg         , Gd^Fmw      , Gd^Fmw      , Gll^Fp      , Gd^Fmw      , Hhd^Fdw     , Hhd^Fdw     , Hhd^Fdw     , Hhd^Fdw     , Hhd^Fdw     , Aa^Fpa      , Aa^Fda      , Aa^Fda      , Aa^Fma      , Ha^Fma      , Ha^Fma      , Aa^Fma      , Aa^Fpa      , Ha^Fma      , Ha^Fpa      , Aa^Fpa      , Aa^Fpa      , Aa^Fpa      , Ha^Fma      , Aa^Fda      , Aa^Fda      , Ms          , Ms          , Ms          
Ms          , Ms          , Ms          , Ms          , Ha^Fma      , Ha^Fma      , Ha^Fpa      , Ha^Fma      , Gg          , Gll^Fp      , Gll^Fp      , Gll^Fp      , Gll^Fp      , Gg          , Gg^Gvs      , Rr          , Rr          , Ww          , Gg          , Gd^Fmw      , Gll^Fp      , Gd^Fmw      , Gg          , Hhd^Fdw     , Gg          , Hhd^Fdw     , Gg^Gvs      , Aa^Fpa      , Aa^Fpa      , Aa^Fda      , Aa^Fma      , Aa^Fma      , Aa^Fma      , Aa^Fma      , Ha^Fma      , Aa^Fpa      , Aa^Fpa      , Ha^Fpa      , Ha^Fpa      , Ha^Fpa      , Ha^Fma      , Ha^Fpa      , Ha^Fpa      , Gd^Fmw      , Ms          , Ms          
Ms          , Ms          , Ms          , Ha^Fma      , Ha^Fma      , Ha^Fma      , Gll^Fp      , Ha^Fpa      , Ha^Fpa      , Ha^Fpa      , Gg          , Gll^Fp      , Gg^Gvs      , Gg^Gvs      , Gg^Gvs      , Gs^Vh       , Rr          , Wwg         , Gg          , Gg          , Rp          , Gg          , Rp          , Gg          , Gg          , Gg^Gvs      , Gg^Gvs      , Gg^Gvs      , Gg^Gvs      , Aa^Fma      , Aa          , Aa          , Ha^Fma      , Aa^Fma      , Ha^Fpa      , Gg          , Gg          , Aa^Fpa      , Ha^Fpa      , Ha^Fma      , Ha^Fma      , Aa^Fda      , Aa^Fda      , Ha^Fpa      , Gd^Fmw      , Ms          
Ms          , Ms          , Ha^Fma      , Ha^Fma      , Ha^Fma      , Ha^Fma      , Ha^Fma      , Gll^Fp      , Gll^Fp      , Gll^Fp      , Gll^Fp      , Gll^Fp      , Gg          , Gg^Gvs      , Gg^Gvs      , Gg          , Rr          , Wwg         , Ww^Bw/      , Rp          , Gg          , Rp          , Gg^Gvs      , Rp          , Rp          , Gg          , Gs^Vh       , Gg^Gvs      , Gg          , Aa          , Aa          , Aa          , Gg          , Ha^Fpa      , Gg          , Gg          , Gll^Fp      , Ha^Fpa      , Gd^Fmw      , Ha^Fma      , Aa          , Ha^Fpa      , Gll^Fp      , Gd^Fmw      , Chr         , Gs^Fds      
Ms          , Ha^Fma      , Ha^Fma      , Ha^Fma      , Gs^Fdw      , Gs^Fdw      , Gs^Fds      , Gs^Fdw      , Gg          , Gg          , Gg          , Gg          , Gg          , Gg^Gvs      , Gg          , Gg          , Rr          , Rp          , Wwg         , Gg          , Gg          , Gg^Gvs      , Gg^Gvs      , Gg^Gvs      , Gg          , Rp          , Rp          , Gg          , Gg          , Gg          , Gg          , Gg          , Gg          , Gg          , Gg          , Gg          , Gg^Gvs      , Gd^Fmw      , Gd^Fmw      , Ha^Fma      , Ha^Fma      , Ha^Fma      , Gll^Fp      , Chr         , 2 Khr       , Gll^Fp      
Ha^Fma      , Ha^Fma      , Ha^Fma      , Gs^Fdw      , Gll^Fp      , Gs^Fdw      , Gs^Fdw      , Gs^Fdw      , Gg          , Gg          , Aa          , Gg          , Gg          , Gg          , Gg          , Rr          , Gg          , Gg          , Wwr         , Wwg         , Gg          , Gg^Gvs      , Gg^Gvs      , Gs^Vh       , Gg          , Gg          , Rp          , Gg          , Gg          , Gg          , Gg^Gvs      , Gg^Gvs      , Gg^Gvs      , Gg          , Gg          , Gg^Gvs      , Gg^Gvs      , Gg^Gvs      , Gg^Gvs      , Gd^Fmw      , Gd^Fmw      , Gll^Fp      , Gll^Fp      , Chr         , Chr         , Chr         
Ha^Fma      , Ha^Fma      , Ha^Fma      , Gll^Fp      , Gll^Fp      , Gs^Fdw      , Gs^Fdw      , Gs^Fdw      , Gg          , Gg          , Aa          , Aa          , Cha         , Ch          , Ch          , Rr          , Gg          , Gg          , Gg          , Wwg         , Aa          , Gg          , Gg          , Gg          , Gg^Gvs      , Gs^Vh       , Gg          , Rp          , Gg          , Gg^Gvs      , Gg^Gvs      , Gg^Gvs      , Gg^Gvs      , Gg          , Gg          , Gg^Gvs      , Gg^Gvs      , Gg^Gvs      , Gs^Vh       , Gd^Fmw      , Gd^Fmw      , Gll^Fp      , Gll^Fp      , Chr         , Chr         , Gll^Fp      
Ha^Fma      , Ha^Fma      , Gs^Fdw      , Gs^Fdw      , Gs^Fdw      , Gs^Fdw      , Gs^Fdw      , Gg          , Gg          , Gg          , Gg          , Aa          , Ch          , Ch          , Kha         , Ch          , Ch          , Gg^Efm      , Gg          , Wwg         , Aa          , Aa          , Gg          , Gg^Gvs      , Gg^Gvs      , Gg^Gvs      , Gg          , Rp          , Gg          , Gs^Vh       , Gg          , Gg^Gvs      , Aa          , Gg          , Gg          , Gg          , Aa          , Gg^Gvs      , Gd^Fmw      , Gd^Fmw      , Gd^Fmw      , Gll^Fp      , Gll^Fp      , Gll^Fp      , Gd^Fmw      , Gd^Fmw      
Ha^Fma      , Ha^Fma      , Ha^Fpa      , Ha^Fpa      , Gg          , Gll^Fp      , Gg          , Gg          , Gg^Gvs      , Gg          , Gg^Gvs      , Gg          , Gg          , Ch          , Ch          , Cha         , Aa          , Gg          , Gg          , Wwg         , Aa          , Aa          , Aa          , Gg^Gvs      , Gg^Gvs      , Gg^Gvs      , Gg          , Rp          , Rp          , Gg          , Gg          , Gg          , Aa^Gvs      , Aa          , Aa          , Aa          , Gg^Gvs      , Gg          , Gg          , Gd^Fmw      , Gd^Fmw      , Gd^Fmw      , Gd^Fmw      , Gd^Fmw      , Ha^Fma      , Ha^Fma      
Ha^Fma      , Ha^Fpa      , Gll^Fp      , Gg          , Gg          , Gg          , Gg          , Gg          , Gg^Gvs      , Gg^Gvs      , Gg^Gvs      , Gg          , Gg          , Gg          , Rp          , Aa          , Gg          , Gg          , Gg          , Wwg         , Wwg         , Aa          , Aa          , Gg^Gvs      , Gg          , Gg          , Gg          , Gg          , Rp          , Gg          , Gg^Efm      , Gg^Gvs      , Gg^Gvs      , Aa          , Aa          , Aa          , Gg^Gvs      , Gg^Gvs      , Gg          , Gll^Fp      , Gd^Fmw      , Gd^Fmw      , Gd^Fmw      , Ha^Fma      , Ha^Fpa      , Ha^Fpa      
Gd^Fmw      , Ha^Fma      , Gll^Fp      , Gd^Fmw      , Gll^Fp      , Gg          , Gg          , Gg          , Gg          , Gg^Gvs      , Gg^Gvs      , Gs^Vh       , Gg          , Gg          , Rp          , Gg          , Gg^Gvs      , Gg^Gvs      , Gg^Gvs      , Gg          , Wwg         , Aa          , Gg          , Gg          , Gg          , Gg^Gvs      , Gg^Gvs      , Gs^Vh       , Gg          , Rp          , Gg          , Gg^Gvs      , Gg^Gvs      , Aa          , Gg          , Aa          , Gs^Vh       , Gg^Gvs      , Gg          , Gll^Fp      , Gd^Fmw      , Gd^Fmw      , Gd^Fmw      , Ha^Fpa      , Ha^Fma      , Ha^Fma      
Gd^Fmw      , Gd^Fmw      , Gd^Fmw      , Gd^Fmw      , Gd^Fmw      , Gd^Fmw      , Gll^Fp      , Gg          , Gd^Fmw      , Gg          , Gg          , Gg          , Gg^Gvs      , Gg^Gvs      , Rp          , Gg          , Gs^Vh       , Gg^Gvs      , Gg^Gvs      , Gg          , Wwf         , Ww          , Gg          , Gg          , Gg^Gvs      , Gg^Gvs      , Gg^Gvs      , Gg^Gvs      , Gg          , Rp          , Gg          , Gs^Vh       , Gg          , Gg          , Gg^Gvs      , Gg^Gvs      , Gg^Gvs      , Gg          , Gd^Fmw      , Gd^Fmw      , Gll^Fp      , Gd^Fmw      , Ha^Fpa      , Ha^Fpa      , Ms          , Ha^Fma      
Ha^Fma      , Gd^Fmw      , Aa^Fpa      , Gd^Fmw      , Gd^Fmw      , Gd^Fmw      , Gll^Fp      , Gg          , Gd^Fmw      , Gg          , Gg          , Aa          , Aa          , Gg^Gvs      , Rp          , Gg          , Gg          , Gg^Gvs      , Gg          , Gg          , Gs^Fdw      , Ww          , Gg          , Gg          , Gg          , Gg^Gvs      , Gg^Gvs      , Gg^Gvs      , Gg          , Rp          , Gg          , Gg          , Gs^Vh       , Gg^Gvs      , Gg^Gvs      , Gg^Gvs      , Gg^Gvs      , Gg          , Gg          , Gll^Fp      , Gll^Fp      , Gll^Fp      , Ha^Fma      , Ha^Fpa      , Ms          , Ms          
Ha^Fma      , Ha^Fma      , Ha^Fma      , Aa^Fpa      , Gd^Fmw      , Gd^Fmw      , Gd^Fmw      , Gll^Fp      , Gd^Fmw      , Gd^Fmw      , Aa          , Aa          , Gg^Gvs      , Aa          , Gs^Vh       , Rp          , Rp          , Gg          , Gs^Fdw      , Gs^Fdw      , Gs^Fdw      , Wwg         , Wwg         , Gg          , Gg          , Gg          , Gg          , Gg          , Rp          , Rp          , Gg          , Gg          , Gg          , Gg^Gvs      , Gg^Gvs      , Gg^Gvs      , Gg          , Gg          , Gll^Fp      , Gll^Fp      , Gll^Fp      , Gll^Fp      , Ha^Fpa      , Ha^Fpa      , Ms          , Ms          
Ms          , Ms          , Ha^Fma      , Ha^Fma      , Ha^Fma      , Aa^Fpa      , Gd^Fmw      , Gd^Fmw      , Gd^Fmw      , Gll^Fp      , Gll^Fp      , Aa          , Gg          , Gg          , Gg^Efm      , Gg          , Gg          , Rp          , Rp          , Gs^Fdw      , Gs^Fdw      , Gs^Fdw      , Wwg         , Wwr         , Gg          , Gg          , Rp          , Rp          , Gg          , Gg          , Gg^Gvs      , Gg          , Gg^Gvs      , Gg          , Gg^Gvs      , Gg          , Gg          , Gll^Fp      , Gd^Fmw      , Gd^Fmw      , Gd^Fmw      , Gd^Fmw      , Ha^Fpa      , Ha^Fma      , Ms          , Ms          
Ms          , Ms          , Ms          , Ha^Fma      , Ha^Fma      , Ha^Fma      , Ha^Fma      , Gd^Fmw      , Gd^Fmw      , Gd^Fmw      , Gd^Fmw      , Gg          , Gg          , Gg          , Gg          , Gg          , Gg^Gvs      , Gs^Vh       , Gg          , Rp          , Rp          , Gs^Fdw      , Gs^Fdw      , Wwg         , Ww^Bw/      , Rp          , Gg          , Gg          , Gg          , Gs^Vh       , Gg^Gvs      , Gg^Gvs      , Gg^Gvs      , Gg^Gvs      , Gg^Gvs      , Gg          , Gll^Fp      , Gll^Fp      , Gll^Fp      , Gd^Fmw      , Gd^Fmw      , Ha^Fma      , Ha^Fma      , Ha^Fma      , Ms          , Ms          
Ms          , Ms          , Ms          , Ha^Fma      , Ha^Fma      , Ha^Fma      , Aa^Fpa      , Ha^Fma      , Ha^Fma      , Gd^Fmw      , Gd^Fmw      , Gll^Fp      , Gg          , Gg          , Gg          , Gg^Gvs      , Gg^Gvs      , Gg^Gvs      , Gg          , Gg          , Rp          , Gs^Fdw      , Rp          , 3 Rp        , Gg          , Wwg         , Aa          , Aa          , Aa          , Gg          , Aa          , Gg^Gvs      , Gg^Gvs      , Gg^Gvs      , Gg          , Gg          , Gll^Fp      , Gg          , Gll^Fp      , Gd^Fmw      , Gd^Fmw      , Ha^Fma      , Ha^Fma      , Ms          , Ms          , Ms          
Ms          , Ms          , Ms          , Ms          , Ms          , Ha^Fma      , Ha^Fma      , Aa^Fpa      , Ha^Fma      , Gd^Fmw      , Gd^Fmw      , Gll^Fp      , Gll^Fp      , Gg          , Gg          , Gg          , Gg^Gvs      , Gg          , Gg          , Gg          , Aa          , Rp          , Gg          , Gg          , Gg          , Wwg         , Wwg         , Aa          , Aa          , Aa          , Gg          , Gg^Gvs      , Gg          , Gg^Gvs      , Gg          , Gg          , Gll^Fp      , Gll^Fp      , Gll^Fp      , Ha^Fpa      , Ha^Fpa      , Ha^Fma      , Ms          , Ms          , Ms          , Ms          
Ms          , Ms          , Ms          , Ms          , Ms          , Ms          , Ha^Fma      , Ha^Fma      , Ha^Fma      , Ha^Fma      , Ha^Fma      , Gd^Fmw      , Gll^Fp      , Gll^Fp      , Gg          , Gg          , Gg          , Gg          , Gg          , Aa          , Aa          , Gg          , Gg          , Gg^Gvs      , Gg^Gvs      , Gg          , Gg          , Wwg         , Aa          , Gg          , Gg^Gvs      , Gg^Gvs      , Gg^Gvs      , Gg          , Gg          , Gg          , Gd^Fmw      , Gd^Fmw      , Gd^Fmw      , Gd^Fmw      , Ha^Fpa      , Ha^Fma      , Ms          , Ms          , Ms          , Ms          
Ms          , Ms          , Ms          , Ms          , Ms          , Ms          , Ms          , Ha^Fma      , Ha^Fma      , Ha^Fma      , Aa^Fpa      , Gll^Fp      , Gll^Fp      , Gd^Fmw      , Gll^Fp      , Gll^Fp      , Gg          , Gg          , Gg          , Gg          , Gg          , Gg          , Gs^Vh       , Gg^Gvs      , Gg^Gvs      , Gg^Gvs      , Gg          , Wwg         , Ww          , Gg          , Gs^Vh       , Gg^Gvs      , Gg^Gvs      , Gg          , Gll^Fp      , Gd^Fmw      , Gll^Fp      , Gll^Fp      , Gd^Fmw      , Gd^Fmw      , Gd^Fmw      , Ha^Fpa      , Ms          , Ms          , Ms          , Ms          
Ms^Xm       , Ms          , Ms          , Ms          , Ms          , Ms          , Ms          , Ms          , Ha^Fma      , Ha^Fma      , Ha^Fma      , Gll^Fp      , Gd^Fmw      , Gll^Fp      , Gll^Fp      , Gg          , Gll^Fp      , Gg          , Gg          , Gg          , Gg          , Gg          , Gg          , Gs^Gvs      , Gg^Gvs      , Gg^Gvs      , Gg          , Gg          , Wwf         , Gg          , Gg          , Gg^Gvs      , Gg^Gvs      , Gg          , Gll^Fp      , Gll^Fp      , Gll^Fp      , Gll^Fp      , Gd^Fmw      , Gd^Fmw      , Ha^Fpa      , Ha^Fma      , Ms          , Ms          , Ms          , Ms          
Ms^Xm       , Ms          , Ms          , Ms          , Ms          , Ms          , Ms          , Ms          , Ha^Fpa      , Ha^Fma      , Ha^Fma      , Ha^Fma      , Gd^Fmw      , Gll^Fp      , Gll^Fp      , Gll^Fp      , Gll^Fp      , Gg          , Gg          , Gg          , Gg          , Gg          , Gg          , Gg          , Gg          , Gg          , Gg          , Gg          , Gg          , Wwg         , Gg          , Gg^Gvs      , Gg          , Gg          , Gll^Fp      , Gll^Fp      , Gll^Fp      , Gll^Fp      , Ha^Fma      , Ha^Fpa      , Ha^Fma      , Ha^Fma      , Ms          , Ms          , Ms          , Ms          
Ms^Xm       , Ms^Xm       , Ms          , Ms          , Ms          , Ms          , Ms          , Ms          , Ha^Fpa      , Ha^Fpa      , Ha^Fma      , Ha^Fma      , Ha^Fma      , Gd^Fmw      , Gd^Fmw      , Gll^Fp      , Gd^Fmw      , Gg          , Gll^Fp      , Gll^Fp      , Gd^Fmw      , Gd^Fmw      , Gll^Fp      , Gg          , Gg          , Gg          , Gg          , Gg          , Gg          , Wwg         , Gg          , Gg          , Gg          , Gg          , Gll^Fp      , Gd^Fmw      , Gd^Fmw      , Gd^Fmw      , Ha^Fma      , Ha^Fpa      , Ha^Fma      , Ms          , Ms          , Ms          , Ms          , Mm^Xm       
Ms^Xm       , Ms^Xm       , Ms^Xm       , Ms          , Ms          , Ms          , Ms          , Ms          , Ha^Fpa      , Ha^Fma      , Ha^Fma      , Ha^Fma      , Ha^Fma      , Gd^Fmw      , Gd^Fmw      , Gd^Fmw      , Gd^Fmw      , Gll^Fp      , Gd^Fmw      , Gd^Fmw      , Gd^Fmw      , Gd^Fmw      , Gd^Fmw      , Gll^Fp      , Gd^Fmw      , Gg          , Gg          , Gg          , Gg          , Wwg         , Wwg         , Gg          , Gg          , Gg          , Gll^Fp      , Gd^Fmw      , Gd^Fmw      , Ha^Fma      , Ha^Fpa      , Ha^Fpa      , Ms          , Ms          , Ms          , Ms          , Ms          , Ms^Xm       
Ms^Xm       , Ms^Xm       , Ms^Xm       , Ms          , Ms          , Ms          , Ms          , Ms          , Ms          , Ha^Fma      , Ha^Fma      , Ha^Fma      , Ha^Fma      , Ha^Fma      , Ha^Fma      , Aa^Fpa      , Ha^Fpa      , Gll^Fp      , Ha^Fma      , Ha^Fma      , Ha^Fpa      , Gll^Fp      , Gll^Fp      , Gd^Fmw      , Gd^Fmw      , Gd^Fmw      , Gll^Fp      , Gg          , Gd^Fmw      , Gg          , Wwf         , Gg          , Gg          , Gll^Fp      , Gd^Fmw      , Gd^Fmw      , Ha^Fma      , Ha^Fpa      , Ha^Fma      , Ha^Fma      , Ms          , Ms          , Ms          , Ms          , Ms^Xm       , Ms^Xm       
Ms^Xm       , Ms^Xm       , Ms^Xm       , Ms          , Ms          , Ms          , Ms          , Ms          , Ms          , Ms          , Ms          , Ha^Fma      , Ha^Fma      , Ha^Fma      , Ha^Fma      , Ha^Fma      , Ha^Fma      , Ha^Fma      , Ha^Fpa      , Ha^Fpa      , Ha^Fpa      , Ha^Fma      , Ha^Fma      , Gll^Fp      , Gll^Fp      , Gll^Fp      , Gll^Fp      , Gll^Fp      , Gd^Fmw      , Gd^Fmw      , Wwg         , Gg          , Gg          , Gd^Fmw      , Ha^Fma      , Ha^Fpa      , Ha^Fpa      , Ha^Fma      , Ms          , Ms          , Ms          , Ms          , Ms          , Ms          , Ms^Xm       , Ms^Xm       
Ms^Xm       , Ms^Xm       , Ms^Xm       , Ms^Xm       , Ms          , Ms          , Ms          , Ms          , Ms          , Ms          , Ms          , Ms          , Ms          , Ms          , Ms          , Ha^Fma      , Ha^Fma      , Ha^Fpa      , Ha^Fma      , Ha^Fma      , Ha^Fma      , Ha^Fpa      , Ha^Fma      , Ha^Fma      , Ha^Fpa      , Ha^Fma      , Ha^Fma      , Ha^Fma      , Ha^Fpa      , Gd^Fmw      , Gd^Fmw      , Wwf         , Gg          , Gd^Fmw      , Ha^Fpa      , Ha^Fpa      , Ha^Fma      , Ha^Fma      , Ms          , Ms          , Ms          , Ms          , Ms          , Mm^Xm       , Ms^Xm       , Ms^Xm       
Ms^Xm       , Ms^Xm       , Ms^Xm       , Ms^Xm       , Ms^Xm       , Ms          , Ms          , Ms          , Ms          , Ms          , Ms          , Ms          , Ms          , Ms          , Ms          , Ms          , Ha^Fma      , Ha^Fma      , Ha^Fma      , Ha^Fma      , Ha^Fma      , Ha^Fma      , Ha^Fma      , Ha^Fma      , Ha^Fma      , Ha^Fma      , Ha^Fma      , Ha^Fpa      , Ha^Fma      , Gd^Fmw      , Ha^Fma      , Ai          , Gg          , Ha          , Ha^Fma      , Ha^Fma      , Ms          , Ms          , Ms          , Ms          , Ms          , Ms          , Ms^Xm       , Ms^Xm       , Ms^Xm       , Ms^Xm       
Ms^Xm       , Mm^Xm       , Ms^Xm       , Mm^Xm       , Mm^Xm       , Ms^Xm       , Ms^Xm       , Ms          , Ms          , Ms          , Ms          , Ms          , Ms          , Ms          , Ms          , Ms          , Ms          , Ms          , Ms          , Ha^Fma      , Ms          , Ha^Fma      , Ms          , Ha^Fma      , Ms          , Ms          , Ms          , Ha^Fma      , Ms          , Ha^Fma      , Ha^Fma      , Ai          , Ha^Fma      , Ha^Fma      , Ms          , Ms          , Ms          , Ms          , Ms          , Ms          , Ms^Xm       , Ms^Xm       , Ms^Xm       , Ms^Xm       , Ms^Xm       , Ms^Xm       
Ms^Xm       , Mm^Xm       , Ms^Xm       , Ms^Xm       , Ms^Xm       , Mm^Xm       , Ms^Xm       , Mm^Xm       , Ms^Xm       , Ms          , Ms^Xm       , Ms          , Mm^Xm       , Ms          , Ms^Xm       , Ms          , Ms^Xm       , Ms          , Ms^Xm       , Ms          , Ms          , Ms          , Ms          , Ms          , Ms          , Ms          , Ms          , Ms          , Ms          , Ms          , Ms          , Ai          , Ms          , Ms          , Ms          , Ms          , Ms          , Ms          , Ms^Xm       , Ms^Xm       , Mm^Xm       , Ms^Xm       , Ms^Xm       , Ms^Xm       , Ms^Xm       , Ms^Xm       
Ms^Xm       , Ms^Xm       , Ms^Xm       , Ms^Xm       , Ms^Xm       , Ms^Xm       , Ms^Xm       , Ms^Xm       , Ms^Xm       , Ms^Xm       , Ms^Xm       , Ms^Xm       , Ms^Xm       , Mm^Xm       , Ms^Xm       , Ms^Xm       , Ms^Xm       , Ms^Xm       , Ms^Xm       , Ms^Xm       , Ms^Xm       , Ms^Xm       , Ms^Xm       , Ms^Xm       , Ms^Xm       , Ms          , Ms^Xm       , Ms          , Ms^Xm       , Ms          , Ms^Xm       , Ai          , 1 Ai        , Ms          , Ms^Xm       , Ms^Xm       , Ms^Xm       , Mm^Xm       , Ms^Xm       , Ms^Xm       , Mm^Xm       , Ms^Xm       , Ms^Xm       , Ms^Xm       , Ms^Xm       , Ms^Xm       
Ms^Xm       , Ms^Xm       , Ms^Xm       , Ms^Xm       , Ms^Xm       , Ms^Xm       , Ms^Xm       , Ms^Xm       , Ms^Xm       , Ms^Xm       , Ms^Xm       , Ms^Xm       , Ms^Xm       , Ms^Xm       , Ms^Xm       , Ms^Xm       , Ms^Xm       , Ms^Xm       , Ms^Xm       , Ms^Xm       , Ms^Xm       , Ms^Xm       , Ms^Xm       , Ms^Xm       , Ms^Xm       , Ms^Xm       , Ms^Xm       , Ms^Xm       , Ms^Xm       , Ms^Xm       , Ms^Xm       , Ms^Xm       , Ai          , Ms^Xm       , Ms^Xm       , Ms^Xm       , Ms^Xm       , Ms^Xm       , Ms^Xm       , Ms^Xm       , Ms^Xm       , Ms^Xm       , Ms^Xm       , Ms^Xm       , Ms^Xm       , Ms^Xm       
