border_size=1
usage=map

Gs^Fds      , Gs^Fds      , Gs^Fds      , Gs^Fds      , Gs^Fds      , Gs^Fds      , Hh^Fms      , Gs^Fds      , Gs^Fds      , Hh^Fms      , Hh^Fms      , Gs^Fds      , Gs^Fds      , Gs^Fds      , Gs^Fds      , Gs^Fds      , Gs^Fds      , Gs^Fds      , Gg          , Rp          , Gg          , Gg          , Gs^Fds      , Gs^Fds      , Hh^Fms      , Gs^Fds      , Gs^Fds      , Gs^Fds      , Gg          , Rp          , Gg          , Gg          , Gg          , Gs^Fds      , Gs^Fds      , Gs^Fds      , Gs^Fds      , Gs^Fds      , Hh^Fms      , Gs^Fds      , Hh^Fms      , Hh^Fms      , Hh^Fms      , Hh^Fms      , Hh^Fms      , Hh^Fms      
Gs^Fds      , Hh^Fms      , Hh^Fms      , Hh^Fms      , Gs^Fds      , Gs^Fds      , Hh^Fms      , Hh^Fms      , Hh^Fms      , Gs^Fds      , Hh^Fms      , Gs^Fds      , Gs^Fds      , Gs^Fds      , Gs^Fds      , Gs^Fds      , Gs^Fds      , Gs^Fds      , Gg          , Rp          , Rp          , Gg          , Gs^Fds      , Gs^Fds      , Gs^Fds      , Hh^Fms      , Gs^Fds      , Gs^Fds      , Gg          , Rp          , Rp          , Gg          , Gg          , Gs^Fds      , Gs^Fds      , Gs^Fds      , Gs^Fds      , Gs^Fds      , Gs^Fds      , Hh^Fms      , Hh^Fms      , Gs^Fds      , Hh^Fms      , Hh^Fms      , Hh^Fms      , Gs^Fds      
Hh^Fms      , Gs^Fds      , Gs^Fds      , Gs^Fds      , Gs^Fds      , Gs^Fds      , Hh^Fms      , Hh^Fms      , Gs^Fds      , Hh^Fms      , Hh^Fms      , Hh^Fms      , Gs^Fds      , Hh^Fms      , Gs^Fds      , Gs^Fds      , Gs^Fds      , Gs^Fds      , Gg          , Gg          , Rp          , Gg          , Gg          , Gs^Fds      , Gs^Fds      , Gs^Fds      , Gs^Fds      , Gs^Fds      , Rb^Gvs      , Gg          , Rp          , Gg          , Gg          , Gg          , Gs^Fds      , Gs^Fds      , Gs^Fds      , Gs^Fds      , Gs^Fds      , Gs^Fds      , Gs^Fds      , Hh^Fms      , Hh^Fms      , Hh^Fms      , Gs^Fds      , Gs^Fds      
Gs^Fds      , Gs^Fds      , Gs^Fds      , Gs^Fds      , Gs^Fds      , Hh^Fms      , Gs^Fds      , Gs^Fds      , Gs^Fds      , Gs^Fds      , Gs^Fds      , Gs^Fds      , Gs^Fds      , Gs^Fds      , Gs^Fds      , Gs^Fds      , Gs^Fds      , Gs^Fds      , Gs^Fds      , Gg          , Gg          , Rp          , Rp          , Gs^Fds      , Gs^Fds      , Gs^Fds      , Gs^Fds      , Gs^Fds      , Rb^Gvs      , Rb^Gvs      , Rb^Gvs      , Rp          , Rp          , Gg          , Gg          , Gs^Fds      , Gs^Fds      , Gs^Fds      , Gs^Fds      , Gs^Fds      , Gs^Fds      , Gs^Fds      , Gs^Fds      , Gs^Fds      , Gs^Fds      , Gs^Fds      
Gs^Fds      , Gs^Fds      , Gs^Fds      , Gs^Fds      , Gs^Fds      , Hh^Fms      , Gs^Fds      , Gs^Fds      , Gs^Fds      , Hh^Fms      , Hh^Fms      , Gs^Fds      , Gs^Fds      , Gs^Fds      , Gs^Fds      , Gs^Fds      , Gs^Fds      , Gs^Fds      , Rb^Gvs      , Gg          , Gg          , Gg          , Rp          , Gg          , Gs^Fds      , Gs^Fds      , Gs^Fds      , Gs^Fds      , Gg          , Rb^Gvs      , Rb^Gvs      , Rb^Gvs      , Rp          , Gg          , Rb^Gvs      , Gg          , Gs^Fds      , Gs^Fds      , Gs^Fds      , Gs^Fds      , Gs^Fds      , Gs^Fds      , Gs^Fds      , Gs^Fds      , Gs^Fds      , Gs^Fds      
Gs^Fds      , Gs^Fds      , Gs^Fds      , Gs^Fds      , Gs^Fds      , Hh^Fms      , Gs^Fds      , Gs^Fds      , Gs^Fds      , Gs^Fds      , Gs^Fds      , Gs^Fds      , Gs^Fds      , Gs^Fds      , Gs^Fds      , Gs^Fds      , Gs^Fds      , Rb^Gvs      , Rb^Gvs      , Rb^Gvs      , Rb^Gvs      , Gg          , Gg          , Rp          , Gg          , Gs^Fds      , Gs^Fds      , Gg          , Gg          , Gs^Vh       , Rb^Gvs      , Rb^Gvs      , Rp          , Gg          , Rb^Gvs      , Rb^Gvs      , Rb^Gvs      , Gs^Fds      , Gs^Fds      , Gs^Fds      , Gs^Fds      , Gs^Fds      , Gs^Fds      , Gs^Fds      , Gs^Fds      , Gs^Fds      
Gs^Fds      , Gs^Fds      , Gs^Fds      , Gs^Fds      , Gs^Fds      , Gs^Fds      , Gs^Fds      , Gs^Fds      , Gs^Fds      , Gs^Fds      , Gs^Fds      , Gs^Fds      , Gs^Fds      , Gs^Fds      , Gs^Fds      , Gs^Fds      , Gs^Fds      , Rb^Gvs      , Rb^Gvs      , Rb^Gvs      , Gs^Vh       , Gg          , Rp          , Rp          , Gg          , Gg          , Gg          , Gg          , Gg          , Gg          , Gg          , Rb^Gvs      , Rp          , Rb^Gvs      , Rb^Gvs      , Rb^Gvs      , Rb^Gvs      , Gg          , Gg          , Gs^Fds      , Gs^Fds      , Gs^Fds      , Gs^Fds      , Gs^Fds      , Gs^Fds      , Gs^Fds      
Gg          , Gs^Fds      , Gs^Fds      , Gs^Fds      , Gs^Fds      , Gs^Fds      , Gs^Fds      , Gs^Fds      , Gs^Fds      , Gs^Fds      , Gs^Fds      , Gs^Fds      , Gs^Fds      , Hh^Fms      , Gs^Fds      , Gs^Fds      , Gs^Fds      , Rb^Gvs      , Rb^Gvs      , Rb^Gvs      , Gg          , Rp          , Gg          , Gg          , Co          , Gg          , Gg          , Gg^Efm      , Gg          , Gg          , Gg^Efm      , Gg          , Rp          , Rb^Gvs      , Rb^Gvs      , Rb^Gvs      , Rb^Gvs      , Rb^Gvs      , Gg          , Gs^Fds      , Gs^Fds      , Gs^Fds      , Gs^Fds      , Gs^Fds      , Gs^Fds      , Gs^Fds      
Gg          , Gg          , Gg          , Gg          , Rb^Gvs      , Rb^Gvs      , Rb^Gvs      , Gs^Fds      , Gs^Fds      , Gs^Fds      , Gs^Fds      , Gs^Fds      , Gs^Fds      , Gs^Fds      , Gs^Fds      , Gs^Fds      , Gs^Fds      , Gg          , Gg          , Gg          , Gg          , Rp          , Gg          , Co          , 2 Ko        , Co          , Co          , Gg          , Gg^Es       , Gg          , Gg^Es       , Gg          , Gg^Eff      , Rp          , Gg          , Gs^Vh       , Rb^Gvs      , Rb^Gvs      , Gg          , Gg^Efm      , Gg^Es       , Gg          , Gg          , Gs^Fds      , Gg          , Gg          
Gg          , Gg          , Gg          , Rb^Gvs      , Rb^Gvs      , Rb^Gvs      , Rb^Gvs      , Gg          , Gg          , Gs^Fds      , Gg          , Gs^Fds      , Gs^Fds      , Gs^Fds      , Gs^Fds      , Gs^Fds      , Gs^Fds      , Gs^Fds      , Gg          , Gg^Es       , Gg          , Rp          , Gg          , Co          , Co          , Co          , Co          , Gg          , Gg          , Gg          , Gg^Eff      , Gg^Eff      , Rb^Gvs      , Rp          , Rp          , Gg          , Gg          , Gg          , Rb^Gvs      , Gg          , Rb^Gvs      , Rb^Gvs      , Gs^Vh       , Gg          , Gg          , Gg          
Rp          , Gg^Es       , Rp          , Rb^Gvs      , Rp          , Rb^Gvs      , Gs^Vh       , Rb^Gvs      , Gg          , Gg          , Gg^Wm       , Gg          , Gg          , Gg          , Gg          , Gg          , Gg          , Gg          , Gg^Efm      , Gg          , Rp          , Rp          , Gg          , Co          , Gg          , Co          , Gg          , Gg          , Gg^Eff      , Gg^Eff      , Gg          , Gg          , Rb^Gvs      , Rb^Gvs      , Gg          , Rp          , Rp          , Gg          , Rb^Gvs      , Gg          , Rb^Gvs      , Rb^Gvs      , Gg          , Gg          , Rp          , Rp          
Gg          , Rp          , Gg          , Rp          , Gg          , Rp          , Rp          , Rp          , Rp          , Gg          , Rp          , Gg          , Gg          , Rb^Gvs      , Rb^Gvs      , Rb^Gvs      , Rb^Gvs      , Gg          , Rb^Gvs      , Gg          , Rp          , Gg^Eff      , Gg^Eff      , Gg          , Gg          , Gg          , Rb^Eff      , Rb^Eff      , Rb^Gvs      , Gg          , Gg          , Rb^Gvs      , Rb^Gvs      , Rb^Gvs      , Rb^Gvs      , Gg          , Rp          , Gg          , Gg          , Rb^Gvs      , Rb^Gvs      , Rb^Gvs      , Rp          , Rp          , Gg          , Gg          
Gs^Fds      , Gg          , Gs^Fds      , Gg          , Gg          , Gg          , Gg          , Gg          , Gg          , Rp          , Gg          , Rp          , Rp          , Rb^Gvs      , Rb^Gvs      , Rb^Gvs      , Rb^Gvs      , Rb^Gvs      , Rp          , Rp          , Gg          , Rp          , Gg          , Gg^Eff      , Gg          , Gg^Eff      , Rb^Gvs      , Rb^Gvs      , Rb^Gvs      , Gg          , Gg          , Rb^Gvs      , Rb^Gvs      , Rb^Gvs      , Rb^Gvs      , Gg          , Gg          , Rp          , Rp          , Gg          , Rp          , Rp          , Rb^Gvs      , Gg          , Rb^Gvs      , Rb^Gvs      
Gs^Fds      , Gs^Fds      , Gs^Fds      , Gs^Fds      , Gs^Fds      , Gg          , Gg^Es       , Gg^Efm      , Gg          , Rp          , Gg          , Gg          , Gg          , Rp          , Rp          , Gs^Vh       , Rp          , Rp          , Gg          , Gg          , Gg          , Rp          , Rp          , Gg          , Gg^Es       , Gg          , Rb^Gvs      , Rb^Gvs      , Rb^Gvs      , Rb^Gvs      , Gg          , Gg          , Gg          , Rb^Gvs      , Gs^Vh       , Gg          , Gg          , Gg          , Rp          , Rp          , Gg          , Gg          , Rb^Gvs      , Rb^Gvs      , Rb^Gvs      , Rb^Gvs      
Gs^Fds      , Hh^Fms      , Gs^Fds      , Gs^Fds      , Rb^Gvs      , Gg          , Gg          , Gg          , Rp          , Rp          , Rb^Gvs      , Gg          , Gg^Efm      , Gg          , Gg          , Rp          , Gg          , Gg          , Rb^Gvs      , Rb^Gvs      , Gg          , Gg          , Gg          , Rp          , Rp          , Gg          , Gg          , Rb^Gvs      , Gg          , Gg          , Rp          , Gg^Efm      , Rp          , Gg          , Gg          , Gg          , Gg          , Gg^Wm       , Rp^Es       , Gg          , Gg          , Gs^Vh       , Rb^Gvs      , Rb^Gvs      , Rb^Gvs      , Ww          
Gs^Fds      , Gs^Fds      , Rb^Gvs      , Rb^Gvs      , Rb^Gvs      , Rb^Gvs      , Gg          , Gg          , Rp          , Gg          , Rb^Gvs      , Rb^Gvs      , Rb^Gvs      , Gg          , Gg          , Rp          , Gg^Efm      , Gg          , Rb^Gvs      , Rb^Gvs      , Rb^Gvs      , Gg          , Gg          , Gg          , Rp          , Gg          , Rp          , Gs^Vh       , Rp          , Rp          , Gg          , Rp          , Gg          , Rp          , Rp          , Gg^Efm      , Rp          , Rp          , Gg          , Gg          , Gg          , Rb^Gvs      , Rb^Gvs      , Rb^Gvs      , Rb^Gvs      , Ww          
Gs^Fds      , Gs^Fds      , Rb^Gvs      , Rb^Gvs      , Rb^Gvs      , Rb^Gvs      , Gg          , Rp          , Gg          , Gg          , Rb^Gvs      , Rb^Gvs      , Rb^Gvs      , Rb^Gvs      , Gg          , Rp          , Gg          , Gg          , Rb^Gvs      , Rb^Gvs      , Rb^Gvs      , Gg          , Gg          , Gg^Wm       , Gg          , Rp          , Gg          , Rp          , Gg^Es       , Gg          , Rb^Gvs      , Gg          , Rb^Gvs      , Gs^Vh       , Gg          , Rp          , Gg          , Gs^Vh       , Rb^Gvs      , Gg^Efm      , Gg          , Gg          , Gg          , Rb^Gvs      , Ww          , Ww          
Gs^Fds      , Rb^Gvs      , Rb^Gvs      , Rb^Gvs      , Gg          , Gs^Vh       , Rp          , Rp          , Gg          , Gs^Vh       , Rb^Gvs      , Rb^Gvs      , Rb^Gvs      , Gg          , Gg          , Rp          , Gg          , Gg          , Gg          , Rb^Gvs      , Gg          , Gs^Vh       , Gg          , Gg          , Gg          , Rp          , Gg          , Gg          , Rb^Gvs      , Rb^Gvs      , Rb^Gvs      , Rb^Gvs      , Gg          , Gg          , Rp          , Rp          , Gg          , Rb^Gvs      , Rb^Gvs      , Rb^Gvs      , Rb^Gvs      , Gg^Efm      , Ww          , Ww          , Rb^Gvs      , Rb^Gvs      
Gg          , Gg          , Gg          , Rb^Gvs      , Gg          , Gg          , Rp          , Gg          , Gg          , Gg          , Rb^Gvs      , Rb^Gvs      , Gg          , Gg          , Gg          , Rp          , Gg          , Gg          , Rb^Gvs      , Gg          , Rb^Gvs      , Gg          , Gg          , Gg^Es       , Gg          , Rp          , Rb^Gvs      , Rb^Gvs      , Rb^Gvs      , Rb^Gvs      , Rb^Gvs      , Rb^Gvs      , Gg          , Gg          , Rp          , Gg          , Gg          , Rb^Gvs      , Rb^Gvs      , Rb^Gvs      , Rb^Gvs      , Ww          , Rb^Gvs      , Rb^Gvs      , Rb^Gvs      , Rb^Gvs      
Gg          , Gg^Efm      , Rp          , Rp          , Rp          , Rp          , Gg          , Gg^Es       , Rb^Gvs      , Rb^Gvs      , Rb^Gvs      , Rb^Gvs      , Gg          , Gg          , Gg          , Rp          , Gs^Vh       , Rb^Gvs      , Rb^Gvs      , Rb^Gvs      , Rb^Gvs      , Gg          , Rb^Gvs      , Gg          , Gg          , Rp          , Gg          , Gg          , Gg          , Gg          , Rb^Gvs      , Rb^Gvs      , Gg^Es       , Gg          , Rp          , Gg          , Gg          , Gg^Efm      , Rb^Gvs      , Rb^Gvs      , Gg          , Ww          , Rb^Gvs      , Rb^Gvs      , Rb^Gvs      , Rb^Gvs      
Rp          , Rp          , Rp          , Gg          , Gg          , Gg          , Gs^Vh       , Rb^Gvs      , Rb^Gvs      , Rb^Gvs      , Rb^Gvs      , Rb^Gvs      , Gg          , Gg^Es       , Gg          , Rp          , Rp          , Rb^Gvs      , Rb^Gvs      , Rb^Gvs      , Rb^Gvs      , Rb^Gvs      , Rb^Gvs      , Gg          , Gg          , Rp          , Rp          , Rr^Vhc      , Gg          , Gg          , Rb^Gvs      , Rb^Gvs      , Rb^Gvs      , Gg          , Rp          , Rb^Gvs      , Rb^Gvs      , Rb^Gvs      , Rb^Gvs      , Gg          , Gg          , Ww          , Rb^Gvs      , Rb^Gvs      , Gs^Vh       , Rb^Gvs      
Rb^Gvs      , Gg          , Gg          , Rp          , Rp          , Gg          , Gg          , Rb^Gvs      , Gg          , Rb^Gvs      , Rp          , Gg          , Rp          , Gg          , Gg          , Rp          , Gg^Efm      , Rp          , Rp          , Gg          , Gg          , Rb^Gvs      , Gg          , Gg          , Gs^Vh       , Gg          , Rp          , Gg^Efm      , Gg          , Rb^Gvs      , Rb^Gvs      , Rb^Gvs      , Gs^Vh       , Gg^Efm      , Rp          , Rb^Gvs      , Rb^Gvs      , Rb^Gvs      , Rb^Gvs      , Gg          , Ww          , Ww          , Gg          , Gg          , Rp          , Rp          
Rb^Gvs      , Gs^Vh       , Gg          , Gg          , Gg          , Rp          , Rp          , Gg          , Rp          , Rp          , Gg          , Rp          , Gg          , Rp          , Rp          , Rp          , Rp          , Gg          , Gs^Vh       , Rp          , Rp          , Gg          , Gg          , Rb^Gvs      , Rb^Gvs      , Gg          , Gg          , Rp          , Gg          , Rb^Gvs      , Rb^Gvs      , Rb^Gvs      , Ww          , Gg          , Gg          , Rp          , Rb^Gvs      , Rb^Gvs      , Gs^Vh       , Ww          , Rp          , Rp          , Rp          , Rp          , Gg          , Gg          
Rb^Gvs      , Rb^Gvs      , Rb^Gvs      , Gg^Efm      , Gg          , Gg          , Gg          , Rp          , Gg          , Gg          , Gg          , Gg          , Gg          , Gs^Vh       , Rb^Gvs      , Gg          , Rp          , Rb^Gvs      , Rb^Gvs      , Rb^Gvs      , Gg          , Rp          , Rp          , Rb^Gvs      , Rb^Gvs      , Rb^Gvs      , Rp          , Rp          , Ww          , Ww          , Ww          , Ww          , Gg          , Ww          , Ww^Bsb/     , Rp          , Gg          , Rb^Gvs      , Rp          , Ww^Bsb/     , Gs^Vh       , Gg          , Gg          , Gg          , Rb^Gvs      , Gg          
Rb^Gvs      , Rb^Gvs      , Rb^Gvs      , Gg          , Gg          , Gg^Es       , Gg          , Rp          , Rp          , Gg^Wm       , Gg          , Rb^Gvs      , Rb^Gvs      , Rb^Gvs      , Rb^Gvs      , Rb^Gvs      , Rp          , Gg          , Rb^Gvs      , Rb^Gvs      , Rb^Gvs      , Gg          , Rp          , Rp          , Rb^Gvs      , Rb^Gvs      , Ww^Bsb|     , Ww          , Rb^Gvs      , Rb^Gvs      , Rb^Gvs      , Gs^Vh       , Rp          , Rp          , Rb^Gvs      , Ww          , Ww          , Rp          , Gg^Es       , Ww          , Gg          , Gg^Es       , Rb^Gvs      , Rb^Gvs      , Rb^Gvs      , Gg          
Rb^Gvs      , Rb^Gvs      , Rb^Gvs      , Gg          , Gg          , Gg          , Gs^Vh       , Gg          , Gg          , Rp          , Gg          , Rb^Gvs      , Rb^Gvs      , Rb^Gvs      , Rb^Gvs      , Rb^Gvs      , Rb^Gvs      , Rp          , Gg          , Rb^Gvs      , Rb^Gvs      , Rb^Gvs      , Rp          , Gg          , Ww          , Ww          , Rp          , Gg^Es       , Rb^Gvs      , Rb^Gvs      , Rb^Gvs      , Gg          , Rp          , Rb^Gvs      , Rb^Gvs      , Rb^Gvs      , Rp          , Ww^Bsb|     , Ww          , Ww          , Gg          , Rb^Gvs      , Rb^Gvs      , Rb^Gvs      , Rb^Gvs      , Gg          
Gg          , Gg          , Gg          , Gg          , Rb^Gvs      , Rb^Gvs      , Rb^Gvs      , Gg          , Rp          , Rp          , Rp          , Gg          , Gg          , Gg          , Gg          , Rb^Gvs      , Rb^Gvs      , Rp          , Rp          , Gg          , Gg          , Gg          , Ww^Bsb|     , Ww          , Gg          , Rp          , Gg          , Rp          , Rb^Gvs      , Rb^Gvs      , Rb^Gvs      , Gg          , Rp          , Rb^Gvs      , Rb^Gvs      , Rb^Gvs      , Rb^Gvs      , Rp          , Gg          , Gg^Wm       , Gg^Es       , Gg          , Rb^Gvs      , Rb^Gvs      , Gg          , Gg          
Gg          , Gg          , Rb^Gvs      , Rb^Gvs      , Rb^Gvs      , Rb^Gvs      , Rb^Gvs      , Rp          , Gg          , Gg          , Gg          , Rp          , Rp          , Gg          , Gg          , Gg^Efm      , Gg          , Gg          , Gg          , Rp          , Ww          , Ww          , Rp          , Gg          , Gg          , Rp          , Gg^Efm      , Rp          , Rp          , Gg          , Gg          , Gg          , Rp          , Gs^Vh       , Rb^Gvs      , Rb^Gvs      , Rp          , Rp          , Rp          , Gg          , Gg          , Gg          , Gg          , Gg          , Gg          , Gg          
Gg          , Gg          , Gg^Efm      , Gg          , Rb^Gvs      , Rb^Gvs      , Rp          , Rp          , Gg          , Gs^Vh       , Rb^Gvs      , Gg          , Gg          , Rp          , Gg          , Gg          , Gg          , Gg          , Ww          , Ww^Bsb|     , Ch          , Ch          , Rr          , Ch          , Ch          , Rp          , Gg          , Gg          , Rp          , Gg          , Gg          , Gg^Es       , Rp          , Gg          , Gg          , Rp          , Gg          , Gg          , Rb^Gvs      , Rp          , Rp          , Gg          , Gg          , Rb^Gvs      , Gs^Vh       , Gg          
Gg          , Gg          , Rp          , Gg          , Rp          , Gg          , Rp          , Gg          , Rb^Gvs      , Rb^Gvs      , Rb^Gvs      , Rb^Gvs      , Rb^Gvs      , Rp          , Rp          , Gg          , Ww          , Ww          , Ch          , Rr          , Rr          , Rr          , Rr^Vhc      , Rr          , Rr          , Rr          , Ch          , Ch          , Rr          , Ch          , Ch          , Gg          , Rp          , Gg          , Gg^Es       , Rp          , Gg          , Rb^Gvs      , Rb^Gvs      , Gs^Vh       , Gg          , Rp          , Gg          , Rb^Gvs      , Rb^Gvs      , Rb^Gvs      
Gg          , Rp          , Gg          , Rp          , Gg^Es       , Rp          , Rp          , Gg          , Rb^Gvs      , Rb^Gvs      , Rb^Gvs      , Rb^Gvs      , Rb^Gvs      , Gg          , Ww          , Ww^Bsb\     , Rr          , Ch          , Rr          , Rr^Vhc      , Rr          , Rr          , Rr          , Rr^Vhc      , Rr          , Rr          , Rr          , Rr          , Rr          , Rr          , Rr          , Rr          , Ch          , Gg          , Gg          , Rp          , Gg          , Rb^Gvs      , Rb^Gvs      , Rb^Gvs      , Gg          , Rp          , Gg          , Rb^Gvs      , Rb^Gvs      , Rb^Gvs      
Rp          , Rp          , Rb^Gvs      , Gg          , Gg          , Gg          , Rp          , Rp          , Rp          , Rp          , Rp          , Gg          , Rp          , Gg          , Ww          , Ch          , Rr          , Rr          , Rr^Vhc      , Rr          , Ch          , Rr          , Rr          , Rr^Vhc      , Rr          , Ch          , Ch          , Ch          , Ch          , Rr          , Rr^Vhc      , Rr          , Rr          , Ch          , Rp          , Rp          , Gg          , Rb^Gvs      , Gg          , Gg          , Rp          , Rp          , Rp          , Gg          , Rb^Gvs      , Rb^Gvs      
Gg          , Rb^Gvs      , Rb^Gvs      , Gs^Vh       , Rp          , Rp          , Gg          , Gg          , Gg          , Gg          , Gg          , Rp          , Gg          , Ww^Bsb\     , Rp          , Ch          , Rr          , Rr          , Rr          , Rr          , Ch          , Ch          , Rr          , Rr          , Rr          , Ch          , Ch          , 1 Kh        , Ch          , Rr          , Rr          , Rr          , Rr          , Rr          , Ch          , Gg          , Gg          , Gg^Efm      , Rp          , Rp          , Rb^Gvs      , Gg          , Gs^Vh       , Rp          , Rp          , Rb^Gvs      
Rb^Gvs      , Rb^Gvs      , Rb^Gvs      , Rp          , Gg          , Gg          , Rb^Gvs      , Gs^Vh       , Rb^Gvs      , Rb^Gvs      , Rb^Gvs      , Rb^Gvs      , Gg          , Ww          , Ch          , Rr          , Rr          , Rr^Vhc      , Rr          , Rr          , Rr          , Rr          , Rr          , Rr^Vhc      , Rr^Vhc      , Rr          , Rr          , Ch          , Rr          , Rr          , Rr^Vhc      , Rr          , Rr^Vhc      , Rr          , Rr          , Ch          , Rp          , Rp          , Gg^Efm      , Rb^Gvs      , Rb^Gvs      , Rb^Gvs      , Rb^Gvs      , Gg          , Gg          , Rp          
Gg          , Rb^Gvs      , Rp          , Rp          , Gg          , Gg          , Rb^Gvs      , Rb^Gvs      , Rb^Gvs      , Rb^Gvs      , Rb^Gvs      , Rb^Gvs      , Gg          , Ww          , Ch          , Rr          , Rr          , Rr          , Rr          , Rr          , Rr          , Rr^Vhc      , Rr          , Rr          , Rr          , Rr          , Rr          , Rr          , Rr          , Rr          , Rr          , Rr          , Rr          , Rr          , Rr          , Rr          , Ch          , Gg          , Gg          , Gg          , Gg          , Rb^Gvs      , Rb^Gvs      , Rb^Gvs      , Rb^Gvs      , Rb^Gvs      
