border_size=1
usage=map

Gg^Vh, Gg, Re^Gvs, Gg, Re^Gvs, Gs, Re^Gvs, Gg, Re^Gvs, Gg, Re^Gvs, Gg, Gs, Gs, Gs, Gs, Gd, Gd, Gd, Gg, Gs, Rr, Rr, Rr, Rr^Vhc, Rr, Ch, Ch, Ch, Rr, Rr^Vhc, Rr, Rr, Rr, Rr, Rr, Gg, Gg, Gs, Gg^Vh
Re^Gvs, Re^Gvs, Re^Gvs, Re^Gvs, Re^Gvs, Re^Gvs, Gs^Gvs, Re^Gvs, Re^Gvs, Re^Gvs, Gs, Re^Gvs, Re^Gvs, Re^Gvs, Gg, Gs, Re^Gvs, Gd, Gg, Gg, Gs, Ch, Rr, Rp, Rr, Rp, Ch, 3 Kh, Ch, Rr, Rr^Vhc, Rr, Rr, Rr^Vhc, Rr, Gs, Gg, Gs^Es, Gg, Gs
Gs, Re^Gvs, Gg, Re^Gvs, Gs, Gs, Gs, Gg, Gg, Gg, Gs, Gs, Re^Gvs, Re^Gvs, Re^Gvs, Re^Gvs, Gs, Gs, Rr, Gg, Gg, Ch, Rr, Rr^Vhc, Rp, Rp, Rr, Ch, Rr, Rr, Rr, Rr, Rr, Rr^Vhc, Rr, Ch, Gg, Gg, Gs, Gg
Gg, Gg, Gs, Gg, Gg, Gg, Gs, Gg, Gg, Gg, Gg, Re^Gvs, Re^Vh, Re^Gvs, Gg, Gg, Rr, Rr, Re^Gvs, Rr, Rr, Rr, Rr, Rr, Rr, Rr, Rr, Rr, Rp, Rr, 1 Kh, Rp, Rr, Rr, Rr, Ch, Gg, Gs, Gg, Gg
Gg, Gg, Gs, Gg, Gs, Gd, Gs, Gs^Es, Gg, Gg, Gg, Re^Gvs, Re^Gvs, Re^Gvs, Rr, Rr, Re^Gvs, Re^Gvs, Re^Vh, Re^Gvs, Re^Gvs, Ch, Ch, Rr^Vhc, Rr, Rp, Rr^Es, Rr, Rp, Ch, Ch, Ch, Rp, Rr, Rr, Ch, Gg, Gs, Gg, Gg
Gg, Gg^Vh, Gg, Gg, Gs, Gs, Re^Gvs, Gs, Re^Gvs, Re^Gvs, Re^Gvs, Re^Gvs, Rr, Rr, Re^Gvs, Re^Gvs, Re^Gvs, Re^Gvs, Re^Gvs, Re^Gvs, Gg, Gg, Gg, Gg, Gg, Rr, Rp, Rr^Vhc, Rp, Rr, Rr, Ch, Rr, Rr^Vhc, Gg, Gg, Gd, Gd, Gg, Gg
Gs, Gs, Gg, Gg, Gg, Gs^Gvs, Re^Gvs, Re^Gvs, Re^Gvs, Re^Vh, Rr, Rr, Re^Gvs, Re^Gvs, Re^Gvs, Re^Gvs, Gg^Es, Gg, Gg, Gg, Gg, Gg, Gs^Es, Gg, Gg, Ch, Ch, Rr, Rr, Rr, Rr, Rr, Ch, Ch, Gg, Gg, Re^Gvs, Gg, Gg^Es, Gs
Gs, Gg, Gd^Es, Gg, Gs, Gg, Re^Gvs, Re^Gvs, Rr, Rr, Re^Gvs, Re^Gvs, Re^Gvs, Re^Gvs, Gg, Gg, Gs, Gs, Gs, Gg, Re^Gvs, Gg, Gg, Gs, Gs, Gg, Gg, Gg, Re, Rp, Gg, Gd, Gd, Gg, Re^Gvs, Re^Gvs, Re^Gvs, Re^Gvs, Gg, Gg
Gs, Gs, Gg, Gg, Gs, Gg, Re^Gvs, Rr, Re^Gvs, Re^Gvs, Re^Gvs, Re^Gvs, Re^Gvs, Re^Gvs, Gg, Gs, Gs, Gs, Re^Gvs, Re^Gvs, Re^Vh, Re^Gvs, Gg, Gd, Gs, Gg, Gg, Gg, Re, Gg, Re^Gvs, Gs, Re^Gvs, Re^Gvs, Gg^Vh, Gg, Re^Gvs, Gg, Gg^Vh, Gg
Gg, Gs, Gg, Gg, Re^Gvs, Re^Gvs, Re^Gvs, Rr, Re^Vh, Re^Gvs, Re^Gvs, Re^Gvs, Gg^Wm, Re^Gvs, Re^Gvs, Gs, Re^Gvs, Re^Gvs, Re^Gvs, Re^Gvs, Re^Gvs, Re^Gvs, Gg, Gd, Gg^Eff, Gg^Eff, Re^Gvs, Re^Gvs, Re, Re^Gvs, Re^Gvs, Re^Gvs, Re^Gvs, Re^Gvs, Re^Gvs, Re^Gvs, Re^Gvs, Gg, Gg, Gg
Gg, Gg, Re^Gvs, Re^Gvs, Re^Vh, Re^Gvs, Rr, Rr, Re^Gvs, Re^Gvs, Re^Gvs, Re^Gvs, Re^Gvs, Re^Gvs, Re^Gvs, Re^Gvs, Re^Gvs, Re^Gvs, Re^Gvs, Re^Gvs, Gg, Gs, Gs, Gs^Eff, Gg^Eff, Re^Gvs, Re^Gvs, Re, 2 Ke, Ce, Re^Gvs, Re^Gvs, Re^Gvs, Gg, Re^Gvs, Re^Gvs, Re^Gvs, Gg, Re^Gvs, Gg
Gg, Gs, Re^Gvs, Re^Gvs, Rr, Rr, Re^Gvs, Gg, Re^Gvs, Re^Gvs, Re^Gvs, Re^Gvs, Re^Gvs, Re^Gvs, Re^Gvs, Re^Gvs, Re^Gvs, Re^Gvs, Re^Gvs, Re^Gvs, Gs, Gs, Gg, Gs, Gs, Re^Gvs, Re^Gvs, Re, Ce, Ce, Re^Gvs, Re^Gvs, Re^Gvs, Gg, Gg, Re^Gvs, Gg, Re^Gvs, Re^Gvs, Gg
Rr, Gg, Rr, Rr, Re^Gvs, Re^Gvs, Re^Gvs, Gd, Re^Gvs, Re^Gvs, Gg, Gg, Gg^Eff, Gg, Gg^Eff, Gg, Re^Gvs, Re^Gvs, Gg, Gg, Gg, Gg, Re^Gvs, Gs, Gll^Fds, Gll, Re^Gvs, Re, Re, Ce, Re^Gvs, Re^Gvs, Re^Gvs, Gg^Es, Gd, Gg^Vh, Re^Gvs, Re^Gvs, Gs, Gg
Re^Gvs, Rr, Re^Gvs, Re^Vh, Re^Gvs, Re^Gvs, Gg, Re^Gvs, Gg^Eff, Re^Gvs, Gs^Eff, Gg^Eff, Gg, Gs^Eff, Gg, Gll, Gll^Fms, Gll, Gll, Gg^Es, Gg, Re^Gvs, Re^Wm, Re^Gvs, Re^Vh, Gll^Em, Re^Gvs, Re^Gvs, Re, Ce, Re^Gvs, Re^Gvs, Gs^Gvs, Gs, Gd, Gd, Gg, Gg, Gs, Gg
Re^Gvs, Gs, Gg, Re^Gvs, Gg, Gg, Gg, Gg^Eff, Gg, Gs^Eff, Gg, Gs, Gll, Gg, Gg^Em, Gll^Fds, Gll, Gll^Fds, Re^Gvs, Gs, Gg, Re^Gvs, Re^Gvs, Re^Gvs, Gll^Fds, Gll^Fds, Re, Re, Re^Gvs, Ce, Re^Gvs, Re^Gvs, Re^Gvs, Gg, Re^Gvs, Gg, Gg, Gg, Gg, Gs
Gll^Gvs, Gll, Gg, Gs, Gll, Gd, Gg^Es, Gg, Gll^Fds, Gll^Fms, Gll^Fms, Gg^Fms, Gll^Fds, Gll, Re^Gvs, Gll^Fds, Re^Gvs, Re^Gvs, Re^Vh, Re^Gvs, Re^Gvs, Gg^Eff, Gg^Eff, Gll, Re, Re, Gll^Fms, Re^Gvs, Re^Gvs, Re^Gvs, Re^Gvs, Re^Gvs, Re^Gvs, Re^Gvs, Re^Gvs, Re^Gvs, Gg, Gg^Vh, Gg, Gg
Gll, Gs, Gs^Fds, Gll^Fds, Gll, Gs, Gg, Gll, Gll, Gll^Fds, Re^Gvs, Re^Gvs, Re^Gvs, Re^Gvs, Gg, Gg, Gs, Re^Gvs, Re^Gvs, Re^Gvs, Gg^Eff, Gg^Eff, Gll, Re, Gd, Gll, Gll, Gg^Fds, Gll, Gs, Gs, Re^Gvs, Re^Gvs, Re^Gvs, Re^Gvs, Re^Gvs, Gs^Gvs, Gd, Gg^Es, Gg
Gs^Fds, Gll^Fds, Gs^Fms, Gll^Fds, Gll^Efm, Gs, Gs, Gg, Gd, Re^Gvs, Re^Gvs, Re^Gvs, Gg, Gg, Re^Gvs, Gg, Re^Gvs, Re^Gvs, Gg, Gg^Eff, Gg^Efm, Gg, Gll^Fds, Gll^Fms, Gs^Fds, Gg, Gll^Fds, Gll, Gg, Gs, Gd, Gs, Gg, Gg, Gg, Gg, Gs, Gd, Gg^Efm, Gg
Gll^Fds, Gll^Fms, Gll^Fms, Gll^Fds, Gll^Fds, Gg^Efm, Gs^Efm, Gd, Gd, Re^Gvs, Gd, Gg^Vh, Re^Gvs, Re^Gvs, Re^Gvs, Re^Gvs, Re^Gvs, Re^Gvs, Gg^Efm, Gg, Gg, Gd, Gll^Fds, Gll^Fms, Gg, Gg^Fds, Gg^Fds, Gg, Re^Gvs, Gg, Gg, Gs, Gs, Gg, Gll^Fds, Gll, Gll^Fds, Gg, Gll, Gg
Gll^Fds, Gll^Fms, Gll^Fet, Gs^Fds, Gll^Vh, Gll^Fds, Gll^Efm, Gs^Efm, Gg^Efm, Re^Gvs, Re^Gvs, Re^Gvs, Re^Gvs, Re^Gvs, Re^Gvs, Re^Gvs, Gg, Gg, Gll, Gll, Gg, Gg, Gs, Gg, Gg, Gg, Re^Gvs, Re^Vh, Re^Gvs, Re^Gvs, Gll^Efm, Gg, Gs, Gg, Gll, Gll^Fp, Gll^Fms, Gll^Fds, Gll, Gg
Gs^Fds, Gll^Fds, Gll^Fp, Gs^Fds, Gs^Fds, Gs^Fds, Gll^Efm, Gs^Efm, Gll^Efm, Gg^Efm, Gll, Re^Gvs, Gll^Fds, Gll^Fds, Gll^Fds, Gll^Fds, Gll^Efm, Gll^Fms, Gll^Fp, Gll^Fds, Gg^Efm, Gll^Efm, Gll^Fp, Gg, Re, Gs^Fds, Gll^Efm, Re^Gvs, Gg^Efm, Gll^Efm, Gll^Fds, Gs^Fds, Gll, Gll^Fds, Gll^Fds, Gs, Gg, Gll, Gg, Gg
Gs^Fds, Gs^Fds, Gs^Fp, Gs^Fp, Gs^Fds, Gll^Fds, Gll^Efm, Gll^Efm, Gll^Fms, Gll^Fds, Gll^Fds, Gll^Fds, Gll^Fds, Gll^Fp, Gd^Fds, Gll^Efm, Gll, Gll^Fms, Gll^Fds, Gs^Fds, Re^Vh, Gll^Fds, Gll^Fds, Re, Gll^Fds, Gs^Fds, Gs^Fms, Gll^Efm, Gll^Efm, Gll^Fds, Gll, Gll, Gd^Es, Gd, Gs^Fds, Gll^Fds, Gll^Fds, Gg, Gll^Efm, Gg
Gs^Fds, Gs^Fms, Gll^Fds, Gll^Fds, Gll^Fds, Gs^Fds, Gs^Fds, Gll^Efm, Gs^Fds, Gs^Fds, Gll^Fds, Gll^Fms, Gll^Fds, Gg^Fms, Gll^Efm, Gg^Em, Gs^Fms, Gll, Gg, Gg, Re^Gvs, Re^Gvs, Re^Gvs, Re, Gll, Gll^Fds, Gs^Fds, Gs^Fms, Gs^Fms, Gs^Fds, Gll^Em, Gs^Fds, Gs^Fds, Gs^Fp, Gll^Fds, Gll, Gs^Fds, Gll, Gg^Vh, Gg
Gs^Fds, Gll^Fds, Gll^Fms, Gll^Fds, Gll^Fms, Gll^Fms, Gll^Fds, Gll^Fms, Gs^Fds, Gs^Fds, Gll^Fds, Gll^Fms, Re^Fds, Gll^Efm, Gll^Fms, Gg^Fds, Gs^Fds, Gs^Em, Gg, Gg, Re^Gvs, Re^Gvs, Re^Gvs, Re, Re, Gll^Em, Gg, Gg^Fms, Gd, Gs^Fds, Gs^Fds, Gs^Fms, Gs^Fms, Gs^Fds, Gll^Fds, Gll^Es, Gs^Fds, Gs^Fds, Gs^Fds, Gg^Efm
Gll^Fds, Gll^Fds, Gll^Fds, Gll^Fds, Gs^Fds, Gs^Fms, Gs^Fms, Gs^Fms, Gll^Fds, Gs^Fet, Gll^Fms, Re^Fds, Re^Fds, Re^Fms, Gll^Fds, Gll^Fms, Gll^Fds, Gll, Gll^Fds, Re^Gvs, Re^Vh, Re^Gvs, Gd, Gg^Efm, Re, Ce, Ce, Ce, Ce, Gll, Gll^Fds, Gs^Fms, Gs^Fds, Gs^Fms, Gs, Gs, Gs^Fds, Gs^Fds, Gs^Fds, Gll^Efm
Gll^Fds, Gll^Fds, Gll^Vh, Gs^Fds, Gs^Fms, Gs^Fms, Gll^Fds, Gll^Fp, Hh^Fds, Gll^Fds, Gg^Fp, Gg^Fms, Gg^Fds, Gg^Fds, Gll^Em, Gll, Gll, Gll, Gs^Fds, Gll^Fds, Gll^Fds, Gll^Es, Gll^Em, Gd, Gg, Re, Ce, 4 Ke, Ce, Gll, Gll, Gll^Fds, Gll, Gs, Gd^Em, Gll, Gs^Fds, Gs^Fms, Gs^Fms, Gg^Efm
Gs^Fds, Gll^Fds, Gs^Fds, Gs^Fds, Gs^Fms, Gll^Fds, Hh^Fds, Hh^Fds, Hh^Fds, Hh^Fds, Gg^Fms, Gg^Fp, Gs^Fds, Gd^Fds, Gg^Fds, Gg^Fds, Gll^Fds, Gs^Fds, Gs^Fp, Gll^Fds, Gll^Fds, Gll^Fds, Gll, Re^Vct, Gg^Es, Re, Re, Ce, Gs, Gg^Em, Gll^Fds, Gll^Fds, Gll^Fds, Gll, Gll, Gs^Fds, Gs^Fds, Hh^Fms, Hh^Fds, Hh^Fds
Gll^Fds, Gll^Fms, Gs^Fds, Gs^Fms, Gs^Fp, Hh^Fds, Hh^Fds, Hh^Fds, Hh^Fds, Gg^Fds, Re^Fds, Gd^Fms, Gg^Fms, Gs^Fms, Gd^Fds, Gg^Fds, Gll^Fds, Gll^Fds, Gll^Fms, Gs^Fms, Gs^Fds, Gll, Gg, Gd, Gs, Gg, Gg, Re, Gg, Gll, Gll^Fds, Gs^Fp, Gll^Fds, Gll, Gll^Fds, Gs^Fds, Hh^Fds, Hh^Fp, Hh^Fp, Hh^Fds
Gs^Fds, Gll^Fds, Gll^Fds, Gll^Fds, Gll^Fds, Gll^Fds, Gll^Fds, Hh^Fds, Gg^Fds, Hh^Fds, Re^Gvs, Gg^Fds, Gg, Gg^Fms, Gg, Gg^Fds, Gg^Efm, Gll^Fds, Gll^Fds, Gs^Fds, Gs^Fds, Gll^Fds, Gg, Gs, Gg, Gs, Gg, Re, Gg, Gll, Gg^Efm, Gll^Fds, Gg, Gll^Fds, Gs^Fds, Gll^Fds, Hh^Fds, Hh^Fds, Hh^Fds, Hh^Efm
