border_size=1
usage=map

Aa^Fda      , Aa^Fda      , Aa^Fda      , Aa^Fda      , Gd^Fdw      , Gd^Fdw      , Gd^Fdw      , Gd^Fdw      , Gd          , Gd          , Gd          , Gd          , Gd          , Gd          , Gd          , Gd          , Gd          , Gd^Fdw      , Gd^Fdw      , Gd^Fdw      , Gd          , Gd          , Gd          , Gd          , Gd          , Gd          , Gd          , Gd          , Gd          , Gs          , Gs          , Gs          , Gs^Ftp      , Gs^Ftp      , Gs^Ftp      , Gs^Ftp      , Gs^Ftp      , Gs^Ftp      , Gs^Ftp      , Gd^Fzr      , Gd^Fzr      , Gd^Fzr      
Aa^Fda      , Aa^Fda      , Aa^Fda      , Aa^Fda      , Gd^Fdw      , Gd^Fdw      , Aa^Fda      , Gd          , Gd          , Gd          , Gd          , Gd          , Gd          , Gd          , Aa          , Gd          , Gd          , Gd          , Gd          , Gd          , Gd          , Gd          , Gd          , Gd          , Gd^Fdw      , Gd          , Gd^Ftp      , Gd          , Gd          , Gs          , Gs          , Gs          , Gs          , Gs          , Gs          , Gs^Ftp      , Gs^Ftp      , Gs^Ftp      , Gs^Ftp      , Gd^Fzr      , Gd^Fzr      , Gd^Fzr      
Aa^Fda      , Aa^Fda      , Gd^Fdw      , Gd^Fdw      , Gd^Fdw      , Aa^Fda      , Aa^Fda      , Aa          , Aa          , Gd          , Gd          , Gd          , Gd^Fdw      , Gd^Fdw      , Aa^Fda      , Aa          , Aa          , Gd          , Gd          , Gd          , Gd^Vht      , Gd          , Gd          , Gd^Fdw      , Gd^Fdw      , Gd^Fdw      , Gd^Ftp      , Gd^Ftp      , Gd          , Gd          , Gd          , Gs          , Gs          , Gs          , Gs          , Gs          , Gs          , Gs^Ftp      , Gs          , Gs^Ftp      , Gs^Ftp      , Gd^Fzr      
Aa^Fda      , Aa^Fda      , Gd^Fdw      , Gd^Fdw      , Aa^Fda      , Aa^Fda      , Aa^Fda      , Aa          , Gd          , Gd          , Gd          , Gd          , Aa          , Aa^Fda      , Aa^Fda      , Aa          , Aa          , Gd          , Chr         , Chr         , Gd          , Gd          , Gd          , Gd^Fdw      , Gd^Fdw      , Gd^Ftp      , Gd^Ftp      , Gd          , Gd          , Gd          , Gd          , Gd          , Gs          , Gs          , Gs          , Gd          , Gs          , Gs          , Gs          , Gs^Ftp      , Gs^Ftp      , Gs^Ftp      
Gd^Fdw      , Aa^Fda      , Gd          , Gd          , Gd          , Aa          , Aa          , Aa          , Gd          , Gd          , Gd          , Gd          , Gd^Fdw      , Gd^Fdw      , Aa          , Aa          , Gd          , Chr         , 3 Khr       , Chr         , Chr         , Gd          , Gd          , Gd^Fdw      , Gd^Ftp      , Gd^Ftp      , Gd^Ftp      , Gd          , Gd          , Gd          , Gs          , Gs          , Gs          , Gs          , Gs^Ftp      , Gs^Ftp      , Gd          , Gs          , Gs          , Gs^Ftp      , Gs^Ftp      , Gs^Ftp      
Gd^Fdw      , Gd^Fdw      , Gd          , Gd          , Gd          , Gd          , Gd          , Gd          , Gd          , Gd          , Gd          , Gd          , Gd          , Gd          , Gd          , Aa          , Gd          , Chr         , Chr         , Chr         , Chr         , Gd          , Gd          , Gd^Ftp      , Gd          , Gd^Ftp      , Gd          , Gd          , Gd          , Gd          , Gd          , Gs          , Gs          , Gs^Ftp      , Gs^Ftp      , Gs^Ftp      , Gs^Ftp      , Gs^Ftp      , Gs          , Gs          , Gs          , Gs^Ftp      
Gd          , Gd^Fdw      , Gd          , Gd          , Aa^Fda      , Aa          , Gd          , Gd          , Gd          , Gd          , Gd^Vht      , Gd          , Gd          , Gd          , Gd          , Gd          , Gd          , Gd          , Gd          , Chr         , Gd          , Gd          , Gd          , Gd          , Gd          , Gd          , Gd          , Gd          , Gd          , Gd          , Gd          , Gd          , Gs          , Gs          , Gs^Ftp      , Gs          , Gs          , Gd          , Gs          , Gs          , Gs^Ftp      , Gs^Ftp      
Aa          , Gd          , Gd          , Gd^Fdw      , Aa^Fda      , Aa          , Gd          , Gd          , Gd          , Gd          , Gd          , Gd          , Gd^Fdw      , Gd          , Gd          , Gd          , Gd          , Gd          , Gd          , Gd          , Gd          , Gd          , Gd          , Gd          , Gd          , Gd          , Gd^Ftp      , Gd^Ftp      , Gd          , Gd^Vht      , Gd          , Gd          , Gs          , Gs          , Gs          , Gs          , Gs          , Gs^Vht      , Gs          , Gs          , Gd^Fzr      , Gs^Ftp      
Aa          , Aa          , Gd          , Gd^Fdw      , Gd          , Aa          , Gd          , Gd          , Gd          , Gd          , Gd          , Gd          , Gd^Fdw      , Gd^Fdw      , Gd^Fdw      , Gd          , Gd          , Gd          , Gd          , Gd          , Gd^Fdw      , Gd          , Gd^Ftp      , Gd          , Gd          , Gd          , Gd          , Gd^Ftp      , Gd          , Gd          , Gd          , Gs          , Gs          , Gs          , Gs          , Gs          , Gs          , Gs          , Gs          , Gs^Ftp      , Gs^Ftp      , Gd^Fzr      
Aa          , Aa          , Gd          , Gd          , Gd          , Gd          , Gd          , Gd          , Gd          , Gd          , Gd          , Gd          , Gd^Fdw      , Gd^Fdw      , Gd^Fdw      , Gd          , Gd          , Gd          , Gd          , Gd          , Gd^Fdw      , Gd^Ftp      , Gd^Ftp      , Gd^Ftp      , Gd          , Gd          , Gd          , Gd          , Gd          , Gd          , Gd          , Gs          , Gs          , Gs^Ftp      , Gs^Ftp      , Gd          , Gs          , Gs          , Gs          , Gs          , Gs^Ftp      , Gs^Ftp      
Aa^Fda      , Aa          , Gd          , Gd          , Gd          , Gd          , Gd          , Gd          , Gd          , Gd          , Gd          , Gd          , Gd          , Gd^Fdw      , Gd          , Gd          , Gd          , Gd          , Gd^Vht      , Gd          , Gd          , Gd^Ftp      , Gd^Ftp      , Gd          , Gd          , Gd          , Gd          , Gd          , Gd          , Gd          , Gd          , Gs          , Gs^Ftp      , Gd^Fzr      , Gs^Ftp      , Gs          , Gs          , Gd          , Gs          , Gs          , Gs          , Gs^Ftp      
Aa^Fda      , Aa^Fda      , Gd^Fdw      , Gd          , Gd          , Gd^Vht      , Gd          , Gd          , Gd          , Gd          , Gd          , Gd          , Gd          , Gd          , Gd          , Gd          , Gd          , Gd          , Gd          , Gd          , Gd          , Gd          , Gd          , Gd          , Gd          , Gd          , Gd          , Gd          , Gd^Ftp      , Gd          , Gd          , Gs          , Gs^Ftp      , Gs^Ftp      , Gs^Ftp      , Gs          , Gs          , Gs          , Gd          , Gs          , Gs          , Gs^Ftp      
Aa^Fda      , Aa^Fda      , Gd^Fdw      , Gd          , Gd          , Gd          , Gd          , Gd          , Gd          , Gd          , Gd          , Gd          , Gd          , Gd          , Gd          , Gd          , Gd          , Gd          , Gd          , Gd          , Gd          , Gd          , Gd^Fdw      , Gd          , Gd          , Gd          , Gd          , Gd^Ftp      , Gd^Ftp      , Gd          , Gd          , Gs          , Gd          , Gs^Ftp      , Gs          , Gs          , Gs          , Gs          , Gs          , Gs          , Gs^Ftp      , Gs^Ftp      
Aa^Fda      , Gd^Fdw      , Gd          , Gd          , Gd          , Gd          , Gd          , Gd          , Gd^Fdw      , Gd^Fdw      , Gd          , Gd          , Gd          , Gd          , Gd          , Gd          , Gd          , Gd          , Gd          , Gd          , Gd^Fdw      , Gd^Fdw      , Gd^Fdw      , Gd^Fdw      , Gd^Ftp      , Gd          , Gd          , Gd          , Gd          , Gd^Ftp      , Gd          , Gd          , Gd          , Gs          , Gs^Vht      , Gs          , Gs          , Gs          , Gs          , Gs          , Gd^Fzr      , Gd^Fzr      
Gd^Fdw      , Gd          , Gd          , Gd          , Gd          , Gd          , Gd          , Gd          , Gd^Fdw      , Gd^Fdw      , Gd          , Gd          , Gd          , Gd          , Gd          , Gd          , Gd          , Gd          , Gd          , Gd          , Gd          , Gd^Fdw      , Gd^Ftp      , Gd^Ftp      , Gd          , Gd^Ftp      , Gd          , Gd          , Gd          , Gd^Ftp      , Gd          , Gd          , Gd          , Gd          , Gs          , Gs          , Gs          , Gs          , Gs^Ftp      , Gs^Ftp      , Gd^Fzr      , Gd^Fzr      
Aa          , Gd          , Gd          , Gd          , Gd          , Gd          , Gd          , Gd          , Gd          , Gd          , Gd          , Gd          , Gd          , Gd          , Gd          , Gd          , Gd          , Gd          , Gd          , Gd          , Gd          , Gd          , Gd          , Gd          , Gd          , Gd          , Gd          , Gd          , Gd^Vht      , Gd          , Gd          , Gd          , Gs          , Gs          , Gd          , Gs          , Gs          , Gd          , Gs^Ftp      , Gs^Ftp      , Gs^Ftp      , Gs^Ftp      
Aa          , Gd          , Gd          , Gd          , Gd          , Gd          , Gd          , Gd          , Gd          , Gd          , Gd          , Gd          , Gd          , Gd          , Gd          , Gd          , Gd          , Gd          , Gd          , Gd          , Gd          , Gd          , Gd          , Gd          , Gd          , Gd          , Gd          , Gd          , Gd          , Gd          , Gs          , Gs          , Gs          , Gs          , Gs^Ftp      , Gs          , Gs          , Gs          , Gs          , Gs          , Gs^Ftp      , Gs^Ftp      
Aa^Fda      , Gd          , Aa^Fda      , Aa^Fda      , Gd          , Gd          , Gd          , Gd          , Gd^Vht      , Gd          , Gd          , Gd          , Gd          , Gd          , Gd          , Gd          , Gd^Vht      , Gd          , Gd          , Gd          , Gd          , Gd          , Gd          , Gd          , Gd          , Gd          , Gd          , Gd          , Gd          , Gd          , Gs          , Gs          , Gs^Ftp      , Gs^Ftp      , Gs^Ftp      , Gs          , Gs          , Gs          , Gs          , Gd          , Gs^Ftp      , Gs^Ftp      
Aa^Fda      , Aa^Fda      , Aa^Fda      , Gd^Fdw      , Gd          , Gd          , Gd          , Gd          , Gd          , Gd          , Gd          , Gd          , Gd          , Gd          , Gd          , Gd          , Gd          , Gd          , Gd^Fdw      , Gd          , Gd          , Gd          , Gd          , Gd          , Gd          , Gd^Ftp      , Gd^Ftp      , Gd          , Gd          , Gd          , Gd          , Gs          , Gs^Ftp      , Gs^Ftp      , Gs          , Gs          , Gs          , Gs          , Gs          , Gs^Ftp      , Gd^Fzr      , Gd^Fzr      
Gd          , Aa^Fda      , Gd^Fdw      , Gd^Fdw      , Gd^Fdw      , Gd          , Gd          , Gd          , Gd          , Gd          , Gd          , Gd          , Gd          , Gd          , Gd          , Gd          , Gd          , Gd          , Gd          , Gd^Fdw      , Gd^Ftp      , Gd          , Gd          , Gd          , Gd^Ftp      , Gd^Ftp      , Gd^Ftp      , Gd^Ftp      , Gd          , Gd          , Gd          , Gs          , Gs          , Gs          , Gs          , Gs          , Gs          , Gs^Vht      , Gs          , Gs^Ftp      , Gs^Ftp      , Gd^Fzr      
Gd          , Aa^Fda      , Gd          , Gd^Fdw      , Gd          , Gd          , Gd          , Gd          , Gd          , Gd          , Gd          , Gd^Fdw      , Gd^Fdw      , Gd^Fdw      , Gd^Fdw      , Gd          , Gd          , Gd          , Gd          , Gd^Fdw      , Gd^Ftp      , Gd          , Gd          , Gd          , Gd          , Gd^Ftp      , Gd          , Gd^Ftp      , Gd          , Gd          , Gd          , Gs          , Gs          , Gs          , Gs          , Gs          , Gd          , Gs          , Gs          , Gs^Ftp      , Gs^Ftp      , Gs^Ftp      
Gd          , Gd          , Gd          , Gd          , Gd          , Gd          , Gd          , Gd          , Gd          , Gd          , Gd          , Gd          , Gd          , Gd          , Gd          , Gd          , Gd          , Gd          , Gd          , Gd^Fdw      , Gd^Ftp      , Gd^Ftp      , Gd          , Gd          , Gd          , Gd          , Gd          , Gd          , Gd          , Gd          , Gd          , Gs          , Gd          , Gs          , Gs          , Gs          , Gs^Ftp      , Gs          , Gs          , Gs          , Gs          , Gs^Ftp      
Gd          , Gd          , Gd          , Gd          , Gd          , Gd          , Gd          , Gd          , Gd          , Gd          , Gd          , Gd          , Gd          , Gd          , Gd          , Gd          , Gd          , Gd          , Gd^Fdw      , Gd^Fdw      , Gd^Ftp      , Gd^Ftp      , Gd          , Gd          , Gd          , Gd          , Gd          , Gd          , Gs          , Gs          , Gs^Ftp      , Gs          , Gs^Ftp      , Gs          , Gs          , Gs^Ftp      , Gd^Fzr      , Gs          , Gs          , Gs          , Gs          , Gs^Ftp      
Gd          , Gd          , Gd          , Gd          , Gd          , Gd          , Gd          , Gd^Vht      , Gd          , Gd          , Gd          , Gd          , Chr         , Chr         , Chr         , Chr         , Chr         , Gd          , Gd          , Gd^Ftp      , Gd^Ftp      , Gd^Ftp      , Gd          , Gd          , Gd          , Gd          , Gd          , Gs          , Gs          , Gs^Ftp      , Gd^Fzr      , Gd^Fzr      , Gs^Ftp      , Gs          , Gs^Ftp      , Gd^Fzr      , Gd^Fzr      , Gs^Ftp      , Gs          , Gs          , Gs^Ftp      , Gs^Ftp      
Gd          , Gd          , Gd          , Gd          , Gd          , Gd          , Gd          , Gd          , Gd          , Gd          , Gd          , Gd          , Gd          , Chr         , Chr         , 2 Khr       , Chr         , Gd          , Gd          , Gd          , Gd          , Gd^Ftp      , Gd          , Gd          , Gd          , Gd^Vht      , Gd          , Gd          , Gs          , Gs^Ftp      , Gs^Ftp      , Gs^Ftp      , Gs          , Gs          , Gs          , Gs^Ftp      , Gs^Ftp      , Gs^Ftp      , Gs          , Gs          , Gs^Ftp      , Gs^Ftp      
Gd          , Gd          , Gd          , Gd          , Gd^Fdw      , Gd          , Gd          , Gd          , Gd          , Gd          , Gd          , Gd^Fdw      , Gd          , Gd          , Chr         , Chr         , Chr         , Gd          , Gd          , Gd          , Gd          , Gd          , Gd          , Gd          , Gd          , Gd          , Gd          , Gd          , Gs          , Gs^Ftp      , Gs          , Gs          , Gs          , Gs          , Gs          , Gs          , Gd          , Gs          , Gs          , Gs          , Gs^Ftp      , Gd^Fzr      
Gd          , Gd          , Gd          , Gd^Fdw      , Gd          , Gd^Fdw      , Gd          , Gd          , Gd          , Gd          , Gd          , Gd^Fdw      , Gd^Fdw      , Gd          , Gd          , Chr         , Gd          , Gd          , Gd          , Gd          , Gd          , Gd          , Gd          , Gd          , Gd          , Gd          , Gd          , Gd          , Gd          , Gs          , Gs          , Gs          , Gs          , Gs          , Gs          , Gs          , Gs          , Gs          , Gs^Ftp      , Gs^Ftp      , Gd^Fzr      , Gd^Fzr      
Gd          , Gd          , Gd          , Gd          , Gd          , Gd          , Gd          , Gd          , Gd          , Gd          , Gd          , Gd          , Gd^Fdw      , Gd^Fdw      , Gd          , Gd          , Gd          , Gd          , Gd          , Gd          , Gd          , Gd          , Gd          , Gd          , Gd          , Gd          , Gd          , Gd          , Gd          , Gd          , Gd          , Gd          , Gd          , Gd          , Gd          , Gs          , Gs          , Gd          , Gs          , Gs^Ftp      , Gs^Ftp      , Gd^Fzr      
Gd          , Gd          , Gd          , Gd          , Gd          , Gd          , Gd          , Gd          , Gd          , Gd          , Gd          , Gd          , Gd          , Gd^Fdw      , Gd          , Gd          , Gd          , Gd          , Gd          , Gd          , Gd          , Gd          , Gd          , Gd          , Gd          , Gd          , Gd          , Gd          , Gd          , Gd          , Gd          , Gd          , Gd          , Gd          , Gd          , Gd          , Gd          , Gs          , Gs          , Gs          , Gs^Ftp      , Gs^Ftp      
Gd          , Gd          , Gd          , Gd          , Gd          , Gd          , Gd^Vht      , Gd          , Gd          , Gd          , Gd          , Gd          , Gd          , Gd          , Gd          , Gd          , Gd          , Gd          , Gd          , Gd          , Gd          , Gd          , Gd          , Gd          , Gd          , Gd          , Gd          , Gd          , Gd          , Gd          , Ds          , Gd          , Gd          , Gd          , Gd          , Gd          , Ds          , Gd          , Gs          , Gs          , Gs          , Gs^Ftp      
Gd          , Gd          , Gd          , Gd          , Gd          , Gd          , Gd          , Gd          , Gd          , Gd          , Gd          , Gd          , Gd          , Gd          , Gd          , Gd          , Gd          , Gd          , Gd          , Gd          , Gd          , Gd          , Gd          , Gd          , Gd          , Gd          , Gd          , Gd          , Gd          , Ds          , Ds          , Ds          , Ds          , Ds          , Ds          , Ds          , Ds          , Ds          , Ds          , Gs          , Gs          , Gs^Ftp      
Gd^Fdw      , Gd          , Gd^Fdw      , Gd          , Gd          , Gd          , Gd          , Gd          , Gd          , Gd          , Gd          , Gd          , Gd          , Gd          , Gd          , Gd          , Ds          , Ds          , Ds          , Gd          , Gd          , Gd          , Gd          , Gd          , Gd          , Gd          , Gd          , Gd          , Ds          , Ds          , Ds          , Ds          , Ds          , Ds          , Ds          , Ds          , Ds          , Ds          , Ds          , Ds          , Gs          , Gs          
Gd^Fdw      , Gd^Fdw      , Gd          , Gd          , Gd          , Gd          , Gd          , Gd          , Gd          , Gd          , Ds          , Gd          , Ds          , Ds          , Ds          , Ds          , Ds          , Ds          , Ds          , Ds          , Gd          , Gd          , Ds          , Ds          , Ds          , Gd          , Ds          , Ds          , Ds          , Ds          , Ds          , Ds          , Ds          , Ds          , Ds          , Dd^Vdt      , Ds          , Ds          , Ds          , Ds          , Gs          , Gs          
Gd^Fdw      , Gd^Fdw      , Gd          , Gd          , Gd          , Gd          , Gd          , Gd          , Gd          , Gd          , Ds          , Ds          , Ds          , Ds          , Ds          , Ds          , Ds          , Ds          , Ds          , Ds          , Ds          , Ds          , Ds          , Ds          , Ds          , Ds          , Ds          , Ds          , Ds          , 1 Ds        , Ds          , Ds          , Ds          , Ds          , Ds          , Ds          , Ds          , Ds          , Ds          , Ds          , Ds          , Gs          
Gd^Fdw      , Gd^Fdw      , Gd          , Gd          , Gd          , Gd          , Gd          , Gd          , Gd          , Gd          , Ds          , Ds          , Ds          , Ds          , Ds          , Ds          , Ds          , Ds          , Ds          , Ds          , Ds          , Ds          , Ds          , Ds          , Ds          , Ds          , Ds          , Ds          , Ds          , Ds          , Ds          , Ds          , Ds          , Ds          , Ds          , Ds          , Ds          , Ds          , Ds          , Ds          , Ds          , Ds          
