border_size=1
usage=map

Xos         , Xos         , Xos         , Xos         , Xos         , Xos         , Xos         , Xos         , Xos         , Xos         , Xos         , Xos         , Xos         , Xos         , Xos         , Xos         , Xos         , Xos         , Xos         , Xos         , Xos         , Xos         , Xos         
Xos         , Rr^Ii       , Rr^Ii       , Rr^Ii       , Rr^Ii       , Rr^Ii       , Rr^Ii       , Rr^Ii       , Rr^Ii       , Xos         , Rr^Ii       , Rr^Ii       , Rr^Ii       , Xos         , Rr^Ii       , Xos         , Xos         , Rr          , Rr          , Rr          , Rr          , Rr          , Xos         
Xos         , Rr^Ii       , Rr^Ii       , Rr^Ii       , Rr^Ii       , Rr^Ii       , Xos         , Xos         , Rr^Ii       , Rr^Ii       , Rr^Ii       , Rr^Ii       , Rr^Ii       , Rr^Ii       , Rr^Ii       , Rr^Ii       , Xos         , Xos         , Xos         , Rr          , Rr          , Rr          , Xos         
Xos         , Rr^Ii       , Rr^Ii       , Rr^Ii       , Xos         , Rr^Ii       , Rr^Ii       , Xos         , Xos         , Rr^Ii       , Rr^Ii       , Rr^Ii       , Rr^Ii       , Rr^Ii       , Xos         , Xos         , Rr^Ii       , Rr^Ii       , Rr^Ii       , Xos         , Rr          , Rr          , Xos         
Xos         , Rr^Ii       , Xos         , Xos         , Xos         , Rr          , Rr          , Rr          , Rr          , Xos         , Xos         , Rr^Ii       , Rr^Ii       , Xos         , Rr^Ii       , Rr^Ii       , Rr^Ii       , Rr^Ii       , Rr^Ii       , Rr^Ii       , Rr          , Xos         , Xos         
Xos         , Xos         , Rr          , Rr          , Xos         , Rr          , Rr          , Rr          , Rr          , Rr          , Xos         , Xos         , Rr^Ii       , Rr^Ii       , Rr^Ii       , Rr^Ii       , Rr^Ii       , Rr^Ii       , Rr^Ii       , Rr^Ii       , Rr          , Xos         , Xos         
Xos         , Rr          , 2 Rr        , Rr          , Rr          , Xos         , Xos         , Rr          , Rr^Ii       , Rr^Ii       , Rr^Ii       , Xos         , Xos         , Rr^Ii       , Rr^Ii       , Rr^Ii       , Rr^Ii       , Rr^Ii       , Xos         , Xos         , Rr          , Rr          , Xos         
Xos         , Rr          , Rr          , Rr          , Rr          , Rr          , Xos         , Xos         , Rr^Ii       , Rr^Ii       , Rr^Ii       , Rr^Ii       , Xos         , Xos         , Rr^Ii       , Xos         , Xos         , Xos         , Rr          , Rr          , Rr          , Rr          , Xos         
Xos         , Rr          , Rr          , Rr          , Xos         , Rr^Ii       , Rr^Ii       , Rr^Ii       , Rr^Ii       , Xos         , Xos         , Xos         , Rr^Ii       , Rr^Ii       , Rr^Ii       , Rr^Ii       , Rr^Ii       , Xos         , Xos         , Rr          , Rr          , Rr          , Xos         
Xos         , Rr          , Xos         , Xos         , Xos         , Rr^Ii       , Xos         , Rr^Ii       , Xos         , Rr^Ii       , Xos         , Rr^Ii       , Rr^Ii       , Rr^Ii       , Rr^Ii       , Rr^Ii       , Rr^Ii       , Rr^Ii       , Xos         , Xos         , Rr          , Rr          , Xos         
Xos         , Xos         , Xu          , Xu          , Xu          , Xos         , Xu          , Xos         , Xu          , Xos         , Xu          , Xos         , Xos         , Xos         , Rr          , Xos         , Xos         , Xos         , Xos         , Xos         , Xos         , Xos         , Xos         
Xu          , Xu          , Gg          , Xu          , Gg          , Xu          , Gg          , Xu          , Gg          , Xu          , Rr          , Xu          , Rr          , Rr          , Kh          , Rr          , Rr          , _s          , _s          , _s          , _s          , _s          , Xu          
Gg          , Gg          , Gg          , Gg          , Gg          , Gg          , Gg          , Gg          , Ch          , Rr          , Rr          , Rp^Vhc      , Rr          , Ch          , Kh          , Ch          , Rr          , Rp^Vhc      , Rr          , Rr          , Rr          , Rr          , Rr          
Gg          , Gg          , Re^Gvs      , Re^Gvs      , Gg          , Gg          , Gg          , Gg          , Ch          , Rr          , Rp^Vhc      , Rr          , Rr          , Ch          , Ch          , Ch          , Rr          , Rp^Vhc      , Rr          , Rr          , Rr          , Rr          , Ch          
Re^Gvs      , Re^Gvs      , Gg          , Gg          , Rr          , Rr          , Rr          , Gg          , Rr          , Rr          , Rr          , Rr          , Rr          , Rr          , Rr          , Rr          , Rr          , Rr          , Rr          , Rr          , Rr          , Rr          , Ch          
Re^Gvs      , Gg          , Rr          , Rr          , Re^Gvs      , Re^Gvs      , Re^Gvs      , Rr          , Ch          , Rr          , Rp^Vhc      , Rr          , Rr          , Rr          , Rr          , Rr          , Ch          , 1 Kh        , Ch          , Rr          , Rr          , Rr          , Ch          
Rr          , Rr          , Re^Gvs      , Re^Gvs      , Re^Gvs      , Gg^Vh       , Re^Gvs      , Re^Gvs      , Gg          , Ch          , Rr          , Rr          , Rr          , Rr          , Rp^Vhc      , Rr          , Rr          , Ch          , Ch          , Rr          , Rp^Vhc      , Rr          , Gg          
Re^Gvs      , Re^Gvs      , Re^Gvs      , Re^Gvs      , Re^Gvs      , Re^Gvs      , Gg          , Gg          , Gg          , Gg          , Gg          , Rr          , Ch          , Rr          , Rr          , Rr          , Rr          , Rr          , Rr          , Rr          , Ch          , Gg          , Gg          
