border_size=1
usage=map

Xos         , Xos         , Xos         , Xos         , Xos         , Xos         , Xos         , Xos         , Xos         , Xos         , Xos         , Xos         , Xos         , Xos         , Xos         , Xos         , Xos         , Xos         , Xuc         , Xuc         , Xuc         , Xuc         , Xuc         , Xuc         , Xuc         , Xuc         , Xuc         , Xuc         , Xuc         , Xuc         , Xuc         , Xuc         , Xuc         , Xuc         , Xuc         , Xuc         , Xuc         , Xuc         , Xuc         , Xuc         , Xuc         , Xuc         , Xuc         , Xuc         , Xuc         , Xuc         
Xos         , Xos         , Xos         , Xos         , Xos         , Xos         , Urb         , Xos         , Urb         , Xos         , Xos         , Xos         , Xos         , Xos         , Xos         , Xos         , Xos         , Xos         , Xuc         , Xuc         , Xuc         , Xuc         , Uu          , Xuc         , Xuc         , Xuc         , Xuc         , Xuc         , Ur          , Ur          , Ur          , Uu          , Uu^Vu       , Xuc         , Urb         , Xuc         , Xuc         , Xuc         , Uu          , Xuc         , Uu^Vu       , Urb         , Uu          , Xuc         , Xuc         , Xuc         
Xos         , Xos         , Xos         , Xos         , Urb         , Urb         , Urb         , Urb         , Urb         , Urb         , Urb         , Urb         , Urb         , Xos         , Urb         , Xos         , Xos         , Xos         , Xuc         , Xuc         , Xuc         , Uu          , Urb         , Uu^Vu       , Uu          , Xuc         , Urb         , Xuc         , Ur          , Urb         , Xuc         , Urb         , Xuc         , Uu          , Ur          , Ur          , Ur          , Ur          , Uu          , Uu          , Ur          , Ur          , Ur          , Ur          , Ur          , Ur          
Xos         , Xos         , Xos         , Urb         , Urb         , Urb         , Urb         , Urb         , Urb         , Urb         , Urb         , Urb         , Urb         , Urb         , Urb         , Xos         , Urb         , Urb         , Urb         , Xuc         , Urb         , Uu          , Xuc         , Xuc         , Xuc         , Ur          , Uu          , Uu          , Uu          , Xuc         , Uu          , Uu          , Uu          , Ur          , Uu          , Uu          , Ur          , Uu          , Xuc         , Uu          , Uu          , Urb         , Xuc         , Ur          , Urb         , Ur          
Xos         , Xos         , Xos         , Urb         , Urb         , Urb         , Urb         , Urb         , Urb         , Urb         , Urb         , Urb         , Urb         , Urb         , Urb         , Urb         , Urb         , Urb         , Urb         , Urb         , Urb         , Urb         , Ur          , Xuc         , Ur          , Urb         , Uu          , Uu          , Ur          , Urb         , Xuc         , Urb         , Xuc         , Ur          , Xuc         , Xuc         , Uu^Vu       , Ur          , Ur          , Urb         , Urb         , Uu          , Ur          , Uu          , Uu          , Urb         
Xos         , Xos         , Urb         , Urb         , Urb         , Urb         , Urb         , Urb         , Urb         , Urb         , Urb         , Urb         , Urb         , Urb         , Urb         , Urb         , Urb         , Urb         , Urb         , Urb         , Urb         , Urb         , Urb         , Ur          , Ur          , Ur          , Xuc         , Uu          , Xuc         , Xuc         , Xuc         , Xuc         , Xuc         , Xuc         , Xuc         , Xuc         , Xuc         , Ur          , Xuc         , Ur          , Xuc         , Ur          , Urb         , Ur          , Ur          , Urb         
Xos         , Xos         , Urb         , Urb         , Urb         , Urb         , Urb         , Urb         , Urb         , Urb         , Urb         , Urb         , Urb         , Urb         , Xol         , Xos         , Xol         , Xos         , Xos         , Urb         , Urb         , Urb         , Urb         , Urb         , Xuc         , Xuc         , Xuc         , Xuc         , Xuc         , Xuc         , Xuc         , Xuc         , Xuc         , Xuc         , Xuc         , Xuc         , Xuc         , Xuc         , Xuc         , Xuc         , Xuc         , Xuc         , Xuc         , Uu^Vu       , Xuc         , Xuc         
Xos         , Xos         , Urb         , Urb         , Urb         , Urb         , Urb         , Urb         , Urb         , Urb         , Urb         , Urb         , Urb         , Urb         , Urb         , Xol         , Urb         , Xol         , Xol         , Xol         , Urb         , Xos         , Xos         , Xuc         , Xuc         , Xuc         , Xuc         , Xuc         , Xuc         , Xuc         , Xuc         , Xuc         , Xuc         , Xuc         , Xos         , Xos         , Xos         , Xuc         , Xuc         , Xuc         , Xuc         , Xuc         , Xuc         , Xuc         , Xuc         , Xuc         
Xos         , Xos         , Urb         , Urb         , Urb         , Urb         , Xos         , Xos         , Urb         , Urb         , Xol         , Xol         , Urb         , Urb         , Urb         , Urb         , Urb         , Urb         , Urb         , Urb         , Urb         , Xol         , Xol         , Xuc         , Xuc         , Xuc         , Xuc         , Xuc         , Xuc         , Xuc         , Xos         , Xuc         , Xos         , Xos         , Xos         , Xos         , Xos         , Xos         , Xuc         , Xuc         , Xuc         , Xuc         , Xuc         , Xuc         , Xuc         , Xuc         
Xos         , Xos         , Urb         , Urb         , Xos         , Xos         , Xos         , Xos         , Xos         , Xol         , Urb         , Urb         , Urb         , Urb         , Urb         , Urb         , Urb         , Urb         , Urb         , Urb         , Urb         , Urb         , Urb         , Xos         , Xuc         , Xuc         , Xos         , Xos         , Xos         , Xos         , Xos         , Xos         , Urb         , Xuc         , Xuc         , Xuc         , Xuc         , Xuc         , Ur          , Xuc         , Xuc         , Xuc         , Xuc         , Xuc         , Xuc         , Xuc         
Xos         , Xos         , Urb         , Xos         , Urb         , Urb         , Urb         , Urb         , Xos         , Xol         , Urb         , Urb         , Urb         , 3 Urb       , Urb         , Qxua        , Qxua        , Urb         , Urb         , Urb         , Urb         , Urb         , Urb         , Xos         , Xos         , Xos         , Urb         , Urb         , Urb         , Urb         , Urb         , Urb         , Urb         , Uu          , Uu          , Uu^Vu       , Uu          , Ur          , Ur          , Ur          , Uu          , Xuc         , Ur          , Xuc         , Xuc         , Xuc         
Xos         , Xos         , Urb         , Urb         , Urb         , Urb         , Urb         , Urb         , Urb         , Xol         , Urb         , Urb         , Urb         , Urb         , Urb         , Qxua        , Qxua        , Qxua        , Urb         , Urb         , Urb         , Urb         , Urb         , Xos         , Urb         , Urb         , Urb         , Urb         , Urb         , Urb         , Urb         , Urb         , Ur          , Uu          , Ur          , Uu          , Ur          , Ur          , Uu          , Uu          , Xuc         , Ur          , Xuc         , Xuc         , Xuc         , Xuc         
Xos         , Urb         , Urb         , Urb         , Urb         , Urb         , Urb         , Urb         , Urb         , Urb         , Urb         , Urb         , Urb         , Urb         , Urb         , Urb         , Urb         , Urb         , Urb         , Urb         , Urb         , Urb         , Urb         , Urb         , Urb         , Urb         , Urb         , Urb         , Cud         , Cud         , Cud         , Uu          , Uu          , Ur          , Uu          , Uu          , Uu          , Ur          , Xuc         , Xuc         , Xuc         , Xuc         , Uu          , Ur          , Xuc         , Xuc         
Xos         , Xos         , Urb         , Urb         , Urb         , Urb         , Urb         , Urb         , Urb         , Xol         , Xol         , Urb         , Urb         , Urb         , Urb         , Urb         , Urb         , Urb         , Xol         , Xol         , Xos         , Urb         , Urb         , Urb         , Urb         , Urb         , Urb         , Cud         , Cud         , 2 Kud       , Cud         , Urb         , Ur          , Uu          , Urb         , Uu          , Uu          , Uu          , Ur          , Urb         , Ur          , Xuc         , Uu          , Uu          , Ur          , Xuc         
Xos         , Xos         , Urb         , Urb         , Urb         , Urb         , Urb         , Urb         , Urb         , Xos         , Xos         , Xol         , Xol         , Xol         , Xol         , Urb         , Xos         , Xol         , Xos         , Xos         , Xos         , Urb         , Urb         , Urb         , Urb         , Urb         , Urb         , Uu          , Uu          , Cud         , Uu          , Ur          , Uu          , Xuc         , Xuc         , Xuc         , Xuc         , Urb         , Uu          , Ur          , Uu          , Uu          , Ur          , Uu          , Urb         , Xuc         
Xos         , Urb         , Urb         , Urb         , Urb         , Urb         , Urb         , Urb         , Urb         , Urb         , Xos         , Xos         , Xos         , Xos         , Urb         , Urb         , Urb         , Urb         , Urb         , Xos         , Xos         , Urb         , Urb         , Urb         , Urb         , Urb         , Uu          , Uu          , Uu          , Urb         , Ur          , Uu          , Uu          , Xuc         , Ur          , Uu^Vu       , Uu          , Ur          , Urb         , Xuc         , Xuc         , Xuc         , Urb         , Uu          , Xuc         , Xuc         
Xos         , Xos         , Urb         , Urb         , Urb         , Urb         , Urb         , Urb         , Urb         , Urb         , Urb         , Xos         , Xos         , Urb         , Urb         , Urb         , Urb         , Urb         , Urb         , Xos         , Xos         , Urb         , Urb         , Urb         , Uu          , Ur          , Uu          , Uu          , Uu          , Ur          , Urb         , Ur          , Ur          , Ur          , Ur          , Ur          , Xuc         , Ur          , Urb         , Xuc         , Urb         , Ur          , Ur          , Uu          , Xuc         , Xuc         
Xos         , Xos         , Xos         , Urb         , Urb         , Urb         , Urb         , Urb         , Urb         , Urb         , Urb         , Xos         , Xos         , Urb         , Urb         , Urb         , Urb         , Urb         , Urb         , Xos         , Xos         , Xuc         , Uu^Vu       , Urb         , Ur          , Ur          , Urb         , Uu          , Ur          , Ur          , Uu          , Ur          , Xuc         , Uu          , Ur          , Urb         , Xuc         , Ur          , Xuc         , Urb         , Uu          , Uu          , Uu          , Uu          , Xuc         , Xuc         
Xos         , Xos         , Xos         , Urb         , Urb         , Urb         , Urb         , Urb         , Urb         , Urb         , Xos         , Xos         , Urb         , Urb         , Urb         , Urb         , Urb         , Urb         , Urb         , Xos         , Xos         , Xuc         , Ur          , Ur          , Xuc         , Uu          , Ur          , Ur          , Xuc         , Ur          , Xuc         , Uu          , Ur          , Xuc         , Xuc         , Uu          , Xuc         , Ur          , Xuc         , Xuc         , Xuc         , Xuc         , Xuc         , Xuc         , Xuc         , Xuc         
Xos         , Xos         , Xos         , Urb         , Urb         , Urb         , Urb         , Urb         , Urb         , Urb         , Xos         , Urb         , Urb         , Urb         , Urb         , Urb         , Urb         , Urb         , Urb         , Xos         , Xos         , Xuc         , Xuc         , Xuc         , Urb         , Uu          , Uu          , Uu          , Xuc         , Xuc         , Xuc         , Ur          , Ur          , Uu          , Xuc         , Ur          , Urb         , Ur          , Urb         , Xuc         , Xuc         , Xuc         , Xuc         , Xuc         , Xuc         , Xuc         
Xos         , Xos         , Xos         , Xos         , Urb         , Urb         , Urb         , Urb         , Urb         , Urb         , Xos         , Xos         , Urb         , Urb         , Urb         , Urb         , Urb         , Urb         , Urb         , Urb         , Xos         , Xuc         , Uu          , Xuc         , Ur          , Ur          , Xuc         , Urb         , Xuc         , Xuc         , Xuc         , Xuc         , Xuc         , Urb         , Uu          , Xuc         , Xuc         , Uu          , Ur          , Ur          , Xuc         , Xuc         , Xuc         , Xuc         , Xuc         , Xuc         
Xos         , Xos         , Xos         , Xos         , Urb         , Urb         , Urb         , Urb         , Urb         , Urb         , Xos         , Urb         , Urb         , Urb         , Urb         , Urb         , Urb         , Urb         , Urb         , Urb         , Xos         , Xuc         , Xuc         , Ur          , Ur          , Ur          , Xuc         , Xuc         , Xuc         , Xuc         , Xuc         , Xuc         , Xuc         , Xuc         , Ur          , Uu          , Uu          , Urb         , Ur          , Urb         , Xuc         , Xuc         , Xuc         , Xuc         , Xuc         , Xuc         
Xos         , Xos         , Urb         , Xos         , Urb         , Urb         , Urb         , Urb         , Urb         , Urb         , Urb         , Xos         , Xos         , Urb         , Urb         , Urb         , Urb         , Urb         , Urb         , Urb         , Urb         , Xos         , Xuc         , Xuc         , Uu          , Xuc         , Xuc         , Xuc         , Xuc         , Uu          , Uu          , Xuc         , Xuc         , Uu^Vu       , Ur          , Ur          , Ur          , Ur          , Xuc         , Xuc         , Xuc         , Xuc         , Xuc         , Xuc         , Xuc         , Xuc         
Xos         , Xos         , Urb         , Urb         , Urb         , Urb         , Urb         , Urb         , Urb         , Urb         , Xos         , Xos         , Xos         , Xos         , Urb         , Urb         , Urb         , Urb         , Urb         , Urb         , Urb         , Xos         , Xos         , Xuc         , Uu          , Uu          , Uu          , Xuc         , Xuc         , Uu^Vu       , Uu          , Ur          , Uu          , Ur          , Ur          , Ur          , Xuc         , Xuc         , Xuc         , Xuc         , Xuc         , Xuc         , Xuc         , Xuc         , Xuc         , Xuc         
Xos         , Xos         , Xos         , Urb         , Urb         , Urb         , Urb         , Urb         , Xos         , Xos         , Xos         , Xos         , Xos         , Urb         , Urb         , Urb         , Urb         , Urb         , Urb         , Urb         , Urb         , Urb         , Urb         , Uu          , Xuc         , Xuc         , Uu          , Xuc         , Urb         , Uu          , Xuc         , Urb         , Uu          , Xuc         , Uu          , Uu          , Urb         , Xuc         , Xuc         , Xuc         , Xuc         , Xuc         , Xuc         , Xuc         , Xuc         , Xuc         
Xos         , Xos         , Xos         , Urb         , Urb         , Urb         , Urb         , Urb         , Urb         , Xos         , Urb         , Xos         , Urb         , Urb         , Urb         , Urb         , Urb         , Urb         , Urb         , Urb         , Urb         , Urb         , Xos         , Xuc         , Xuc         , Xuc         , Uu          , Uu          , Uu          , Xuc         , Xuc         , Ur          , Uu          , Uu          , Urb         , Uu          , Uu          , Xuc         , Xuc         , Xuc         , Xuc         , Xuc         , Xuc         , Xuc         , Xuc         , Xuc         
Xos         , Xos         , Urb         , Urb         , Urb         , Urb         , Urb         , Urb         , Urb         , Urb         , Urb         , Urb         , Urb         , Urb         , Urb         , Urb         , Urb         , Urb         , Urb         , Urb         , Xos         , Xos         , Xos         , Xos         , Xuc         , Xuc         , Xuc         , Uu          , Uu          , Xuc         , Urb         , Uu          , Ur          , Uu          , Xuc         , Xuc         , Ur          , Uu^Vu       , Xuc         , Xuc         , Xuc         , Xuc         , Xuc         , Xuc         , Xuc         , Xuc         
Xos         , Xos         , Urb         , Urb         , Urb         , Urb         , Urb         , Urb         , Urb         , Urb         , Urb         , Urb         , Urb         , Urb         , Urb         , Urb         , Urb         , Urb         , Urb         , Urb         , Xos         , Xos         , Xos         , Xos         , Xuc         , Xuc         , Xuc         , Xuc         , Xuc         , Uu          , Uu          , Ur          , Uu          , Ur          , Urb         , Ur          , Urb         , Urb         , Urb         , Cud         , Kud         , Xuc         , Xuc         , Xuc         , Xuc         , Xuc         
Xos         , Xos         , Xos         , Urb         , Urb         , Urb         , Urb         , Urb         , Xos         , Urb         , Urb         , Urb         , Urb         , Urb         , Urb         , Urb         , Urb         , Urb         , Urb         , Urb         , Xos         , Xos         , Xos         , Xos         , Xos         , Xuc         , Xuc         , Xuc         , Xuc         , Xuc         , Xuc         , Uu          , Uu          , Xuc         , Xuc         , Ur          , Urb         , Xuc         , Urb         , Cud         , Cud         , Xuc         , Xuc         , Xuc         , Xuc         , Xuc         
Xos         , Xos         , Xos         , Urb         , Urb         , Urb         , Urb         , Urb         , Urb         , Urb         , Urb         , Urb         , Urb         , Urb         , Urb         , Xos         , Urb         , Urb         , Urb         , Urb         , Urb         , Xos         , Xos         , Xos         , Xos         , Xuc         , Xuc         , Xuc         , Xuc         , Xuc         , Xuc         , Xuc         , Uu          , Uu          , Uu          , Uu          , Ur          , Xuc         , Xuc         , Urb         , Urb         , Xuc         , Xuc         , Xuc         , Xuc         , Xuc         
Xos         , Xos         , Xos         , Urb         , Urb         , Urb         , Urb         , Urb         , Urb         , Urb         , Urb         , Urb         , Urb         , Urb         , Urb         , Urb         , Urb         , Urb         , Urb         , Urb         , Urb         , Xos         , Xos         , Xos         , Xos         , Xos         , Xuc         , Xuc         , Xuc         , Xuc         , Xuc         , Xuc         , Xuc         , Uu          , Ur          , Uu          , Uu          , Urb         , Urb         , Urb         , Urb         , Xuc         , Xuc         , Xuc         , Xuc         , Xuc         
Xos         , Xos         , Xos         , Xos         , Urb         , Urb         , Urb         , Urb         , Urb         , Urb         , Urb         , Urb         , Urb         , Urb         , Urb         , Urb         , Urb         , Urb         , Urb         , Urb         , Xos         , Xos         , Xos         , Xos         , Xos         , Xos         , Xuc         , Xuc         , Xuc         , Xuc         , Xuc         , Xuc         , Xuc         , Uu^Vu       , Uu          , Urb         , Xuc         , Xuc         , Urb         , Uu          , Ur          , Xuc         , Xuc         , Xuc         , Xuc         , Xuc         
Xos         , Xos         , Xos         , Xos         , Xos         , Urb         , Urb         , Urb         , Urb         , Urb         , Urb         , Urb         , Urb         , Urb         , Urb         , Urb         , Xos         , Xos         , Xos         , Xos         , Xos         , Xos         , Xos         , Xos         , Xos         , Xos         , Xuc         , Xuc         , Xuc         , Xuc         , Xuc         , Xuc         , Xuc         , Urb         , 1 Uu        , Urb         , Xuc         , Xuc         , Xuc         , Urb         , Ur          , Uu^Vu       , Xuc         , Xuc         , Xuc         , Xuc         
Xos         , Xos         , Xos         , Xos         , Xos         , Xos         , Xos         , Urb         , Xos         , Urb         , Urb         , Urb         , Urb         , Urb         , Xos         , Xos         , Xos         , Xos         , Xos         , Xos         , Xos         , Xos         , Xos         , Xos         , Xos         , Xos         , Xuc         , Xuc         , Xuc         , Xuc         , Xuc         , Xuc         , Ur          , Ur          , Ur          , Ur          , Uu          , Xuc         , Xuc         , Xuc         , Uu          , Urb         , Xuc         , Xuc         , Xuc         , Xuc         
Xos         , Xos         , Xos         , Xos         , Xos         , Xos         , Xos         , Xos         , Xos         , Xos         , Xos         , Xos         , Xos         , Xos         , Xos         , Xos         , Xos         , Xos         , Xos         , Xos         , Xos         , Xos         , Xos         , Xos         , Xos         , Xos         , Xuc         , Xuc         , Xuc         , Xuc         , Xuc         , Xuc         , Urb         , Ur          , Xuc         , Xuc         , Urb         , Uu          , Uu          , Uu          , Urb         , Uu          , Xuc         , Xuc         , Xuc         , Xuc         
