border_size=1
usage=map

Wo          , Wo          , Ww          , Ww          , Ww          , Ww          , Ds          , Ds          , Gg          , Gg          , Gs          , Gs          , Gs          , Gs          , Gs          , Gg          , Gg          , Gg          , Gg          , Gg          , Gg          , Gg          , Gg          , Gg          , Gg          , Gg          , Gg          , Gg          , Gg          , Gg          , Gg          , Hh          , Hh          , Hh          , Hh          , Md          , Md          , Md          , Md          , Md          , Md          , Md          , Md          , Md          , Md          , Md          
Wo          , Wo          , Ww          , Ww          , Ww          , Ds          , Ds          , Ds          , Gg          , Gg          , Gs          , Gs          , Gs          , Gg          , Gs          , Gs          , Gs          , Gs          , Gg          , Gs          , Gs          , Gs          , Gs          , Gs          , Gg          , Gg          , Gg          , Gs          , Gs          , Gs          , Gg          , Gg          , Gg          , Hh          , Hh          , Hh          , Hh          , Md          , Hh          , Md          , Ch          , Md          , Md          , Md          , Md          , Md          
Wo          , Wo          , Ww          , Ww          , Ww          , Ds          , Ds          , Ds          , Gs          , Gs          , Gg          , Gg          , Gs          , Gs^Vht      , Gs          , Gg          , Gs          , Gs          , Gs          , Gs          , Gg          , Gs          , Gs          , Gs          , Gs          , Gg          , Gs          , Gs          , Gs          , Gs          , Gg          , Gg          , Gg          , Gg          , Gg          , Hh          , Gg          , Hh          , Hh          , Ch          , 1 Kh        , Ch          , Ch          , Md          , Md          , Md          
Wo          , Wo          , Ww          , Ww          , Ww          , Ds          , Ds          , Gg          , Gs          , Gg          , Gs          , Gs          , Gg          , Gs          , Gs          , Gs          , Rr          , Rr          , Rr          , Gs          , Gs          , Gg          , Gg          , Gs          , Gs          , Gg          , Gs          , Gs          , Gs          , Gs          , Gs          , Gs          , Gs          , Gg          , Gg          , Gg          , Gg          , Gg          , Gg          , Ch          , Ch          , Ch          , Hh          , Hh          , Hh          , Md          
Wo          , Wo          , Ww          , Ww          , Ww          , Ds          , Ds          , Gg          , Gg          , Gs          , Gg          , Gg          , Rr          , Gg          , Rr          , Rr          , Gg          , Gg          , Gg          , Rr          , Rr          , Gs          , Gs          , Gs          , Gg          , Gs          , Gs          , Gs          , Rr          , Gs          , Gs          , Gs^Vht      , Gs          , Gs          , Gs          , Gg          , Gs          , Gg          , Gg          , Gg          , Gg          , Hh          , Gg          , Hh          , Rr          , Md          
Wo          , Wo          , Ww          , Ww          , Ww          , Ds          , Ds          , Gg          , Gg          , Gg          , Rr          , Rr          , Gg          , Rr          , Gg          , Gs          , Gs          , Gg          , Gs          , Ch          , Ch          , Rr          , Rr          , Gs          , Gs          , Gs          , Rr          , Rr          , Gs          , Rr          , Rr          , Gs          , Rr          , Rr          , Rr          , Gs          , Gs          , Gg          , Rr          , Rr          , Rr          , Gg          , Rr          , Rr          , Hh          , Rr          
Wo          , Wo          , Ww          , Ww          , Ww          , Ds          , Ds          , Gg          , Rr          , Rr          , Gg          , Gg          , Gs          , Gg          , Gg          , Gs          , Gs          , Gs          , Gs          , Ch          , Chr         , 2 Kh        , Ch          , Rr          , Rr          , Rr          , Gs          , Gg          , Gs          , Gs          , Gs          , Rr          , Gs          , Gs          , Gg          , Rr          , Rr          , Rr          , Gs          , Gs^Vht      , Gs          , Rr          , Gs          , Hh          , Hh          , Hh          
Wo          , Ww          , Ww          , Ww          , Ww          , Ds          , Rd          , Rr          , Gg          , Gg          , Gg          , Gg          , Gg          , Gs          , Gg          , Gs^Vht      , Gg          , Gs          , Gs          , Gg          , Ch          , Ch          , Rr          , Rr          , Gs          , Gs          , Gg          , Gs          , Gs          , Gs          , Gs          , Gs          , Gg          , Gg          , Gg          , Gg          , Gg          , Gs          , Gs          , Gs          , Gs          , Gg          , Hh          , Hh          , Hh          , Md          
Ww          , Ww          , Ww          , Ww          , Ww^Bw/      , Rd          , Ds          , Gg          , Gg          , Gs          , Gs          , Gg          , Gs          , Gg          , Gs          , Gs          , Gs          , Gg          , Gs          , Gg          , Gg          , Ch          , Rr          , Gs          , Gg          , Gg          , Gg          , Gs          , Gs          , Gs          , Gs          , Gg          , Gg          , Gg          , Gs          , Gs          , Gs          , Gs          , Gs          , Gg          , Gg          , Gg          , Hh          , Hh          , Md          , Md          
Ww          , Ww          , Ww          , Ww^Bw/      , Ww          , Ds          , Ds          , Gg          , Gg          , Gs          , Gg          , Gs          , Gs          , Gg          , Gs          , Gs          , Gg          , Gg          , Gg          , Gs          , Gs          , Ch          , Gg          , Gs          , Gg          , Gg          , Gg          , Gs^Vht      , Gs          , Gs          , Gs          , Gs          , Gs          , Gs          , Gs          , Gs          , Gg          , Gs          , Gs          , Gs          , Gg          , Gg          , Hh          , Hh          , Md          , Md          
Wo          , Ww          , Ww          , Ww          , Ww          , Ds          , Ds          , Gg          , Gg          , Gg          , Gg          , Gg          , Gs          , Gs          , Gs          , Gs          , Gg          , Gg          , Gg          , Gs          , Gs          , Gg          , Gg          , Gg          , Gg          , Gs          , Gs          , Gs          , Gs          , Gs          , Gs          , Gs          , Gs          , Gs          , Gs          , Gg          , Gs          , Gs          , Gs          , Gs          , Gg          , Gg          , Hh          , Hh          , Md          , Md          
Wo          , Wo          , Wo          , Ww          , Ww          , Ds          , Ds          , Gg          , Gg          , Gg          , Gg          , Gg          , Gg          , Gs          , Gs          , Gg          , Gg          , Gg          , Gg          , Gg          , Gs          , Gs          , Gg          , Gg          , Gg          , Gg          , Gg          , Gg          , Gg          , Gg          , Gg          , Gs          , Gs          , Gs^Vht      , Gs          , Gs          , Gs          , Gs          , Gg          , Gg          , Gg          , Gg          , Hh          , Hh          , Md          , Md          
Wo          , Wo          , Wo          , Ww          , Ww          , Ds          , Ds          , Gg          , Gg          , Gg          , Gg          , Gg          , Gs          , Gg          , Gs          , Gg          , Gs          , Gg          , Gg          , Gs          , Gs          , Gs          , Gg          , Gg          , Gg          , Gs          , Gs          , Gg          , Gg          , Gg          , Gg          , Gg          , Gg          , Gg          , Gg          , Gs          , Gg          , Gg          , Gg          , Gg          , Gg          , Gg          , Hh          , Md          , Md          , Md          
Wo          , Wo          , Wo          , Ww          , Ww          , Ww          , Ds          , Ds          , Gg          , Gg          , Gs          , Gg          , Gg          , Gs          , Gg          , Gs          , Gs          , Gs          , Gg          , Gs          , Gs          , Gs          , Gg          , Gg          , Gg          , Gg          , Gg          , Gs          , Gs          , Gg          , Gg          , Gg          , Gg          , Gg          , Gg          , Gg          , Gg          , Gg          , Gg          , Gg          , Hh          , Hh          , Hh          , Md          , Md          , Md          
Wo          , Wo          , Wo          , Ww          , Ww          , Ww          , Ds          , Ds          , Gg          , Gs          , Gg          , Gg          , Gg          , Gs          , Gs          , Gs          , Gs          , Gs          , Gs          , Gs          , Gs          , Gg          , Gg          , Gg          , Gg          , Gg          , Gg          , Gg          , Gg          , Gg          , Gg          , Gg          , Gg          , Gg          , Gg          , Gg          , Gg          , Gg          , Gg          , Gg          , Hh          , Hh          , Md          , Md          , Md          , Md          
Wo          , Wo          , Wo          , Ww          , Ww          , Ww          , Ds          , Ds          , Gg          , Gs          , Gs          , Gg          , Gg          , Gs          , Gs          , Gg          , Gs          , Gs          , Gs          , Gs          , Gs          , Gg          , Gg          , Gs          , Gg          , Gg          , Gg          , Gg          , Gg          , Gg          , Gg          , Gg          , Gg          , Gg          , Gg          , Gg          , Hh          , Gg          , Hh          , Hh          , Hh          , Md          , Md          , Md          , Md          , Md          
Wo          , Wo          , Wo          , Ww          , Ww          , Ww          , Ds          , Ds          , Gg          , Gg          , Gg          , Gg          , Gs          , Gs          , Gs          , Gs          , Gs          , Gs          , Gg          , Gs^Vht      , Gs          , Gs          , Gs          , Gg          , Gg          , Gg          , Gg          , Gg          , Gg          , Gg          , Gg          , Gg          , Hh          , Hh          , Hh          , Hh          , Hh          , Hh          , Hh          , Hh          , Md          , Md          , Md          , Md          , Md          , Md          
Wo          , Wo          , Wo          , Wo          , Ww          , Ww          , Ds          , Gg          , Gg          , Gg          , Gg          , Gg          , Gs          , Gs          , Gs          , Gg          , Gg          , Gs          , Gs          , Gs          , Gs          , Gs          , Gs          , Gs          , Gg          , Gg          , Gg          , Gg          , Hh          , Hh          , Hh          , Gg          , Hh          , Hh          , Hh          , Hh          , Hh          , Hh          , Md          , Md          , Md          , Md          , Md          , Md          , Md          , Md          
Wo          , Wo          , Wo          , Wo          , Ww          , Ww          , Ds          , Gg          , Gg          , Gg          , Gg          , Gg          , Gg          , Gs          , Gs          , Gs          , Gs          , Gg          , Gg          , Gg          , Gg          , Gg          , Gg          , Gg          , Gg          , Gg          , Gg          , Gg          , Hh          , Hh          , Hh          , Hh          , Md          , Md          , Md          , Hh          , Md          , Md          , Md          , Md          , Md          , Md          , Md          , Md          , Md          , Md          
Wo          , Wo          , Wo          , Wo          , Ww          , Ww          , Ww          , Ds          , Gg          , Gg          , Gg          , Gg          , Gs          , Gs          , Gs          , Gs          , Gs          , Gs          , Gs          , Gs          , Gg          , Gg          , Gg          , Gg          , Gg          , Gg          , Hh          , Hh          , Hh          , Md          , Md          , Md          , Md          , Md          , Md          , Md          , Md          , Md          , Md          , Md          , Md          , Md          , Md          , Md          , Md          , Md          
Wo          , Wo          , Wo          , Wo          , Ww          , Ww          , Ww          , Ds          , Ds          , Gg          , Gg          , Gg          , Gg          , Gs          , Gs          , Gg          , Gg          , Gg          , Gg          , Gg          , Gg          , Gg          , Gg          , Gg          , Hh          , Hh          , Hh          , Hh          , Md          , Md          , Md          , Md          , Md          , Md          , Md          , Md          , Md          , Md          , Md          , Md          , Md          , Md          , Md          , Md          , Md          , Md          
