border_size=1
usage=map

Xu          , Xu          , Xu          , Xu          , Xu          , Xu          , Xu          , Xu          , Xu          , Xu          , Xu          , Xu          , Xu          , Xu          , Xu          , Xu          , Xu          , Xu          , Xu          , Xu          , Xu          , Xu          , Xu          , Xu          , Xu          , Xu          , Xu          , Xu          , Xu          , Xu          , Xu          , Xu          , Xu          , Xu          , Xu          , Xu          , Xu          , Xu          , Xu          , Xu          , Xu          , Xu          , Uu          , Uu          , Ur          , Ur          
Xu          , Xu          , Xu          , Xu          , Xu          , Xu          , Xu          , Xu          , Xu          , Xu          , Xu          , Xu          , Xu          , Xu          , Xu          , Xu          , Xu          , Xu          , Xu          , Xu          , Xu          , Xu          , Xu          , Xu          , Xu          , Xu          , Xu          , Xu          , Xu          , Xu          , Xu          , Xu          , Xu          , Xu          , Xu          , Xu          , Xu          , Xu          , Xu          , Xu          , Uu          , Uu          , Ur          , Ur          , Uu          , Uu          
Xu          , Xu          , Xu          , Xu          , Xu          , Xu          , Xu          , Xu          , Xu          , Xu          , Xu          , Xu          , Xu          , Xu          , Uu^Uf       , Uu^Uf       , Uu^Uf       , Uh          , Xu          , Uh          , Uh          , Uh          , Uu          , Xu          , Xu          , Xu          , Xu          , Xu          , Xu          , Xu          , Xu          , Xu          , Xu          , Xu          , Xu          , Xu          , Xu          , Xu          , Uu          , Uu^Vu       , Ur          , Ur          , Uu          , Uu          , Xu          , Xu          
Xu          , Xu          , Xu          , Xu          , Xu          , Xu          , Uu^Uf       , Xu          , Uh          , Uu^Uf       , Cud         , Uu^Uf       , Xu          , Xu          , Uh          , Uu^Uf       , Uu^Uf       , Uh          , Uu          , Uu          , Ur          , Uu^Vu       , Ur          , Uu          , Uu          , Uh          , Uu^Uf       , Uh          , Uh          , Xu          , Xu          , Xu          , Xu          , Xu          , Xu          , Xu          , Ww          , Uu          , Ur          , Ur          , Uu          , Cud         , Cud         , Xu          , Xu          , Xu          
Xu          , Xu          , Xu          , Uh          , Uu^Uf       , Uu^Vu       , Uh          , Uh          , Uh          , Uh          , Xu          , 3 Kud       , Cud         , Uh          , Ur          , Uu          , Ur          , Ur          , Ur          , Ur          , Ww          , Ur          , Ww          , Ur          , Ur          , Uu^Uf       , Uu          , Uu^Uf       , Uu^Uf       , Uu^Uf       , Xu          , Xu          , Xu          , Xu          , Xu          , Ww          , Ww          , Uu          , Ur          , 1 Kud       , Cud         , Cud         , Cud         , Xu          , Xu          , Xu          
Xu          , Xu          , Uh          , Uh          , Uu          , Uu          , Uu          , Ur          , Uu          , Uu          , Xu          , Cud         , Cud         , Ur          , Uu          , Ur          , Ur          , Uu          , Xu          , Xu          , Xu          , Ww          , Xu          , Ww          , Ww          , Ur          , Ur          , Uu          , Uu          , Uu          , Uu          , Xu          , Xu          , Ww          , Ww          , Ww          , Ww          , Ur          , Uu          , Uu          , Cud         , Cud         , Xu          , Xu          , Xu          , Xu          
Xu          , Xu          , Xu          , Uu^Uf       , Uu          , Uu          , Ur          , Ur          , Uu          , Xu          , Xu          , Xu          , Uu^Uf       , Uu          , Uh          , Uu^Vu       , Ur          , Uu          , Ww          , Xu          , Xu          , Xu          , Xu          , Xu          , Xu          , Xu          , Xu          , Ur          , Ur          , Ur          , Ur          , Uu^Vu       , Uu          , Uu          , Uu          , Uu          , Ur          , Ur          , Uu          , Uu          , Uh          , Cud         , Xu          , Xu          , Xu          , Xu          
Xu          , Xu          , Xu          , Ww          , Ur          , Ur          , Uu^Uf       , Uu          , Uu^Uf       , Xu          , Xu          , Xu          , Xu          , Uu^Uf       , Uh          , Uu          , Ur          , Ww          , Ww          , Xu          , Uh          , Uh          , Xu          , Xu          , Xu          , Xu          , Xu          , Uu^Uf       , Uu^Uf       , Uu^Uf       , Uh          , Ur          , Ur          , Ur          , Ur          , Ur          , Uu^Uf       , Uu^Uf       , Uu^Uf       , Uh          , Xu          , Xu          , Xu          , Xu          , Xu          , Xu          
Xu          , Xu          , Uh          , Ww          , Ur          , Uu^Uf       , Uh          , Uu^Uf       , Uh          , Uu^Uf       , Xu          , Xu          , Xu          , Xu          , Xu          , Uh          , Ur          , Uu^Uf       , Uu^Uf       , Uu^Uf       , Uu^Uf       , Uh          , Xu          , Xu          , Xu          , Xu          , Uu^Uf       , Uu^Uf       , Uh          , Uh          , Uh          , Ur          , Uu          , Uu          , Uu          , Ur          , Uu^Uf       , Uu^Uf       , Xu          , Xu          , Xu          , Xu          , Xu          , Xu          , Xu          , Xu          
Xu          , Xu          , Uh          , Uh          , Uu          , Ur          , Uh          , Uh          , Xu          , Xu          , Xu          , Xu          , Xu          , Xu          , Ww          , Ww          , Ur          , Uu^Uf       , Uu^Uf       , Uu^Uf       , Uu^Uf       , Uh          , Xu          , Xu          , Xu          , Uu^Uf       , Uu^Uf       , Uu^Uf       , Ur          , Uh          , Ur          , Ur          , Uu          , Uu          , Uu          , Ur          , Uu          , Uu^Uf       , Uh          , Xu          , Xu          , Xu          , Xu          , Xu          , Xu          , Xu          
Xu          , Xu          , Xu          , Uh          , Uu          , Ur          , Uu^Vu       , Uh          , Xu          , Xu          , Xu          , Xu          , Xu          , Xu          , Uh          , Ww          , Ur          , Uu          , Uu^Vu       , Uu^Uf       , Xu          , Uh          , Xu          , Xu          , Uu^Uf       , Uu^Uf       , Ur          , Ur          , Uu          , Ur          , Uu          , Uu          , Xu          , Uu          , Xu          , Ur          , Ur          , Uu          , Uh          , Uh          , Xu          , Xu          , Xu          , Xu          , Xu          , Xu          
Xu          , Xu          , Xu          , Xu          , Uu          , Ur          , Uu          , Uh          , Xu          , Xu          , Xu          , Xu          , Uh          , Uh          , Uu^Uf       , Uu          , Ur          , Uu          , Xu          , Xu          , Xu          , Xu          , Xu          , Xu          , Uu          , Ur          , Uu^Vu       , Uu          , Uh          , Uu^Uf       , Uu^Uf       , Xu          , Xu          , Xu          , Xu          , Xu          , Xu          , Ur          , Ur          , Xu          , Xu          , Xu          , Xu          , Xu          , Xu          , Xu          
Xu          , Xu          , Xu          , Uh          , Uh          , Ur          , Uu          , Xu          , Xu          , Xu          , Xu          , Uh          , Uu^Uf       , Uu^Uf       , Uu          , Uu          , Ur          , Uu          , Uh          , Xu          , Uh          , Xu          , Xu          , Xu          , Uu          , Ur          , Uu          , Uh          , Uh          , Uh          , Uu^Uf       , Xu          , Xu          , Xu          , Xu          , Xu          , Xu          , Uu          , Ur          , Uu^Uf       , Xu          , Xu          , Xu          , Xu          , Xu          , Xu          
Xu          , Xu          , Xu          , Xu          , Uh          , Ur          , Ur          , Uu^Uf       , Ur          , Xu          , Uu          , Uu^Uf       , Uu          , Uu^Vu       , Ur          , Ur          , Cud         , Ur          , Ur          , Uh          , Uu^Uf       , Uh          , Uh          , Uu          , Ur          , Ur          , Ur          , Uu          , Uu          , Uu^Uf       , Uu          , Uu          , Uh          , Xu          , Uu^Uf       , Uu^Uf       , Uu^Uf       , Xu          , Ur          , Uu^Uf       , Uh          , Xu          , Xu          , Xu          , Xu          , Xu          
Xu          , Xu          , Xu          , Xu          , Xu          , Uu          , Ur          , Ur          , Uu          , Ur          , Ur          , Ur          , Ur          , Ur          , Cud         , Cud         , Cud         , Cud         , Uu          , Ur          , Ur          , Ur          , Ur          , Ur          , Xu          , Xu          , Xu          , Ur          , Ur          , Ur          , Ur          , Uu          , Uu          , Uh          , Uu^Uf       , Uu^Uf       , Uh          , Uu          , Ur          , Uu          , Uu^Vu       , Uh          , Xu          , Xu          , Xu          , Xu          
Xu          , Xu          , Xu          , Xu          , Uh          , Uh          , Ur          , Uu          , Xu          , Xu          , Xu          , Uu          , Ur          , Uu          , Cud         , 4 Kud       , Xu          , Xu          , Xu          , Uu          , Xu          , Uu          , Xu          , Xu          , Xu          , Xu          , Xu          , Xu          , Xu          , Xu          , Uh          , Ur          , Ur          , Uu          , Uu          , Uu^Vu       , Uh          , Uh          , Ur          , Uu          , Uu          , Xu          , Uh          , Xu          , Xu          , Xu          
Xu          , Xu          , Xu          , Uu^Uf       , Uu^Uf       , Uh          , Ur          , Uu          , Xu          , Xu          , Xu          , Uu          , Uu          , Ur          , Xu          , Xu          , Xu          , Xu          , Xu          , Xu          , Uh          , Xu          , Xu          , Xu          , Xu          , Xu          , Xu          , Xu          , Uh          , Uh          , Uh          , Uh          , Uu          , Ur          , Ur          , Uu          , Uh          , Uh          , Ur          , Uu          , Uu          , Uh          , Xu          , Xu          , Xu          , Xu          
Xu          , Xu          , Xu          , Uu^Uf       , Uu^Uf       , Uh          , Ur          , Xu          , Xu          , Xu          , Xu          , Xu          , Xu          , Ur          , Ur          , Ww          , Xu          , Xu          , Xu          , Xu          , Uh          , Uh          , Uh          , Uh          , Uh          , Uh          , Uh          , Uh          , Uh          , Uh          , Xu          , Xu          , Ur          , Ur          , Uu^Vu       , Ur          , Ur          , Ur          , Uu          , Uu          , Xu          , Xu          , Xu          , Xu          , Xu          , Xu          
Xu          , Xu          , Xu          , Uu^Uf       , Uh          , Uu          , Ur          , Uu^Vu       , Uu          , Xu          , Xu          , Xu          , Xu          , Uu^Uf       , Ur          , Uu          , Uu^Uf       , Uu^Uf       , Xu          , Uh          , Uu^Uf       , Uh          , Uu          , Uu^Uf       , Uu^Uf       , Uu^Uf       , Uu^Uf       , Uu^Uf       , Xu          , Xu          , Xu          , Ww          , Ur          , Uu          , Uu          , Uu^Uf       , Uh          , Uh          , Uh          , Uu          , Uu^Uf       , Xu          , Xu          , Xu          , Xu          , Xu          
Xu          , Xu          , Xu          , Xu          , Xu          , Xu          , Ur          , Uu          , Uu          , Uu          , Uh          , Xu          , Xu          , Uu^Uf       , Uu^Uf       , Ur          , Ur          , Uu^Uf       , Uu^Uf       , Uu^Uf       , Uu          , Uu          , Ur          , Uu          , Uu^Uf       , Uu^Uf       , Uu^Uf       , Xu          , Xu          , Xu          , Xu          , Ur          , Ww          , Uh          , Uh          , Uh          , Uh          , Xu          , Xu          , Xu          , Uu^Uf       , Uu^Uf       , Xu          , Xu          , Xu          , Xu          
Xu          , Xu          , Xu          , Xu          , Uh          , Uu          , Ur          , Uu          , Uu          , Uu          , Uh          , Xu          , Uh          , Uh          , Ww          , Ww          , Ur          , Uu          , Uu          , Uu^Vu       , Uu          , Ur          , Xu          , Xu          , Xu          , Uu^Uf       , Ur          , Xu          , Ur          , Xu          , Uu          , Ur          , Uu          , Ww          , Xu          , Xu          , Xu          , Xu          , Xu          , Xu          , Uu^Uf       , Uu^Uf       , Uh          , Xu          , Xu          , Xu          
Xu          , Xu          , Uh          , Xu          , Uh          , Uu          , Ur          , Uu          , Uu^Uf       , Uu          , Uh          , Uh          , Uh          , Uh          , Ww          , Ww          , Ur          , Uu          , Ur          , Ur          , Uu          , Uu          , Xu          , Xu          , Xu          , Xu          , Uu          , Ur          , Uu          , Uu          , Ur          , Ur          , Uu          , Ww          , Xu          , Xu          , Xu          , Xu          , 7 Kud       , Cud         , Uh          , Uh          , Uh          , Xu          , Xu          , Xu          
Xu          , Xu          , Uu^Uf       , Uh          , Uh          , Ur          , Uu          , Uh          , Uh          , Xu          , Xu          , Xu          , Xu          , Xu          , Xu          , Ww          , Uu          , Ur          , Uu          , Uu          , Xu          , Xu          , Xu          , Xu          , Xu          , Uu^Vu       , Uu          , Uu          , Uu^Uf       , Uu          , Ur          , Uu          , Uu          , Ww          , Ww          , Uu          , Cud         , Cud         , Cud         , Uu^Uf       , Uh          , Uh          , Uh          , Xu          , Xu          , Xu          
Xu          , Xu          , Xu          , Uh          , Uh          , Ur          , Uu^Vu       , Uu          , Uh          , Xu          , Xu          , Xu          , Xu          , Xu          , Xu          , Xu          , Uu          , Ur          , Uu^Uf       , Uu^Uf       , Uu^Uf       , Xu          , Uh          , Xu          , Xu          , Xu          , Xu          , Xu          , Uh          , Uu          , Ur          , Uu          , Ur          , Ur          , Ur          , Ur          , Xu          , Xu          , Xu          , Cud         , Uu^Uf       , Xu          , Xu          , Xu          , Xu          , Xu          
Xu          , Xu          , Xu          , Uh          , Ww          , Ur          , Ur          , Uu          , Uu          , Xu          , Xu          , Xu          , Xu          , Xu          , Xu          , Xu          , Uh          , Ur          , Uu          , Uu^Uf       , Uu^Uf       , Uh          , Uh          , Uh          , Xu          , Xu          , Uh          , Xu          , Uh          , Uu          , Ur          , Ur          , Uu          , Uh          , Uu^Vu       , Xu          , Xu          , Xu          , Xu          , Xu          , Xu          , Xu          , Xu          , Xu          , Xu          , Xu          
Xu          , Xu          , Uu^Uf       , Xu          , Ww          , Ur          , Xu          , Ur          , Ur          , Uu          , Uh          , Xu          , Xu          , Xu          , Uh          , Uh          , Uu          , Ur          , Uu          , Uu^Uf       , Uu          , Uu^Uf       , Uu          , Uh          , Ur          , Ur          , Ur          , Uh          , Uh          , Uu          , Ur          , Uu          , Uu          , Uu^Uf       , Uh          , Xu          , Xu          , Xu          , Xu          , Xu          , Xu          , Xu          , Xu          , Xu          , Xu          , Xu          
Xu          , Xu          , Xu          , Uu^Uf       , Ww          , Ur          , Xu          , Xu          , Xu          , Ur          , Ur          , Uh          , Ur          , Uh          , Ur          , Uu          , Ur          , Ur          , Uu^Vu       , Uu          , Ur          , Uu          , Ur          , Ur          , Uu          , Uu^Vu       , Uu          , Ur          , Ur          , Uu          , Ur          , Uu          , Uu          , Uh          , Uu^Uf       , Uu^Uf       , Uh          , Xu          , Xu          , Xu          , Xu          , Xu          , Xu          , Xu          , Xu          , Xu          
Xu          , Xu          , Xu          , Uh          , Ww          , Ur          , Uu^Uf       , Xu          , Xu          , Xu          , Xu          , Ur          , Ww          , Ur          , Ww          , Ur          , Xu          , Ur          , Ur          , Ur          , Uu^Uf       , Ur          , Xu          , Uu          , Xu          , Uu          , Xu          , Uu          , Xu          , Ur          , Uu          , Uu          , Ww          , Uh          , Uh          , Uh          , Ww          , Uh          , Xu          , Xu          , Xu          , Xu          , Xu          , Xu          , Xu          , Xu          
Xu          , Xu          , Xu          , Uu^Vu       , Uh          , Uu^Uf       , Uu^Uf       , Xu          , Xu          , Xu          , Xu          , Xu          , Xu          , Xu          , Xu          , Xu          , Xu          , Xu          , Xu          , Ur          , Ur          , Uu^Uf       , Uu^Uf       , Xu          , Xu          , Xu          , Xu          , Xu          , Xu          , Ur          , Ur          , Uu          , Ww          , Ww          , Ww          , Uu^Vu       , Uh          , Xu          , Xu          , Xu          , Xu          , Xu          , Xu          , Xu          , Xu          , Xu          
Xu          , Xu          , Xu          , Xu          , Uh          , Uu^Uf       , Uh          , Uh          , Uu^Uf       , Xu          , Xu          , Xu          , Xu          , Xu          , Xu          , Xu          , Xu          , Xu          , Xu          , Uh          , Ur          , Ww          , Ww          , Xu          , Xu          , Xu          , Xu          , Xu          , Cud         , Cud         , Cud         , Cud         , Cud         , Ww          , Uu^Uf       , Uh          , Uh          , Uh          , Xu          , Xu          , Xu          , Xu          , Xu          , Xu          , Xu          , Xu          
Xu          , Xu          , Xu          , Xu          , Xu          , Uh          , Xu          , Uh          , Uu^Uf       , Xu          , Xu          , Xu          , Xu          , Xu          , Xu          , Xu          , Xu          , Xu          , Uh          , Uh          , Cud         , Cud         , Cud         , Uh          , Xu          , Xu          , Xu          , Xu          , Cud         , Cud         , Cud         , 6 Kud       , Cud         , Xu          , Xu          , Uu^Uf       , Uu^Uf       , Uu^Uf       , Xu          , Xu          , Xu          , Xu          , Xu          , Xu          , Xu          , Xu          
Xu          , Xu          , Xu          , Xu          , Uu^Uf       , Xu          , Cud         , Cud         , Cud         , Cud         , Cud         , Xu          , Xu          , Xu          , Xu          , Xu          , Xu          , Xu          , Uh          , Cud         , Cud         , 5 Kud       , Uu^Uf       , Uh          , Xu          , Xu          , Xu          , Xu          , Xu          , Xu          , Uu          , Cud         , Uu          , Xu          , Xu          , Xu          , Xu          , Xu          , Xu          , Xu          , Xu          , Xu          , Xu          , Xu          , Xu          , Xu          
Xu          , Xu          , Xu          , Xu          , Xu          , Uu^Uf       , Uu^Uf       , Cud         , 2 Kud       , Cud         , Xu          , Cud         , Xu          , Xu          , Xu          , Xu          , Xu          , Xu          , Xu          , Xu          , Xu          , Cud         , Cud         , Uh          , Xu          , Xu          , Xu          , Xu          , Xu          , Uu^Uf       , Uu          , Ur          , Ur          , Uu^Uf       , Xu          , Xu          , Xu          , Xu          , Xu          , Xu          , Xu          , Xu          , Xu          , Xu          , Xu          , Xu          
Xu          , Xu          , Xu          , Xu          , Xu          , Xu          , Xu          , Uh          , Xu          , Uh          , Xu          , Xu          , Xu          , Xu          , Xu          , Xu          , Xu          , Xu          , Xu          , Xu          , Xu          , Xu          , Xu          , Xu          , Xu          , Xu          , Xu          , Xu          , Xu          , Uh          , Uh          , Uu          , Ur          , Uu^Uf       , Xu          , Xu          , Xu          , Xu          , Xu          , Xu          , Xu          , Xu          , Xu          , Xu          , Xu          , Xu          
Xu          , Xu          , Xu          , Xu          , Xu          , Xu          , Xu          , Xu          , Xu          , Xu          , Xu          , Xu          , Xu          , Xu          , Xu          , Xu          , Xu          , Xu          , Xu          , Xu          , Xu          , Xu          , Xu          , Xu          , Xu          , Xu          , Xu          , Xu          , Xu          , Uh          , Uu^Uf       , Uu^Uf       , Ur          , Uu^Uf       , Xu          , Xu          , Xu          , Xu          , Xu          , Xu          , Xu          , Xu          , Xu          , Xu          , Xu          , Xu          
