Ms^Xm, Ms^Xm, Ms^Xm, Ms, Ms^Xm, Ms, Ms^Xm, Ms^Xm, Ms^Xm, Ms^Xm, Ms, Ms, Ms, Ms, Ms, Ms, Ms, Ha, Ms, Ms, Ms, Ms, Ms^Xm, Ms^Xm, Ms^Xm, Ms^Xm, Ms^Xm, Ms^Xm, Ms, Ha, Ms, Ha, Ms, Ms, Ms, Ms, Ms, Ha, Ms, Ha, Ms, Ms, Ms, Ms, Ms, Ha, Ms, Ms, Ha, Ha^Fda, Ha^Fda, Aa^Fda, Aa^Ftp, Aa^Ftp, Aa^Ftp, Aa^Ftp, Aa^Fda, Aa^Fda, Aa, Aa, Aa^Fda, Aa^Fda, Aa^Fda, Aa^Fda, Aa, Aa, Aa, Aa, Aa, Gd, Gd, Gd, Gd, Gd, Gd, Gd, Gd, Gd
Ms^Xm, Ms^Xm, Ms^Xm, Ms^Xm, Ms^Xm, Ms^Xm, Ms, Ms, Ms, Ms, Ms, Ms, Ha, Ha^Fda, Ha^Fda, Ms, Ms, Ms, Ms, Ms, Ms, Ms, Ms, Ms, Ms, Ms^Xm, Ms^Xm, Ms^Xm, Ms, Ms, Ms, Ms, Ms, Ms, Ha^Fda, Ms, Ms, Ms, Ms, Ms, Ms, Ms, Ms, Ms, Ms, Ms, Ha, Ha, Ha, Ha^Fda, Aa^Ftp, Aa^Ftp, Aa^Ftp, Aa^Ftp, Aa^Ftp, Aa^Ftp, Aa^Ftp, Aa^Fda, Aa, Aa, Aa, Aa^Fda, Aa, Aa, Aa, Aa, Gd, Aa, Gd, Gd, Aa, Aa, Aa^Ftp, Gd, Gd, Gd, Gd, Gd
Ms^Xm, Ms^Xm, Ms^Xm, Ms^Xm, Ms, Ms, Ms, Ms, Ms, Ms, Ms, Ms, Ms, Ha, Ha, Ha^Fda, Ha, Ha, Ha, Ha, Ha, Ms, Ms, Ms, Ms, Ms, Ms, Ms^Xm, Ms, Ms, Ms, Ms, Ms, Ha^Fda, Ha^Fda, Ha, Ha, Ms, Ha, Ms, Ha, Ms, Ha, Ha, Ms, Ha, Aa, Aa, Aa^Fda, Aa^Fda, Aa^Fda, Aa^Fda, Gd, Aa^Ftp, Gd, Aa^Ftp, Aa^Ftp, Aa, Aa, Aa, Aa^Fda, Aa^Ftp, Aa^Ftp, Aa^Ftp, Aa^Ftp, Gd, Gd^Vhr, Gd, Gd, Aa, Aa^Fda, Aa^Fda, Aa^Ftp, Gd, Gd^Vhr, Gd, Gd, Gd
Ms^Xm, Ms^Xm, Ms^Xm, Ms^Xm, Ms, Ms, Ha, Ms, Ha^Fda, Ms, Ms, Ms, Ms, Ms, Ha, Aa^Fda, Aa^Fda, Aa^Fda, Gd, Ha, Ha, Ha^Fda, Ha^Fda, Ha^Fda, Ha^Fda, Ms, Ms, Ms^Xm, Ms, Ms, Ms, Ms, Ms, Ms, Ha^Fda, Ha^Fda, Ha, Ha, Ha, Ha, Ha^Fda, Ha, Ha, Ha, Ha, Ha, Gd, Gd, Gd, Gd, Gd, Gd^Vhr, Aa, Gd, Gd, Gd, Aa, Aa, Aa, Aa^Fda, Aa^Fda, Aa^Ftp, Aa^Ftp, Aa^Ftp, Gd, Gd, Gd, Gd, Aa, Aa, Aa^Ftp, Aa^Ftp, Aa^Ftp, Aa^Ftp, Gd, Gd, Gd, Gd
Ms^Xm, Ms^Xm, Ms^Xm, Ms, Ms, Ms, Ha, Ms, Ha^Fda, Ha^Fda, Ms, Ms, Ms, Ha, Aa^Fda, Aa^Fda, Gd, Gd, Gd, Gd, Gd, Ha, Ha, Ha, Ms, Ha^Fda, Ms, Ms^Xm, Ms, Ms, Ha^Fda, Ms, Ms, Ms, Ha^Fda, Ha^Fda, Ha, Ha^Fda, Ha^Fda, Ha^Fda, Ha^Fda, Ha^Fda, Aa^Fda, Aa, Gd, Gd, Gd, Gd, Gd, Gd, Aa^Fda, Aa^Fda, Aa^Ftp, Aa, Aa^Ftp, Aa, Aa, Aa, Aa, Aa, Aa, Aa, Aa, Aa^Ftp, Aa, Gd, Gd, Gd, Gd, Aa, Aa, Aa, Aa, Aa^Ftp, Co, Gd, Gd, Gd
Ms^Xm, Ms^Xm, Ms^Xm, Ms, Ms, Ms, Ha, Ha, Ha^Fda, Ha^Fda, Ha^Fda, Ha, Ha, Ha, Gd, Aa^Fda, Gd^Vhr, Gd, Cha, Cha, Chr, Gd, Gd, Ha, Ms, Ms, Ms^Xm, Ms^Xm, Ms, Ha^Fda, Ha^Fda, Ha^Fda, Ms, Ms, Ha, Ha, Ha, Ha, Ha, Ha^Fda, Aa^Fda, Aa^Fda, Aa, Aa, Gd, Gd, Gd, Gd, Gd, Aa^Fda, Aa^Fda, Aa^Ftp, Aa^Ftp, Aa^Ftp, Aa, Aa, Aa^Ftp, Aa^Ftp, Aa^Ftp, Aa, Aa, Aa, Aa, Aa, Aa, Aa, Gd, Gd, Aa^Ftp, Gd, Co, Co, Ko, Co, Co, Co, Gd, Gd
Ms^Xm, Ms^Xm, Ms^Xm, Ms, Ms, Ms, Ms, Ha, Ms, Ha, Ha, Ha, Ha, Aa, Aa, Gd, Gd, Chr, Chr, 2 Khr, Chr, Chr, Gd, Ms, Ms, Ms^Xm, Ms, Ms, Ms, Ha^Fda, Ha^Fda, Ha, Ha, Ha, Ha^Fda, Ha^Fda, Ha, Ha, Ha, Aa^Ftp, Aa^Ftp, Aa^Fda, Gd, Gd^Vhr, Gd, Gd, Gd, Gd, Gd, Gd, Aa, Aa^Ftp, Aa, Aa, Aa, Aa, Aa^Ftp, Aa^Ftp, Aa^Ftp, Aa^Fda, Aa^Fda, Aa^Fda, Aa, Aa, Aa^Fda, Aa, Aa^Ftp, Aa^Ftp, Aa^Ftp, Gd, Co, Co, Aa^Fda, 1 Co, Aa^Ftp, Gd, Gd, Gd
Ms^Xm, Ms^Xm, Ms, Ms, Ms, Ms, Ms, Ms, Ms, Ms, Ha, Ha, Aa, Aa, Gd, Gd, Gd, Chr, Cha, Chr, Cha, Gd, Ha, Ms, Ms^Xm, Ms^Xm, Ms, Ms, Ha, Ha^Fda, Ha, Ha, Ha, Ha, Ha^Fda, Ha^Fda, Aa, Ha, Aa^Ftp, Aa^Ftp, Aa^Ftp, Gd, Gd, Gd, Gd, Gd, Aa, Gd, Aa, Aa, Gd, Aa, Gd, Gd, Gd, Aa, Aa, Aa, Aa, Aa^Fda, Aa^Fda, Aa, Aa^Ftp, Aa^Fda, Aa^Fda, Aa^Ftp, Aa^Ftp, Aa^Ftp, Aa^Ftp, Aa^Ftp, Gd, Co, Aa^Fda, Aa^Ftp, Aa^Ftp, Aa^Ftp, Gd, Gd
Ms^Xm, Ms^Xm, Ms, Ms, Ha, Ms, Ms, Ms, Ms, Ms, Ha, Ha, Ha, Aa, Gd, Gd, Gd, Gd, Gd, Gd, Gd, Gd, Ha, Ms, Ms^Xm, Ms^Xm, Ms, Ha, Ha^Fda, Ha, Ha, Ha, Ha, Aa^Ftp, Aa^Ftp, Aa^Ftp, Aa^Ftp, Aa, Aa^Ftp, Aa^Ftp, Aa^Fda, Gd, Gd, Aa, Aa, Aa, Aa^Fda, Aa, Gd, Gd, Gd, Gd, Gd, Gd^Vhr, Gd, Gd, Gd, Aa, Aa, Aa, Aa, Aa^Ftp, Aa, Aa^Fda, Aa, Aa, Aa, Aa, Aa^Ftp, Aa^Ftp, Gd, Gd, Aa^Fda, Aa^Fda, Aa^Ftp, Aa^Ftp, Gd, Gd
Ms^Xm, Ms^Xm, Ms, Ms, Ha, Ha, Ha, Ms, Ha, Ha, Ha^Fda, Ha, Ha^Fda, Gd, Gd, Gd, Gd, Gd, Gd, Gd, Aa^Fda, Gd, Ha, Ms, Ms^Xm, Ms, Ms, Ha^Fda, Ha^Fda, Ha^Fda, Ha, Ha, Ha, Aa^Ftp, Aa^Ftp, Aa^Ftp, Aa^Ftp, Aa, Aa, Aa^Ftp, Aa^Fda, Gd, Gd, Aa, Aa, Aa^Fda, Aa^Ftp, Aa^Ftp, Aa^Ftp, Gd, Gd, Gd, Aa, Gd, Gd, Gd, Gd, Aa, Aa, Aa, Aa, Aa, Aa, Aa, Gd, Aa, Gd, Aa, Gd, Gd, Gd, Gd, Gd, Aa, Gd, Gd, Gd, Gd
Ms^Xm, Ms^Xm, Ha, Ha, Ha, Ha, Ha, Ha, Ha, Ha, Ha, Ha^Fda, Ha^Fda, Aa^Fda, Gd, Gd, Gd, Gd, Gd, Aa^Fda, Aa^Fda, Ha, Ms, Ms, Ms^Xm, Ms, Ha, Ha, Ha, Ha, Ha, Ha, Aa, Aa^Ftp, Gd, Aa, Gd, Aa, Aa, Aa, Gd, Gd, Gd, Aa, Aa, Aa^Ftp, Aa, Aa, Gd, Gd, Gd, Aa, Aa, Aa, Gd, Gd, Aa^Ftp, Aa, Aa^Ftp, Aa^Fda, Aa^Ftp, Aa^Ftp, Aa, Aa, Gd, Gd, Gd, Gd, Gd, Gd, Gd, Gd, Gd, Gd, Gd, Gd, Aa^Ftp, Aa^Ftp
Ms^Xm, Ms^Xm, Ha, Aa, Aa, Ha^Fda, Aa^Fda, Ha, Aa^Fda, Aa, Ha, Ha^Fda, Aa, Aa^Fda, Aa^Fda, Gd, Gd, Gd, Aa^Fda, Aa^Fda, Ha, Ha, Ms^Xm, Ms^Xm, Ms, Ms, Ha, Ha, Gd, Ha, Gd, Gd, Gd, Gd, Gd^Vhr, Gd, Gd, Gd, Gd, Aa, Gd, Gd, Gd, Aa, Aa, Aa, Gd, Gd, Gd, Gd, Gd, Gd, Gd, Aa, Aa, Aa^Ftp, Aa^Ftp, Aa^Ftp, Aa^Ftp, Aa^Fda, Aa^Fda, Aa^Ftp, Aa^Ftp, Gd, Gd, Gd, Gd, Gd^Vhr, Gd, Gd, Gd, Gd, Aa^Ftp, Gd, Gd, Aa^Ftp, Aa^Ftp, Aa^Ftp
Ms, Ha, Ha, Aa, Aa, Aa, Gd, Aa^Fda, Aa^Fda, Aa, Aa, Aa^Fda, Aa^Fda, Aa^Fda, Gd, Gd, Gd, Gd, Aa, Ha, Ms, Ms^Xm, Ms, Ms, Ha, Ha, Ha, Ha, Gd, Gd, Gd, Gd, Gd, Gd, Gd, Gd, Gd, Gd, Gd, Gd, Gd, Gd, Gd, Aa, Gd, Gd, Gd, Gd, Aa, Gd, Gd, Gd, Gd, Gd, Gd, Aa^Ftp, Aa^Ftp, Aa^Ftp, Aa, Aa, Aa, Aa, Aa, Aa^Ftp, Gd, Gd, Gd, Gd, Gd, Aa, Aa^Ftp, Aa^Ftp, Aa^Ftp, Gd, Gd, Gd, Aa^Ftp, Aa^Ftp
Ha, Ha^Fda, Ha^Fda, Aa, Aa, Aa, Gd, Gd, Gd, Gd, Gd, Gd, Gd, Gd, Gd^Vhr, Gd, Gd, Gd, Gd, Ha, Ha, Ms, Ha, Ha, Aa, Gd, Gd, Gd, Gd, Gd, Gd, Gd, Aa, Gd, Gd, Gd, Aa, Gd, Gd, Gd, Gd, Gd, Gd, Gd, Gd, Gd, Aa, Aa, Aa^Ftp, Aa^Ftp, Aa^Ftp, Aa^Ftp, Gd, Gd, Gd, Gd, Gd, Gd, Gd^Vhr, Gd, Aa, Aa, Aa, Gd, Gd, Gd, Gd, Gd, Aa, Aa, Aa^Ftp, Aa^Ftp, Aa^Ftp, Gd, Gd, Gd, Gd, Aa^Ftp
Gd, Ha^Fda, Ha, Ha, Gd, Gd, Gd, Gd, Gd, Gd, Gd, Gd, Gd, Gd, Gd, Gd, Gd, Gd, Gd, Gd, Gd, Aa, Aa, Aa, Gd, Gd, Gd, Gd, Aa, Gd, Gd, Aa, Aa, Aa^Ftp, Aa, Aa, Aa, Aa, Aa, Gd, Gd, Gd, Gd, Gd^Vhr, Gd, Gd, Aa, Aa^Ftp, Aa^Ftp, Aa^Ftp, Aa, Aa, Gd, Gd, Gd, Gd, Gd, Gd, Gd, Gd, Aa, Aa, Aa^Ftp, Aa^Ftp, Aa^Ftp, Gd, Gd, Aa, Aa, Aa^Ftp, Aa^Fda, Aa^Fda, Aa, Gd, Gd^Vhr, Gd, Gd, Gd
Gd, Gd, Gd, Gd, Chr, Gd, Gd, Gd^Vhr, Gd, Gd, Gd, Gd, Gd, Gd, Aa^Fda, Gd, Aa, Gd, Gd, Gd, Gd, Gd, Gd, Gd, Gd, Gd, Aa^Ftp, Aa^Ftp, Aa, Gd, Gd^Vhr, Gd, Aa^Ftp, Aa^Ftp, Aa^Ftp, Aa^Fda, Aa, Gd, Aa, Aa, Gd, Gd, Gd, Gd, Gd, Aa, Aa, Aa^Fda, Aa, Aa, Gd, Gd, Gd, Gd, Gd, Gd, Gd, Gd, Aa, Aa, Aa, Aa^Fda, Aa^Ftp, Aa^Ftp, Aa^Ftp, Aa^Ftp, Gd, Gd, Gd, Aa, Aa, Aa, Gd, Gd, Gd, Gd, Gd, Gd
Gd, Gd, Chr, Cha, 3 Khr, Cha, Gd, Gd, Gd, Gd, Aa, Aa^Fda, Aa^Fda, Aa^Fda, Aa, Aa, Aa, Aa^Fda, Aa, Gd, Gd, Gd, Gd, Gd^Vhr, Gd, Gd, Aa, Aa, Gd, Gd, Gd, Gd, Aa^Ftp, Aa^Ftp, Aa^Fda, Aa^Fda, Aa, Aa, Aa, Aa, Gd, Gd, Gd, Gd, Gd, Gd, Gd, Gd, Gd, Gd, Gd, Gd, Gd, Aa, Aa, Aa, Aa, Gd, Gd, Gd, Gd, Aa, Gd, Aa^Ftp, Gd, Aa^Ftp, Gd, Gd, Gd, Gd, Gd, Gd, Gd, Gd, Gd, Gd, Gd, Gd
Gd, Gd, Cha, Chr, Chr, Cha, Gd, Gd, Gd, Gd, Aa, Aa, Aa, Aa, Aa, Aa, Aa, Ha, Ha^Fda, Ha^Fda, Ha, Gd, Ha, Gd, Gd, Gd, Gd, Gd, Gd, Gd, Gd, Gd, Aa^Ftp, Aa^Ftp, Aa, Aa, Aa, Aa, Aa, Gd, Gd, Gd, Gd, Gd, Gd, Gd, Aa, Aa, Aa^Ftp, Gd, Gd, Gd, Gd, Aa^Ftp, Aa, Aa, Aa, Gd, Aa, Gd, Gd, Gd, Gd, Gd, Gd, Gd, Gd, Gd^Vhr, Gd, Gd, Gd, Gd, Aa, Aa, Aa^Ftp, Gd, Gd, Gd
Aa, Gd, Aa, Gd, Gd, Gd, Gd, Ha, Ha, Gd, Aa, Aa, Ha, Ha, Ha, Aa, Ha, Ha^Fda, Ha^Fda, Ha^Fda, Ms, Ha, Ms, Ha, Ha, Gd, Ha, Gd, Gd, Gd, Aa^Ftp, Aa, Gd, Gd, Gd, Gd, Gd, Aa, Gd, Gd, Gd, Gd, Gd, Gd, Aa, Aa, Aa^Fda, Aa^Ftp, Aa^Ftp, Aa^Ftp, Gd, Gd^Vhr, Gd, Aa^Ftp, Aa^Ftp, Aa, Aa^Ftp, Aa, Aa^Fda, Aa^Ftp, Aa^Ftp, Aa^Ftp, Aa^Ftp, Aa^Ftp, Aa^Ftp, Gd, Gd, Gd, Gd, Gd, Aa, Aa, Aa^Ftp, Aa^Ftp, Aa^Ftp, Aa^Ftp, Aa^Ftp, Gd
Ha, Aa, Ha, Aa, Ha, Ha, Ha, Ha, Ha, Aa, Ha, Ha, Ha^Fda, Ha^Fda, Ha^Fda, Ha, Ha^Fda, Ha^Fda, Ha^Fda, Ms, Ms^Xm, Ms^Xm, Ms, Ha, Ha, Ha, Ha^Fda, Ha, Ha, Ha, Aa^Ftp, Aa, Aa, Gd, Gd, Gd, Gd, Gd, Gd, Gd, Aa, Gd, Gd^Es, Gd, Aa, Aa^Fda, Aa, Aa^Ftp, Aa, Aa, Gd, Gd, Gd, Aa^Ftp, Aa^Ftp, Aa^Ftp, Aa^Ftp, Aa^Ftp, Aa^Fda, Aa^Ftp, Aa^Ftp, Aa^Ftp, Aa^Ftp, Aa^Ftp, Aa^Ftp, Aa, Gd, Gd, Gd, Gd, Aa, Aa^Fda, Aa^Ftp, Aa^Ftp, Aa^Ftp, Aa^Ftp, Gd, Gd
Ms^Xm, Ha, Ha, Ha, Ha, Ha, Ha, Ha, Ms^Xm, Ha, Ha, Ha, Ms^Xm, Ha, Ms^Xm, Ms^Xm, Ms^Xm, Ha^Fda, Ms^Xm, Ms, Ms^Xm, Ms, Ha, Ha, Ha, Ha, Ha^Fda, Ha^Fda, Ha, Aa^Ftp, Aa^Ftp, Aa^Ftp, Aa, Gd, Aa^Ftp, Aa^Ftp, Aa^Ftp, Aa, Aa^Ftp, Aa, Aa, Gd^Es, Gd^Es, Gd^Vhr, Gd, Aa, Gd, Gd, Gd, Aa, Gd, Gd, Gd, Gd, Aa, Aa^Ftp, Aa^Ftp, Aa^Ftp, Aa^Fda, Aa^Fda, Aa^Ftp, Aa^Ftp, Aa^Ftp, Aa^Ftp, Aa^Ftp, Aa, Gd, Gd, Gd, Aa, Aa, Aa^Fda, Aa, Aa^Ftp, Aa, Aa, Gd, Gd
Ms^Xm, Ms^Xm, Ms^Xm, Ms^Xm, Ms^Xm, Ms^Xm, Ms^Xm, Ms^Xm, Ms^Xm, Ha, Ms^Xm, Ms^Xm, Ms^Xm, Ms^Xm, Ms^Xm, Ms^Xm, Ms^Xm, Ms^Xm, Ms^Xm, Ms^Xm, Ms, Ms, Ha, Ha^Fda, Ha^Fda, Ha, Ha, Ha, Ha, Aa^Ftp, Aa, Aa^Ftp, Aa, Gd, Gd, Aa^Ftp, Aa^Ftp, Aa^Ftp, Aa^Fda, Aa^Ftp, Cea^Edb, Gd^Esa, Gd^Es, Gd^Es, Gd^Es, Gd, Aa^Ftp, Gd, Gd, Gd, Gd, Gd, Aa, Aa, Aa^Ftp, Aa, Aa, Aa, Aa, Aa, Aa^Ftp, Aa^Ftp, Aa, Aa^Fda, Aa, Aa, Gd, Gd, Gd, Gd, Aa, Aa, Gd, Aa, Gd, Gd, Gd, Gd
Ms^Xm, Ms^Xm, Xu, Xu, Xu, Xu, Xu, Xu, Xu, Ha, Xu, Xu, Xu, Xu, Xu, Xu, Xu, Ms^Xm, Ms^Xm, Ms^Xm, Ms, Ha, Ms, Ms, Ms, Ha^Fda, Ha, Ha, Ha, Ha, Ha, Aa, Gd, Gd, Gd^Vhr, Gd, Gd, Gd, Gd, Gd, Cea^Esa, Gll, Cea^Es, Gd^Esa, Aa^Fda, Aa^Fda, Aa^Ftp, Aa^Ftp, Aa, Gd, Gd, Gd, Aa^Ftp, Aa^Ftp, Aa^Ftp, Aa, Aa, Aa, Gd, Aa, Aa, Aa, Aa, Aa, Gd, Gd, Gd, Gd, Gd, Gd, Gd, Gd, Gd, Gd, Gd, Gd, Gd, Gd
Ms^Xm, Ms^Xm, Xu, Xu, Xu, Xu, Uh, Uu, Aa, Aa, Aa, Uu, Uu, Uh, Ur, Xu, Xu, Ms^Xm, Ms^Xm, Ms^Xm, Ms, Ha^Fda, Ms, Ms, Ha, Ms, Ms, Ha, Ha, Ha, Ha, Ha, Ha, Gd, Gd, Gd, Aa, Gd, Aa, Gd^Esd, Aa^Ftp, Gll^Feth, Gd^Esa, Aa, Aa, Aa^Fda, Aa^Ftp, Aa^Ftp, Aa, Gd, Gd, Gd, Aa^Ftp, Aa^Ftp, Aa^Ftp, Aa^Ftp, Aa, Gd, Gd, Gd, Gd, Aa, Gd, Gd, Gd, Gd, Gd, Gd, Gd, Gd, Gd, Gd, Gd, Gd, Gd, Gd, Gd, Gd
Ms^Xm, Ms^Xm, Xu, Uu, Uh, Xu, Uu, Aa, Uu, Aa, Uu, Uu, Ur, Ur, Ur, Uh, Xu, Ms^Xm, Ms, Ms, Ha^Fda, Ha^Fda, Ms, Ms, Ha, Ms, Ha, Ha, Ha, Ha^Fda, Ha^Fda, Ha, Ha^Fda, Ha^Fda, Ha, Gd, Aa, Aa, Aa^Ftp, Aa^Ftp, Aa^Ftp, Gd, Gd, Aa, Gd, Aa^Fda, Aa, Aa, Gd, Gd, Aa, Gd, Aa^Fda, Aa^Fda, Aa, Aa, Aa, Gd, Aa, Gd^Vhr, Gd, Gd, Aa, Aa, Aa, Gd, Gd, Gd, Gd, Gd, Gd, Gd, Gd^Vhr, Gd, Gd, Gd, Gd, Gd
Ms^Xm, Ms^Xm, Xu, Uh, Uh, Ur, Ur, Uu, Uu, Uu, Uu, Uu, Uu, Uu^Vu, Xu, Xu, Xu, Ms^Xm, Ms, Ha^Fda, Ms, Ms, Ms, Ha, Ms, Ha, Ms, Ms, Ha^Fda, Ha, Ha, Ha, Ha, Ha^Fda, Ha^Fda, Ha, Aa, Aa, Aa^Fda, Aa^Ftp, Aa^Fda, Gd, Gd, Gd, Gd, Aa, Gd, Gd, Aa^Fda, Gd, Gd, Aa, Aa, Aa, Gd, Aa, Aa, Aa, Aa, Aa, Gd, Gd, Aa, Aa^Fda, Aa^Fda, Aa^Fda, Aa, Aa, Gd, Gd, Gd, Gd, Gd, Gd, Gd, Gd, Gd, Gd
Ms^Xm, Ms^Xm, Xu, Uh, Xu, Uu^Vu, Xu, Uh, Uu, Ur, Ur, Uh, Xu, Uh, Xu, Xu, Xu, Ms^Xm, Ms, Ha, Ha, Ms, Ha, Ms, Ms, Ms, Ms, Ms, Ms, Ha^Fda, Ha, Ha, Ha, Ha^Fda, Ha^Fda, Ha, Ha, Aa, Aa^Fda, Aa^Fda, Gd, Gd, Gd, Gd, Gd, Gd, Aa, Aa^Ftp, Aa^Ftp, Aa^Fda, Aa, Gd, Gd, Gd, Gd, Gd, Gd, Aa, Gd, Gd, Aa, Aa, Aa^Ftp, Aa^Ftp, Aa^Ftp, Aa^Fda, Aa^Ftp, Aa, Aa, Gd, Gd, Gd, Gd, Gd, Gd, Gd, Gd, Gd
Ha, Ms^Xm, Xu, Xu, Xu, Xu, Xu, Xu, Xu, Xu, Xu, Xu, Xu, Xu, Xu, Xu, Xu, Ms^Xm, Ms, Ms, Ha, Ha, Ms, Ms, Ms, Ms, Ha, Ms, Ms, Ms, Ms, Ms, Ha, Ha, Ha, Ha^Fda, Ha, Ha, Ha, Ha, Gd, Gd, Aa, Aa, Aa, Aa, Aa^Ftp, Aa^Ftp, Aa^Ftp, Aa^Fda, Aa, Gd, Gd, Gd, Gd, Gd, Gd, Gd, Gd, Gd, Aa, Aa, Aa, Aa^Ftp, Aa^Ftp, Aa^Ftp, Aa^Ftp, Aa, Aa, Aa, Gd, Gd, Gd, Gd, Gd, Gd, Gd, Gd
