border_size=1
usage=map

Gs^Fds      , Gs^Fds      , Gs^Fds      , Gs^Fds      , Gs^Fds      , Gs^Fds      , Gs^Fds      , Gs^Fds      , Gs^Fp       , Gs^Fds      , Gs^Fds      , Gs^Fds      , Gs^Fp       , Gs^Fds      , Gs^Fds      , Gs^Fds      , Gs^Fds      , Gs^Fds      , Gs^Fds      , Gg          , Gg          , Gg          , Gs^Fds      , Gs^Fds      , Gs^Fds      , Re^Gvs      , Gg^Vh       , Re^Gvs      , Gg          , Gs^Fds      , Gs^Fds      , Gg^Efm      , Gg^Efm      , Gg^Efm      , Gg^Efm      , Gg^Efm      , Gg^Efm      , Re          , Ce          , Ce          , Ce          , Gg^Efm      , Gs^Fds      , Gs^Fds      , Gs^Fds      , Gg          
Gs^Fds      , Gs^Fds      , Gs^Fds      , Gs^Fds      , Gs^Fds      , Gs^Fds      , Gs^Fds      , Gs^Fp       , Gs^Fp       , Gs^Fds      , Gs^Fp       , Gs^Fp       , Gs^Fp       , Gs^Fds      , Gs^Fds      , Gs^Fds      , Gs^Fds      , Gs^Fds      , Gs^Fds      , Gg          , Gs^Fds      , Gs^Fds      , Gs^Fds      , Gs^Fds      , Gg          , Re^Gvs      , Re^Gvs      , Re^Gvs      , Gs^Fds      , Gs^Fds      , Gs^Fds      , Gs^Fds      , Gs^Fds      , Gg^Vh       , Gg^Efm      , Gg^Efm      , Gg^Efm      , Re          , Ce          , Ke          , Ce          , Gg^Efm      , Gg^Efm      , Gs^Fds      , Gg^Efm      , Gg^Efm      
Gs^Fds      , Gs^Fds      , Gg^Vh       , Gs^Fds      , Gs^Fds      , Gs^Fds      , Gs^Fds      , Gs^Fp       , Gs^Fp       , Gs^Fp       , Gs^Fp       , Gs^Fp       , Gs^Fp       , Gs^Fds      , Gs^Fds      , Gs^Fds      , Gs^Fds      , Gs^Fds      , Gs^Fds      , Gs^Fds      , Gs^Fds      , Gs^Fds      , Gg          , Gg          , Gg          , Gg          , Gg          , Gg          , Gs^Fds      , Gs^Fds      , Gs^Fds      , Gs^Fds      , Gs^Fds      , Gs^Fds      , Gg^Efm      , Re^Vct      , Gg^Efm      , 1 Rd        , Rd          , Ce          , Gg^Efm      , Gg^Efm      , Gs^Fds      , Gs^Fds      , Gs^Fds      , Gg          
Gs^Fds      , Gs^Fds      , Gs^Fds      , Gs^Fds      , Gs^Fds      , Gs^Fds      , Gs^Fds      , Gs^Fp       , Gs^Fp       , Gg^Vh       , Gs^Fp       , Gs^Fp       , Gs^Fp       , Gs^Fds      , Gs^Fds      , Gs^Fds      , Gs^Fds      , Gs^Fds      , Gs^Fds      , Gs^Fds      , Gs^Fds      , Gs^Fds      , Gg          , Gg          , Gg          , Gg          , Gg          , Gg          , Gg          , Gs^Fds      , Gs^Fds      , Gs^Fds      , Gs^Fds      , Gg^Efm      , Gg^Efm      , Gg^Efm      , Gg^Efm      , Gg^Efm      , Gg^Efm      , Re          , Gg^Efm      , Gg^Efm      , Gs^Fds      , Gs^Fds      , Gs^Fds      , Gs^Fds      
Gs^Fds      , Gs^Fds      , Gs^Fds      , Gs^Fds      , Gs^Fp       , Gs^Fds      , Gs^Fds      , Gs^Fp       , Gs^Fp       , Gs^Fp       , Gs^Fp       , Gs^Fp       , Gs^Fp       , Gs^Fds      , Gs^Fds      , Gs^Fds      , Gs^Fds      , Gs^Fds      , Gs^Fds      , Gs^Fds      , Gs^Fds      , Gg          , Re^Gvs      , Re^Gvs      , Re^Gvs      , Gg          , Gg          , Gg          , Gg          , Gs^Fds      , Gs^Fds      , Gs^Fds      , Gs^Fds      , Gs^Fds      , Gg^Efm      , Gg^Efm      , Gg^Efm      , Gg^Efm      , Gg^Efm      , Rd          , Gg^Efm      , Gg^Efm      , Gg^Efm      , Gg^Efm      , Gs^Fds      , Gg^Efm      
Gs^Fds      , Gs^Fds      , Gs^Fds      , Gs^Fds      , Gs^Fds      , Gs^Fp       , Gs^Fp       , Gs^Fp       , Gs^Fds      , Gs^Fp       , Gs^Fds      , Gs^Fds      , Gs^Fds      , Gs^Fds      , Gs^Fds      , Gg^Vh       , Gs^Fds      , Gs^Fds      , Gs^Fds      , Gs^Fds      , Gs^Fds      , Re^Gvs      , Re^Gvs      , Gg^Vh       , Re^Gvs      , Gg          , Gg          , Gg          , Gg          , Gs^Fds      , Gs^Fds      , Gs^Fds      , Gs^Fds      , Gg^Efm      , Gg          , Gg^Efm      , Gg^Efm      , Gg^Efm      , Gg^Efm      , Rd          , Gg^Efm      , Gg^Efm      , Gg^Efm      , Gg^Efm      , Gs^Fp       , Gg^Efm      
Ww          , Gs^Fds      , Gs^Fds      , Gs^Fp       , Gs^Fp       , Gs^Fds      , Gs^Fds      , Gs^Fp       , Gs^Fp       , Gs^Fds      , Gs^Fds      , Gs^Fp       , Gs^Fds      , Gs^Fds      , Gs^Fds      , Gs^Fds      , Gs^Fds      , Gs^Fds      , Gs^Fds      , Gs^Fds      , Re^Gvs      , Re^Gvs      , Re^Gvs      , Re^Gvs      , Re^Gvs      , Re^Gvs      , Gg          , Gg          , Gg          , Gs^Fds      , Gs^Fds      , Gs^Fds      , Gg          , Gg          , Gg          , Gg^Efm      , Gg          , Gg^Efm      , Gg          , Re          , Gg          , Gg^Vh       , Gg          , Gs^Fp       , Gs^Fp       , Gg          
Gs^Fds      , Ww          , Ww          , Gs^Fp       , Gs^Fds      , Gs^Fp       , Gs^Fp       , Gs^Fds      , Gs^Fp       , Gs^Fds      , Gs^Fp       , Gs^Fds      , Gs^Fds      , Gs^Fp       , Gs^Fds      , Gs^Fds      , Gs^Fds      , Gs^Fds      , Gg          , Gg          , Gg          , Re^Gvs      , Re^Gvs      , Re^Gvs      , Gg          , Gg          , Gg          , Gg          , Gg          , Gg          , Gg^Efm      , Gg          , Gg^Vh       , Gg          , Gg^Efm      , Gg^Efm      , Gg          , Gg          , Gg          , Rd          , Gg          , Gg          , Gs^Fds      , Gs^Fp       , Gg          , Gg          
Gs^Fds      , Gs^Fds      , Ww          , Gs^Fds      , Gs^Fp       , Gs^Fds      , Gs^Fds      , Gs^Fp       , Gs^Fds      , Gs^Fds      , Gs^Fds      , Gs^Fds      , Gs^Fds      , Gs^Fds      , Gs^Fds      , Gs^Fp       , Gs^Fds      , Gg          , Gg^Efm      , Gg^Efm      , Gg^Efm      , Gg^Efm      , Gg^Efm      , Gg          , Gg          , Gg          , Gg^Efm      , Gg^Efm      , Gg          , Gg^Efm      , Gg^Efm      , Gg          , Gg          , Gg          , Gg          , Gg          , Gg          , Gg^Efm      , Gg          , Rd          , Gg          , Gg          , Gs^Fds      , Gg^Efm      , Gg          , Gg          
Gs^Fds      , Gg^Vh       , Gs^Fds      , Ww          , Gs^Fds      , Gs^Fds      , Gs^Fds      , Gs^Fds      , Gs^Fds      , Gs^Fds      , Gs^Fds      , Gs^Fds      , Gs^Fds      , Gs^Fds      , Gs^Fp       , Gs^Fp       , Gg          , Gs^Fp       , Gg          , Gg^Efm      , Gg^Efm      , Gg^Efm      , Gg^Efm      , Gg^Efm      , Gg^Efm      , Gg^Efm      , Gg^Efm      , Gg^Efm      , Gg^Efm      , Gg^Efm      , Gg          , Gg          , Gg          , Gg          , Gg          , Gg^Efm      , Gg          , Gg          , Gg          , Rd          , Gg          , Gg          , Gg          , Gg          , Gs^Fp       , Gs^Fp       
Gs^Fds      , Gs^Fds      , Gs^Fp       , Ww          , Gs^Fds      , Gs^Fds      , Gs^Fp       , Gs^Fds      , Gs^Fds      , Gs^Fds      , Gs^Fds      , Gs^Fds      , Gg          , Gs^Fds      , Gs^Fp       , Gs^Fds      , Gg          , Gg          , Gg          , Gg          , Gg          , Gg^Efm      , Gg^Efm      , Gg          , Gg          , Gg^Efm      , Gg^Efm      , Gg^Efm      , Gg          , Gg          , Gg          , Gg          , Gs^Fds      , Gg          , Gs^Fds      , Gg          , Gg          , Gg          , Gg          , Re          , Gg          , Gg          , Gg          , Gs^Fds      , Gs^Fp       , Gs^Fp       
Gs^Fds      , Gs^Fds      , Gs^Fp       , Ww          , Ww          , Gs^Fp       , Gs^Fds      , Gs^Fds      , Gs^Fds      , Gs^Fds      , Gg^Vh       , Gs^Fp       , Gs^Fp       , Gs^Fp       , Gs^Fds      , Gs^Fp       , Gs^Fds      , Gg          , Gs^Fp       , Gs^Fds      , Gs^Fds      , Gg^Vh       , Gs^Fds      , Gg          , Gs^Fds      , Gg          , Gg          , Gg^Efm      , Gg          , Gg^Vh       , Gg^Efm      , Gs^Fds      , Gs^Fp       , Gs^Fds      , Gg          , Gg          , Gs^Fp       , Gg          , Re          , Re          , Gg          , Gg          , Gg          , Gs^Fds      , Gs^Fds      , Gs^Fp       
Gs^Fds      , Gs^Fds      , Gs^Fds      , Gs^Fds      , Ww          , Gs^Fds      , Gs^Fds      , Gs^Fds      , Gs^Fds      , Gs^Fds      , Gg          , Gg          , Gs^Fp       , Gs^Fp       , Gg          , Gs^Fp       , Gs^Fp       , Gs^Fp       , Gs^Fds      , Gs^Fp       , Gg          , Gs^Fds      , Gg          , Gs^Fds      , Gs^Fds      , Gs^Fds      , Gg          , Gg          , Gg          , Gg          , Gg          , Gs^Fp       , Gs^Fp       , Gs^Fp       , Gs^Fds      , Gs^Fds      , Gg          , Gg          , Re          , Gg          , Gg          , Gg          , Gg^Vh       , Gs^Fp       , Gs^Fds      , Gg          
Gg          , Gg          , Gs^Fp       , Gg          , Ww          , Gs^Fds      , Gs^Fds      , Gg          , Gs^Fp       , Gg          , Gs^Fp       , Gs^Fp       , Gs^Fds      , Gs^Fds      , Gs^Fp       , Gs^Fds      , Gs^Fp       , Gs^Fds      , Gs^Fp       , Gs^Fp       , Gs^Fds      , Gg          , Gs^Fp       , Gs^Fp       , Gs^Fp       , Gg          , Gg          , Gg^Efm      , Gg          , Gg          , Gg          , Gs^Fp       , Gg          , Gs^Fds      , Gg          , Gg          , Re          , Re          , Gg          , Gg          , Gg          , Gg          , Gg          , Gg          , Gs^Fp       , Gs^Fds      
Gg          , Gs^Fp       , Gs^Fp       , Gs^Fp       , Gg          , Ww          , Gs^Fp       , Gg          , Gs^Fds      , Gs^Fds      , Gg          , Gg          , Gs^Fp       , Gs^Fds      , Gs^Fp       , Gg^Vh       , Gg^Fet      , Gg          , Gg          , Gs^Fds      , Gs^Fds      , Gs^Fds      , Gs^Fds      , Gg          , Gs^Fds      , Gs^Fp       , Gg          , Gg^Vh       , Gg          , Gg          , Gs^Fds      , Gg          , Gs^Fp       , Gs^Fp       , Gs^Fp       , Gg          , Re          , Gs^Fds      , Gs^Fp       , Gs^Fds      , Gs^Fp       , Gg          , Gs^Fds      , Gs^Fp       , Gs^Fp       , Gs^Fds      
Gg          , Gs^Fp       , Gs^Fp       , Gs^Fp       , Gg          , Ww          , Wwf         , Gg          , Gs^Fds      , Gg          , Gg          , Gs^Fp       , Gs^Fp       , Gs^Fp       , Gg          , Gs^Fp       , Gs^Fds      , Gs^Fp       , Gs^Fds      , Gg          , Gs^Fds      , Gs^Fds      , Gs^Fds      , Gs^Fds      , Gg          , Gg          , Gg          , Gs^Fp       , Gs^Fp       , Gs^Fds      , Gg          , Gg          , Gs^Fds      , Gg          , Gg          , Rd          , Gg          , Re          , Re          , Gg          , Gg          , Gg          , Gs^Fds      , Gg          , Gs^Fds      , Gs^Fds      
Gg          , Gs^Fp       , Gs^Fp       , Gs^Fds      , Gs^Fds      , Gg          , Gs^Fds      , Wwf         , Gs^Fds      , Gg          , Gg          , Gg          , Gs^Fds      , Gs^Fds      , Gs^Fms      , Gs^Fds      , Gs^Fp       , Gs^Fp       , Gs^Fp       , Gs^Fds      , Gg          , Gs^Fds      , Gs^Fds      , Gs^Fp       , Gs^Fp       , Gg          , Gg          , Gs^Fds      , Gs^Fds      , Gs^Fds      , Gs^Fds      , Gs^Fds      , Gg          , Gg          , Rd          , Rd          , Gg          , Gg          , Re          , Gg          , Gg          , Gs^Fds      , Gs^Fds      , Gg          , Gs^Fds      , Gs^Fds      
Gg          , Gg          , Gs^Fp       , Gs^Fp       , Gs^Fds      , Gg          , Gs^Fp       , Wwf         , Ww          , Gs^Fds      , Gg          , Gg          , Gs^Fp       , Gg          , Gs^Fds      , Gs^Fds      , Gs^Fp       , Gs^Fds      , Gs^Fp       , Gg          , Gs^Fds      , Gs^Fds      , Gs^Fds      , Gs^Fds      , Gg          , Gg          , Gg          , Gg          , Gg          , Gs^Fds      , Gg          , Gg          , Gs^Fds      , Gg^Fet      , Rd          , Gg          , Gs^Fds      , Gs^Fds      , Gg          , Rd          , Rd          , Gg          , Gg          , Gs^Fds      , Gg          , Gs^Fds      
Gs^Fp       , Gs^Fp       , Gs^Fds      , Gs^Fds      , Gg          , Gs^Fds      , Gs^Fds      , Gs^Fds      , Gs^Fp       , Wwf         , Gs^Fp       , Gs^Fp       , Gs^Fds      , Gg          , Gs^Fds      , Gg          , Gg          , Gs^Fp       , Gg          , Gg          , Gs^Fds      , Gs^Fp       , Gs^Fds      , Gg          , Gg          , Gs^Fp       , Gs^Fp       , Gg          , Gg          , Gs^Fds      , Gg          , Gs^Fds      , Gs^Fds      , Rd          , Gg          , Gg^Vh       , Gs^Fds      , Gs^Fp       , Gg          , Gg          , Gg          , Rd          , Re          , Gs^Fds      , Gs^Fds      , Gs^Fds      
Gg          , Gs^Fp       , Gg          , Gs^Fds      , Gg          , Gs^Fms      , Gs^Fds      , Gg          , Gs^Fds      , Ww          , Ww          , Gs^Fp       , Gg          , Gg          , Gs^Fds      , Gg          , Gs^Fds      , Gs^Fds      , Gs^Fds      , Gs^Fp       , Gs^Fp       , Gg          , Gs^Fds      , Gg          , Gg          , Gg          , Gg          , Gs^Fds      , Gs^Fds      , Gs^Fms      , Gs^Fp       , Gs^Fds      , Gs^Fds      , Rd          , Gg          , Gg          , Gs^Fds      , Gg          , Gs^Fds      , Gg          , Gs^Fds      , Gg          , Re          , Gg          , Gg          , Gg          
Gg          , Gs^Fds      , Gs^Fp       , Gs^Fp       , Gg          , Gs^Fds      , Gs^Fds      , Gs^Fms      , Gg          , Gs^Fds      , Gg          , Ww          , Gg          , Gs^Fp       , Gg          , Gg^Vh       , Gg          , Gs^Fds      , Gs^Fds      , Gg          , Gs^Fp       , Gg          , Gg          , Gs^Fds      , Gs^Fds      , Gs^Fds      , Gg          , Gg          , Gs^Fds      , Gs^Fms      , Gg          , Gs^Fp       , Re          , Re          , Gg          , Gg          , Gs^Fds      , Gg          , Gg          , Gs^Fp       , Gs^Fp       , Gs^Fp       , Gg          , Re          , Re          , Gg          
Gg          , Gg          , Gs^Fp       , Gg          , Gs^Fds      , Gs^Fds      , Gs^Fds      , Gg          , Gs^Fp       , Gg          , Gs^Fds      , Wwf         , Wwf         , Gs^Fds      , Gs^Fds      , Gs^Fp       , Gs^Fp       , Gs^Fds      , Gg          , Gg          , Gg          , Gg          , Gg          , Gs^Fds      , Gg          , Gs^Fds      , Gs^Fds      , Gs^Fds      , Gs^Fp       , Gs^Fp       , Gg          , Gg          , Re          , Gg          , Gg          , Gg          , Gs^Fds      , Gg          , Gs^Fds      , Gs^Fds      , Gg          , Gg          , Gg          , Gg          , Re          , Gg          
Gs^Fds      , Gs^Fds      , Gs^Fds      , Gs^Fds      , Gg          , Gs^Fds      , Gs^Fds      , Gs^Fds      , Gs^Fp       , Gs^Fds      , Gg          , Gg          , Gg          , Ww          , Gg          , Gs^Fds      , Gg          , Gs^Fds      , Gg          , Gs^Fds      , Gs^Fds      , Gs^Fds      , Gg          , Gg          , Gg          , Gs^Fds      , Gg          , Gg          , Gg          , Gg          , Re          , Re          , Gs^Fms      , Gg          , Gg          , Gs^Fds      , Gs^Fds      , Gs^Fds      , Gg          , Gs^Fds      , Gs^Fds      , Gs^Fds      , Gs^Fds      , Gg^Vh       , Gg          , Re          
Gs^Fds      , Gg          , Gg          , Gs^Fds      , Gs^Fds      , Gs^Fds      , Gg^Fet      , Gs^Fds      , Gs^Fp       , Gs^Fds      , Gg          , Gs^Fds      , Gg          , Ww          , Ww          , Gs^Fds      , Gs^Fp       , Gs^Fp       , Gs^Fp       , Gg          , Gg          , Gs^Fds      , Gs^Fp       , Gg^Vh       , Gg          , Gg          , Gs^Fds      , Gs^Fds      , Gg          , Gg          , Re          , Gs^Fds      , Gs^Fds      , Gs^Fds      , Gs^Fds      , Gg          , Gg          , Gg          , Gs^Fds      , Gg          , Gs^Fp       , Gs^Fp       , Gs^Fp       , Gg          , Gg          , Gg          
Gg          , Gs^Fds      , Gg          , Gs^Fds      , Gs^Fds      , Gg          , Gs^Fds      , Gs^Fds      , Gg          , Gg          , Gs^Fds      , Gs^Fp       , Gs^Fp       , Gg          , Gg          , Ww          , Ww          , Gs^Fp       , Ww          , Gg          , Ww          , Gg          , Gs^Fds      , Gs^Fp       , Gg          , Gs^Fds      , Gg          , Gs^Fds      , Gg          , Gg          , Re          , Gs^Fds      , Gs^Fp       , Gs^Fds      , Gg          , Gg          , Gg          , Gg          , Gg          , Gs^Fp       , Gg          , Gs^Fp       , Gs^Fp       , Gg          , Gg          , Gs^Fds      
Gg          , Gs^Fds      , Gs^Fp       , Gs^Fds      , Gg          , Gs^Fds      , Gs^Fds      , Gg          , Gs^Fds      , Gg          , Gs^Fp       , Gs^Fp       , Gs^Fp       , Gs^Fds      , Gg          , Gg          , Ww          , Ww          , Ww          , Ww          , Ww          , Gs^Fds      , Gs^Fds      , Gg          , Gg          , Gs^Fp       , Gg          , Gs^Fds      , Gg          , Re          , Gg          , Gg          , Gs^Fds      , Gs^Fds      , Gg          , Gg          , Gs^Fds      , Gs^Fds      , Gg          , Gs^Fds      , Gs^Fds      , Gg          , Gg          , Gs^Fds      , Gg          , Gs^Fds      
Gg          , Gs^Fds      , Gs^Fp       , Gg          , Gg          , Gs^Fp       , Gg          , Gg          , Gg          , Gs^Fds      , Gs^Fms      , Gg          , Gg          , Gg          , Gg          , Ww          , Ww          , Ww          , Wo          , Ww          , Ww          , Ww          , Ww          , Ww          , Gs^Fds      , Gs^Fds      , Gs^Fds      , Gs^Fds      , Re          , Rd          , Gg          , Gs^Fds      , Gs^Fds      , Gs^Fds      , Gg          , Gg          , Gg          , Gs^Fds      , Gg          , Gg          , Gg          , Gs^Fds      , Gg          , Gs^Fds      , Gs^Fds      , Gs^Fds      
Gg          , Gs^Fp       , Gg          , Gs^Fds      , Gg          , Gg          , Gg          , Gs^Fds      , Gg          , Gg          , Gs^Fds      , Gg          , Gs^Fds      , Gg          , Ww          , Ww          , Wo          , Wo          , Wo          , Wo          , Wo          , Ww          , Ww          , Ww          , Ww          , Gg          , Gs^Fds      , Gg          , Rd          , Gg          , Gs^Fds      , Gs^Fp       , Gs^Fp       , Gs^Fp       , Gs^Fds      , Gs^Fds      , Gg          , Gg          , Gs^Fp       , Gg          , Gg          , Gs^Fds      , Gs^Fds      , Gg          , Gg          , Gs^Fds      
Gg          , Gs^Fds      , Gg          , Gg          , Gs^Fp       , Gg          , Gs^Fds      , Gs^Fp       , Gs^Fds      , Gs^Fms      , Gg          , Gs^Fds      , Gs^Fp       , Gg          , Wo          , Wo          , Ww          , Ww          , Wo          , Wo          , Wo          , Wo          , Ww          , Ww          , Ww          , Gs^Fds      , Rd          , Rd          , Gg          , Gg          , Gs^Fds      , Gs^Fds      , Gs^Fds      , Gg          , Gg          , Gg          , Gg          , Gg          , Gs^Fds      , Gs^Fp       , Gg          , Gg          , Gg^Vh       , Gs^Fp       , Gg          , Gs^Fds      
Gg          , Gs^Fds      , Gs^Fds      , Gg          , Gg          , Gs^Fp       , Gs^Fp       , Gg          , Gs^Fds      , Gs^Fp       , Gs^Fp       , Gg          , Wo          , Wo          , Gs^Fds      , Ww          , Ww          , Ww          , Wo          , Wo          , Wo          , Wo          , Wo          , Ww          , Ww          , Rd          , Gs^Fds      , Gs^Fp       , Gs^Fds      , Gs^Fds      , Ww          , Gs^Fp       , Gg          , Gg^Vh       , Gg          , Gg          , Gs^Fp       , Gg          , Gg          , Gg          , Gg          , Gg          , Gs^Fp       , Gs^Fp       , Gg          , Gs^Fds      
Wo          , Wo          , Wo          , Gs^Fds      , Gs^Fds      , Gs^Fp       , Gs^Fp       , Gg          , Gg          , Gg          , Wo          , Wo          , Gs^Fds      , Gs^Fds      , Gs^Fds      , Gs^Fds      , Ww          , Ww          , Wo          , Wo          , Wo          , Wo          , Wo          , Wo          , Wo          , Ww^Bw|      , Wo          , Gs^Fds      , Wo          , Ww          , Wo          , Ww          , Ww          , Gg          , Gg          , Gs^Fds      , Gs^Fp       , Gg          , Gg          , Gg          , Gs^Fp       , Gg          , Gs^Fp       , Gg          , Gg          , Gs^Fds      
Gs^Fds      , Ww          , Ww          , Wo          , Gs^Fp       , Gg          , Wo          , Wo          , Wo          , Wo          , Gs^Fds      , Gs^Fds      , Gs^Fms      , Gs^Fds      , Gs^Fds      , Gs^Fds      , Gs^Fds      , Ww          , Gs^Fds      , Ww          , Ww          , Wo          , Ww          , Wo          , Ww          , Ww^Bw|      , Wo          , Wo          , Ww          , Wo          , Wo          , Ww          , Ww          , Gg          , Gs^Fds      , Gg          , Gs^Fp       , Gg          , Gg          , Gs^Fds      , Gs^Fds      , Gs^Fms      , Gs^Fds      , Gs^Fms      , Gg          , Gs^Fds      
Gs^Fds      , Gs^Fds      , Gs^Fds      , Wo          , Wo          , Wo          , Gs^Fds      , Gs^Fds      , Gs^Fds      , Gs^Fds      , Gs^Fds      , Gs^Fds      , Gs^Fds      , Gs^Fds      , Gs^Fp       , Gg^Ve       , Gs^Fds      , Gs^Fds      , Gs^Fds      , Gs^Fds      , Gs^Fds      , Ww          , Cv          , Ww          , Ww          , Ww^Bw|      , Ww          , Wo          , Wo          , Ww          , Wo          , Ww          , Gg          , Gs^Fds      , Gs^Fp       , Gs^Fp       , Gg          , Gs^Fp       , Gg          , Gs^Fds      , Gs^Fp       , Gg          , Gg          , Gg          , Gg          , Gs^Fds      
Gs^Fds      , Gs^Fds      , Gs^Fds      , Gs^Fds      , Gs^Fds      , Gs^Fds      , Gs^Fds      , Gs^Fds      , Gs^Fds      , Gs^Fds      , Gs^Fds      , Gs^Fds      , Gs^Fds      , Gs^Fds      , Gs^Fds      , Gs^Fds      , Gs^Fds      , Gs^Fds      , Gs^Fds      , Gs^Fds      , Gs^Fp       , Gs^Fds      , Cv          , Kv          , Cv          , Rd          , Cv          , Ww          , Ww          , Wo          , Ww          , Wo          , Wo          , Gg          , Ww          , Gg          , Gg          , Gg          , Gg          , Gg          , Gg          , Gg          , Gg          , Gg          , Gg          , Gg          
Gs^Fds      , Gg^Ve       , Gs^Fds      , Gs^Fds      , Gs^Fds      , Gs^Fds      , Gs^Fds      , Gg^Ve       , Gs^Fds      , Gs^Fds      , Gs^Fp       , Gs^Fds      , Hh^Fds      , Gs^Fp       , Gs^Fp       , Gs^Fds      , Gs^Fp       , Gs^Fds      , Gs^Fds      , Gs^Fds      , Gs^Fds      , Gs^Fds      , Gs^Fds      , Cv          , Cv          , Rd          , Cv          , Cv          , Gs^Fds      , Gs^Fds      , Gs^Fds      , Gs^Fds      , Gs^Fds      , Wo          , Wo          , Ww          , Wo          , Gg          , Ww          , Gg          , Gg          , Gg^Vh       , Gs^Fds      , Gg          , Gs^Fms      , Gs^Fp       
Gs^Fds      , Gs^Fds      , Gs^Fds      , Gs^Fds      , Gs^Fds      , Gs^Fds      , Gs^Fds      , Gs^Fds      , Gs^Fds      , Gs^Fds      , Hh^Fds      , Hh^Fds      , Gs^Fds      , Gs^Fds      , Gs^Fds      , Gs^Fds      , Gs^Fds      , Gs^Fds      , Gs^Fds      , Gs^Fds      , Gs^Fms      , Gs^Fds      , Gs^Fds      , Gs^Fds      , Gs^Fds      , Rd          , Gs^Fds      , Gs^Fds      , Gs^Fds      , Gs^Fds      , Gs^Fds      , Gs^Fds      , Gs^Fds      , Gs^Fds      , Gs^Fds      , Wo          , Ww          , Wo          , Wo          , Ww          , Ww          , Gg          , Gg          , Gs^Fp       , Gs^Fds      , Gg          
Gs^Fds      , Gs^Fds      , Gs^Fds      , Gs^Fds      , Gg^Fet      , Gs^Fds      , Gs^Fds      , Gs^Fds      , Hh^Fds      , Hh^Fds      , Hh^Fds      , Hh^Fds      , Gs^Fds      , Gs^Fds      , Gs^Fds      , Gs^Fds      , Gs^Fms      , Gs^Fms      , Gs^Fms      , Gs^Fms      , Gs^Fds      , Gs^Fds      , Gs^Fds      , Gs^Fds      , Rd          , Rd          , Gs^Fds      , Gs^Fds      , Gs^Fds      , Gs^Fds      , Gs^Fds      , Gg^Fet      , Gs^Fds      , Gs^Fds      , Gs^Fds      , Gs^Fds      , Gs^Fds      , Ww          , Ww          , Wo          , Wo          , Ww          , Wo          , Gg          , Gg          , Gg          
Gs^Fds      , Gs^Fds      , Gs^Fds      , Gs^Fds      , Gs^Fds      , Gs^Fds      , Gs^Fms      , Gs^Fms      , Gs^Fds      , Gs^Fds      , Gs^Fds      , Gs^Fds      , Gs^Fp       , Gg^Fet      , Gs^Fds      , Gs^Fds      , Gs^Fms      , Gs^Fds      , Gs^Fp       , Gs^Fds      , Gs^Fds      , Gs^Fds      , Re          , Re          , Gs^Fds      , Gs^Fds      , Gs^Fds      , Gs^Fms      , Gs^Fms      , Gs^Fp       , Gs^Fds      , Gs^Fds      , Gs^Fds      , Gs^Fds      , Gs^Fds      , Gs^Fds      , Gs^Fds      , Gs^Fds      , Gs^Fds      , Gs^Fds      , Gs^Fds      , Wo          , Gs^Fds      , Wo          , Wo          , Wo          
Gs^Fds      , Gs^Fds      , Gs^Fds      , Gs^Fms      , Gs^Fds      , Gs^Fms      , Gs^Fds      , Gs^Fds      , Gs^Fmw      , Hh^Fds      , Gs^Fds      , Gs^Fds      , Gs^Fp       , Gs^Fds      , Gs^Fds      , Gs^Fds      , Gs^Fmw      , Gs^Fds      , Gs^Fp       , Gs^Fp       , Gs^Fds      , Re          , Gs^Fds      , Gs^Fds      , Gg^Ve       , Gs^Fds      , Gs^Fds      , Gs^Fds      , Gs^Fp       , Gs^Fds      , Gs^Fms      , Gs^Fds      , Gs^Fp       , Gg^Ve       , Gs^Fds      , Gs^Fds      , Gs^Fds      , Gs^Fds      , Gs^Fds      , Gs^Fds      , Gs^Fp       , Gs^Fds      , Gs^Fds      , Gs^Fds      , Gs^Fds      , Gs^Fds      
Gs^Fds      , Gs^Fds      , Gs^Fds      , Gs^Fds      , Gs^Fds      , Gs^Fds      , Gs^Fmw      , Gs^Fmw      , Gs^Fdw      , Gs^Fmw      , Gs^Fmw      , Gs^Fmw      , Gs^Fmw      , Gs^Fmw      , Gs^Fmw      , Gs^Fmw      , Gs^Fdw      , Gs^Fmw      , Gs^Fmw      , Gs^Fds      , Re          , Rd          , Gs^Fds      , Gs^Fds      , Gs^Fds      , Gs^Fds      , Gs^Fp       , Gs^Fms      , Gs^Fds      , Gs^Fds      , Gs^Fms      , Gs^Fds      , Gs^Fds      , Gs^Fp       , Gs^Fds      , Gs^Fds      , Gs^Fds      , Gs^Fds      , Gs^Fds      , Gs^Fds      , Gs^Fds      , Gs^Fds      , Gs^Fds      , Gs^Fds      , Gs^Fds      , Gs^Fds      
Gs^Fds      , Gg^Ve       , Gs^Fds      , Gs^Fds      , Gs^Fdw      , Gs^Fmw      , Gs^Fdw      , Gs^Fmw      , Gs^Fmw      , Hh^Fds      , Gs^Fmw      , Gs^Fmw      , Gs^Fdw      , Gs^Fmw      , Gs^Fmw      , Gs^Fdw      , Gs^Fmw      , Gs^Fdw      , Gs^Fmw      , Gs^Fds      , Rd          , Gs^Fds      , Gs^Fmw      , Gs^Fds      , Gs^Fds      , Gs^Fds      , Gs^Fds      , Gs^Fds      , Gs^Fds      , Gs^Fds      , Gs^Fds      , Gs^Fds      , Gs^Fds      , Gs^Fp       , Gs^Fds      , Gs^Fds      , Gs^Fds      , Gs^Fds      , Gs^Fds      , Gs^Fds      , Gg^Ve       , Gs^Fds      , Hh^Fds      , Hh^Fds      , Gs^Fds      , Gs^Fds      
Gs^Fds      , Gs^Fds      , Gs^Fdw      , Gs^Fmw      , Gs^Fmw      , Gs^Fmw      , Gs^Fdw      , Gs^Fmw      , Gs^Fdw      , Gs^Fmw      , Gs^Fdw      , Gs^Fmw      , Gs^Fmw      , Gs^Fmw      , Gs^Fdw      , Gs^Fmw      , Gs^Fmw      , Gs^Fdw      , Gs^Fmw      , Rd          , Gs^Fmw      , Gs^Fdw      , Gs^Fmw      , Gs^Fmw      , Gs^Fmw      , Gg^Fet      , Gs^Fds      , Gs^Fds      , Gg^Ve       , Gs^Fds      , Gs^Fp       , Gs^Fp       , Gs^Fds      , Gs^Fds      , Gs^Fds      , Gs^Fds      , Gs^Fds      , Gg^Fet      , Gs^Fds      , Gs^Fds      , Gs^Fds      , Gs^Fds      , Gs^Fds      , Hh^Fds      , Hh^Fds      , Gs^Fds      
Gs^Fmw      , Gs^Fdw      , Gs^Fmw      , Gs^Fmw      , Gs^Fdw      , Gs^Fdw      , Hh^Fdw      , Hh^Fdw      , Hh^Fdw      , Hh^Fdw      , Hh^Fdw      , Gs^Fdw      , Gs^Fdw      , Gs^Fmw      , Gs^Fdw      , Gs^Fmw      , Gs^Fmw      , Gs^Fmw      , Re          , Re          , Ce          , Gs^Fmw      , Gs^Fmw      , Gs^Fmw      , Gs^Fmw      , Gs^Fds      , Gs^Fmw      , Gs^Fp       , Gs^Fds      , Gs^Fds      , Gs^Fds      , Gs^Fds      , Gs^Fds      , Gs^Fds      , Gs^Fds      , Gs^Fds      , Gs^Fp       , Gs^Fp       , Gs^Fds      , Gs^Fp       , Gs^Fds      , Gs^Fp       , Gs^Fds      , Gs^Fds      , Gs^Fds      , Hh^Fds      
Gs^Fmw      , Gs^Fmw      , Gs^Fmw      , Gs^Fdw      , Hh^Fdw      , Hh^Fdw      , Gs^Fdw      , Gs^Fdw      , Gs^Fdw      , Gs^Fdw      , Gs^Fdw      , Hh^Fdw      , Hh^Fdw      , Gs^Fdw      , Hh^Fdw      , Gs^Fdw      , Gs^Fdw      , Gs^Fdw      , Rd          , Ce          , 2 Ke        , Ce          , Ce          , Gs^Fdw      , Gs^Fmw      , Gs^Fmw      , Gs^Fdw      , Gs^Fmw      , Gs^Fmw      , Gs^Fds      , Gs^Fds      , Gs^Fds      , Gs^Fds      , Hh^Fds      , Gs^Fds      , Gg^Ve       , Gs^Fds      , Gs^Fds      , Hh^Fds      , Gs^Fds      , Hh^Fds      , Gs^Fds      , Gs^Fds      , Hh^Fds      , Hh^Fds      , Hh^Fds      
Gs^Fmw      , Gs^Fdw      , Hh^Fdw      , Hh^Fdw      , Gs^Fdw      , Gs^Fdw      , Gs^Fdw      , Gs^Fdw      , Gs^Fdw      , Gs^Fdw      , Gs^Fdw      , Gs^Fdw      , Hh^Fdw      , Gs^Fdw      , Gs^Fdw      , Gs^Fdw      , Re          , Rd          , Gs^Fmw      , Ce          , Ce          , Ce          , Hh^Fdw      , Gs^Fdw      , Gs^Fdw      , Hh^Fdw      , Gs^Fdw      , Gs^Fdw      , Hh^Fdw      , Gs^Fmw      , Gs^Fmw      , Gs^Fds      , Gs^Fds      , Gs^Fp       , Gs^Fp       , Gs^Fp       , Gs^Fds      , Gs^Fds      , Hh^Fds      , Hh^Fds      , Hh^Fds      , Hh^Fds      , Hh^Fds      , Gs^Fds      , Gs^Fds      , Gs^Fds      
Gs^Fdw      , Gs^Fdw      , Gs^Fdw      , Gs^Fdw      , Gs^Fdw      , Hh^Fdw      , Gs^Fdw      , Gs^Fdw      , Gs^Fmw      , Gs^Fdw      , Gs^Fmw      , Gs^Fmw      , Gs^Fmw      , Gs^Fdw      , Re          , Re          , Gs^Fmw      , Gs^Fdw      , Gs^Fmw      , Hh^Fdw      , Gs^Fmw      , Gs^Fdw      , Gs^Fmw      , Gs^Fmw      , Gs^Fmw      , Hh^Fdw      , Hh^Fdw      , Hh^Fdw      , Gs^Fmw      , Gs^Fmw      , Gs^Fmw      , Gs^Fds      , Gs^Fds      , Gs^Fds      , Gs^Fds      , Gs^Fds      , Gs^Fds      , Gs^Fds      , Gs^Fds      , Hh^Fds      , Gs^Fds      , Hh^Fds      , Gs^Fds      , Gs^Fds      , Gs^Fds      , Gs^Fds      
