border_size=1
usage=map

Ms          , Ms          , Ha^Fda      , Ha^Fda      , Ha^Fda      , Ha^Fda      , Gd^Fmw      , Gd^Fmw      , Gd^Fmw      , Gd^Fmw      , Wwg         , Gd^Fmw      , Hhd^Fmw     , Gd^Fmw      , Hhd^Fmw     , Gd^Fmw      , Gd^Fmw      , Gd^Fmw      , Gd^Fmw      , Ha^Fda      , Ha^Fda      , Ha^Fda      , Ha^Fda      , Ha^Fda      , Ha^Fda      , Gd^Fmw      , Gd^Fmw      , Gd^Fmw      , Gd^Fmw      , Gd^Fmw      , Gd^Fmw      , Gd^Fmw      , Gd^Fmw      , Gd^Fmw      , Gd^Fmw      , Gd^Fmw      , Gd^Fmw      , Gd^Fmw      , Gd^Fmw      , Ha^Fda      , Ha^Fda      , Ha^Fda      , Ha^Fda      , Ms          , Ms          , Ms          
Ha^Fda      , Ha^Fda      , Gd^Fmw      , Gd^Fmw      , Gd^Fmw      , Gd^Fmw      , Gd^Fmw      , Gd^Fmw      , Hhd^Fmw     , Hhd^Fmw     , Wwg         , Hhd^Fmw     , Hhd^Fmw     , Hhd^Fmw     , Hhd^Fmw     , Hhd^Fmw     , Hhd^Fmw     , Hhd^Fmw     , Hhd^Fmw     , Ha^Fda      , Hhd^Fmw     , Ha^Fda      , Hhd^Fmw     , Hhd^Fmw     , Hhd^Fmw     , Gd^Fmw      , Gd^Fmw      , Gd^Fmw      , Gg          , Gd^Fmw      , Gd^Fmw      , Gd^Fmw      , Co          , Gd^Fmw      , Co          , Gd^Fmw      , Hhd^Fmw     , Hhd^Fmw     , Hhd^Fmw     , Ha^Fda      , Hhd^Fmw     , Ha^Fda      , Ha^Fda      , Ha^Fda      , Ha^Fda      , Ms          
Hhd^Fmw     , Gd^Fmw      , Cea         , Cea         , Ce          , Hhd^Fmw     , Gd^Fmw      , Hhd^Fmw     , Hhd^Fmw     , Hhd^Fmw     , Gd^Fmw      , Wwg         , Gd^Fmw      , Hhd^Fmw     , Gd^Fmw      , Hhd^Fmw     , Gd^Fmw      , Gd^Fmw      , Gs^Fdw      , Hhd^Fmw     , Hhd^Fmw     , Hhd^Fmw     , Hhd^Fmw     , Hhd^Fmw     , Gd^Fmw      , Gd^Fmw      , Gd^Fmw      , Gg^Ve       , Gg          , Gg          , Gd^Fmw      , Gs^Fdw      , Gd^Fmw      , Co          , 5 Ko        , Coa         , Gd^Fmw      , Gd^Fmw      , Gd^Fmw      , Gd^Fmw      , Hhd^Fmw     , Hhd^Fmw     , Gd^Fmw      , Ha^Fda      , Ha^Fda      , Ha^Fda      
Hhd^Fmw     , Cea         , Ce          , 3 Ke        , Ce          , Hhd^Fmw     , Hhd^Fmw     , Hhd^Fmw     , Hhd^Fmw     , Gd^Fmw      , Gd^Fmw      , Wwg         , Hhd^Fmw     , Gd^Fmw      , Gd^Fmw      , Gd^Fmw      , Gd^Fmw      , Gd^Fmw      , Gd^Fmw      , Hhd^Fmw     , Hhd^Fmw     , Gd^Fmw      , Gd^Fmw      , Gd^Fmw      , Gd^Fmw      , Gd^Fmw      , Gg          , Gg          , Gd^Fmw      , Gg          , Gg          , Gd^Fmw      , Gd^Fmw      , Co          , Co          , Co          , Gd^Fmw      , Gs^Fdw      , Gd^Fmw      , Hhd^Fmw     , Hhd^Fmw     , Gs^Fdw      , Gd^Fmw      , Gd^Fmw      , Gd^Fmw      , Ha^Fda      
Hhd^Fmw     , Hhd^Fmw     , Ce          , Ce          , Ce          , Hhd^Fmw     , Gg^Ve       , Gd^Fmw      , Gd^Fmw      , Hhd^Fmw     , Gd^Fmw      , Wwg         , Wwg         , Hhd^Fmw     , Hhd^Fmw     , Gd^Fmw      , Gg          , Gd^Fmw      , Gd^Fmw      , Gd^Fmw      , Gd^Fmw      , Gd^Fmw      , Gd^Fmw      , Gd^Fmw      , Gg          , Gg          , Gd^Fmw      , Gd^Fmw      , Gd^Fmw      , Gd^Fmw      , Gg          , Gd^Fmw      , Gd^Fmw      , Gd^Fmw      , Gd^Fmw      , Hhd^Fmw     , Gd^Fmw      , Gd^Fmw      , Hhd^Fmw     , Hhd^Fmw     , Hhd^Fmw     , Hhd^Fmw     , Hhd^Fmw     , Hhd^Fmw     , Hhd^Fmw     , Ha^Fda      
Gd^Fmw      , Hhd^Fmw     , Hhd^Fmw     , Ce          , Hhd^Fmw     , Hhd^Fmw     , Hhd^Fmw     , Hhd^Fmw     , Gd^Fmw      , Gd^Fmw      , Gd^Fmw      , Gd^Fmw      , Wwg^Bw/     , Gd^Fmw      , Gd^Fmw      , Gg          , Gd^Fmw      , Gg          , Gd^Fmw      , Gd^Fmw      , Gd^Fmw      , Gd^Fmw      , Gg          , Gg          , Gg          , Gd^Fmw      , Gg          , Gd^Fmw      , Gg          , Gg          , Gg          , Gd^Fmw      , Gd^Fmw      , Gd^Fmw      , Gd^Fmw      , Gd^Fmw      , Gd^Fmw      , Hhd^Fmw     , Gd^Fmw      , Gd^Fmw      , Gd^Fmw      , Hhd^Fmw     , Hhd^Fmw     , Hhd^Fmw     , Gd^Fmw      , Gd^Fmw      
Ha^Fda      , Gd^Fmw      , Hhd^Fmw     , Hhd^Fmw     , Hhd^Fmw     , Gd^Fmw      , Hhd^Fmw     , Gd^Fmw      , Gd^Fmw      , Gd^Fmw      , Gd^Fmw      , Gd^Fmw      , Gd^Fmw      , Wwg         , Wwg         , Gg          , Gg          , Gg          , Gg          , Gg          , Gg          , Gg          , Gg          , Gg          , Gd^Fmw      , Gg          , Gg          , Gd^Fmw      , Gg          , Gg          , Gg          , Gg          , Gg          , Gg          , Gg          , Gd^Fmw      , Gd^Fmw      , Gd^Fmw      , Gd^Fmw      , Gd^Fmw      , Gd^Fmw      , Gd^Fmw      , Gg^Ve       , Gd^Fmw      , Gd^Fmw      , Gd^Fmw      
Ha^Fda      , Gd^Fmw      , Gd^Fmw      , Gd^Fmw      , Hhd^Fmw     , Hhd^Fmw     , Hhd^Fmw     , Gd^Fmw      , Gd^Fmw      , Gd^Fmw      , Gg          , Gg          , Gg          , Gg          , Wwg         , Gg          , Gg          , Gg          , Gg          , Gg          , Gg          , Gg          , Gg          , Gd^Fmw      , Gg          , Gg          , Gd^Fmw      , Gg          , Gd^Fmw      , Gg          , Gg          , Gg          , Gd^Fmw      , Gg          , Gg          , Gg          , Gg^Ve       , Gs^Fdw      , Gd^Fmw      , Gd^Fmw      , Gd^Fmw      , Gd^Fmw      , Gd^Fmw      , Hhd^Fmw     , Gd^Fmw      , Gd^Fmw      
Ha^Fda      , Gd^Fmw      , Hhd^Fmw     , Hhd^Fmw     , Gd^Fmw      , Gd^Fmw      , Hhd^Fmw     , Gs^Fdw      , Gd^Fmw      , Gd^Fmw      , Gg          , Gg          , Gd^Fmw      , Gg          , Wwg         , Gg          , Gg          , Hhd^Fmw     , Aa^Fma      , Gd^Fmw      , Gg          , Gg^Ve       , Gg          , Gg          , Gd^Fmw      , Gs^Fdw      , Gd^Fmw      , Gg          , Gg          , Gg          , Gd^Fmw      , Gg          , Gg          , Gg          , Gg          , Gg          , Gg          , Gg          , Gg          , Gd^Fmw      , Gd^Fmw      , Gd^Fmw      , Gd^Fmw      , Gd^Fmw      , Gd^Fmw      , Gd^Fmw      
Ha^Fda      , Gd^Fmw      , Hhd^Fmw     , Hhd^Fmw     , Gd^Fmw      , Gd^Fmw      , Gd^Fmw      , Hhd^Fmw     , Gg          , Gd^Fmw      , Gg          , Gg          , Gg          , Gd^Fmw      , Wwg         , Gd^Fmw      , Gg          , Gg          , Hhd^Fmw     , Gg          , Gg          , Gg          , Gg          , Gg          , Gg          , Gd^Fmw      , Gg          , Gd^Fmw      , Gg          , Gd^Fmw      , Gd^Fmw      , Gs^Fdw      , Gd^Fmw      , Gg          , Gd^Fmw      , Gd^Fmw      , Gg          , Gd^Fmw      , Gg          , Gg          , Gd^Fmw      , Gd^Fmw      , Gd^Fmw      , Gd^Fmw      , Hhd^Fmw     , Gd^Fmw      
Ms          , Ha^Fda      , Gd^Fmw      , Gs^Fdw      , Gg^Ve       , Gd^Fmw      , Gd^Fmw      , Gd^Fmw      , Gg          , Gg          , Gd^Fmw      , Gg          , Gg^Ve       , Gg          , Gd^Fmw      , Wwg^Bw/     , Gg          , Gd^Fmw      , Hhd^Fmw     , Gg          , Gg          , Gd^Fmw      , Hhd^Fmw     , Hhd^Fmw     , Gd^Fmw      , Gg          , Gd^Fmw      , Gg          , Gg^Ve       , Gg          , Gd^Fmw      , Aa^Fma      , Gd^Fmw      , Gd^Fmw      , Gd^Fmw      , Gd^Fmw      , Gs^Fdw      , Gg          , Gg          , Gd^Fmw      , Gd^Fmw      , Gd^Fmw      , Hhd^Fmw     , Hhd^Fmw     , Hhd^Fmw     , Gd^Fmw      
Ms          , Ha^Fda      , Gd^Fmw      , Hhd^Fmw     , Hhd^Fmw     , Gd^Fmw      , Gd^Fmw      , Gd^Fmw      , Gg          , Gd^Fmw      , Gd^Fmw      , Gg          , Gg          , Gg          , Gg          , Wwg         , Wwg         , Gd^Fmw      , Wwg         , Gg          , Gd^Fmw      , Gd^Fmw      , Gs^Fdw      , Gd^Fmw      , Cv          , Gd^Fmw      , Gg          , Gd^Fmw      , Gg          , Gg          , Gg          , Gg          , Gg          , Gg          , Gg          , Gd^Fmw      , Hhd^Fmw     , Gd^Fmw      , Gd^Fmw      , Gg          , Gd^Fmw      , Gd^Fmw      , Hhd^Fmw     , Gd^Fmw      , Hhd^Fmw     , Hhd^Fmw     
Ms          , Ha^Fda      , Gd^Fmw      , Hhd^Fmw     , Gd^Fmw      , Hhd^Fmw     , Gd^Fmw      , Gd^Fmw      , Gg          , Gd^Fmw      , Gd^Fmw      , Gg          , Gd^Fmw      , Gd^Fmw      , Gg          , Gg          , Gg          , Wwg         , Gd^Fmw      , Wwg^Bw/     , Wwg         , Cv          , Gg          , Gd^Fmw      , Gg          , Gg          , Gd^Fmw      , Kv          , Cv          , Gg          , Gd^Fmw      , Gg          , Gd^Fmw      , Gg          , Gd^Fmw      , Gd^Fmw      , Gd^Fmw      , Gd^Fmw      , Gd^Fmw      , Gg          , Gg          , Gd^Fmw      , Gd^Fmw      , Gd^Fmw      , Hhd^Fmw     , Gd^Fmw      
Ha^Fda      , Ha^Fda      , Gd^Fmw      , Hhd^Fmw     , Hhd^Fmw     , Hhd^Fmw     , Gd^Fmw      , Gd^Fmw      , Gg          , Hhd^Fmw     , Gd^Fmw      , Hhd^Fmw     , Gd^Fmw      , Hhd^Fmw     , Gg          , Gg          , Cv          , Cv          , Gg          , Gd^Fmw      , Gd^Fmw      , Wwg         , Wwg         , Gg          , Gd^Fmw      , Gd^Fmw      , Gd^Fmw      , Gg          , Gd^Fmw      , Gd^Fmw      , Gd^Fmw      , Gd^Fmw      , Gg          , Gg          , Gg          , Gg          , Gg          , Gg          , Gg          , Gd^Fmw      , Gg          , Gd^Fmw      , Gd^Fmw      , Gd^Fmw      , Gd^Fmw      , Gd^Fmw      
Gd^Fmw      , Gd^Fmw      , Hhd^Fmw     , Hhd^Fmw     , Hhd^Fmw     , Gd^Fmw      , Gd^Fmw      , Gd^Fmw      , Gd^Fmw      , Gg          , Gg          , Gg          , Gg          , Gd^Fmw      , Cv          , Gg          , Gg          , Gg          , Gd^Fmw      , Gg          , Gg          , Gd^Fmw      , Wwg         , Gg          , Gg          , Gd^Fmw      , Gg          , Gg^Ve       , Gd^Fmw      , Gd^Fmw      , Gs^Fdw      , Gd^Fmw      , Gd^Fmw      , Gd^Fmw      , Gd^Fmw      , Gg^Ve       , Gg          , Gg          , Gd^Fmw      , Gg          , Gg          , Gd^Fmw      , Gd^Fmw      , Gd^Fmw      , Gg^Ve       , Gd^Fmw      
Gd^Fmw      , Hhd^Fmw     , Hhd^Fmw     , Hhd^Fmw     , Gd^Fmw      , Gs^Fdw      , Gd^Fmw      , Gd^Fmw      , Gd^Fmw      , Gd^Fmw      , Gg          , Gd^Fmw      , Gd^Fmw      , Gg          , Kv          , Gg          , Gg^Ve       , Gg          , Gg          , Gg          , Gg          , Gd^Fmw      , Wwg         , Aa          , Gd^Fmw      , Gg          , Gg          , Gd^Fmw      , Gd^Fmw      , Gd^Fmw      , Gd^Fmw      , Gd^Fmw      , Gd^Fmw      , Gd^Fmw      , Gg          , Gg          , Gg          , Gd^Fmw      , Gg          , Gg          , Gd^Fmw      , Gg          , Gd^Fmw      , Gd^Fmw      , Gd^Fmw      , Gd^Fmw      
Ha^Fda      , Hhd^Fmw     , Hhd^Fmw     , Gd^Fmw      , Gd^Fmw      , Gd^Fmw      , Gd^Fmw      , Gd^Fmw      , Gg          , Gg          , Gg          , Gg          , Gg          , Gg          , Cv          , Gg          , Gd^Fmw      , Gg          , Gd^Fmw      , Cv          , Gd^Fmw      , Aa^Fma      , Ai          , Aa^Fma      , Hhd^Fmw     , Gd^Fmw      , Gg          , Gd^Fmw      , Gg          , Hhd^Fmw     , Hhd^Fmw     , Gg          , Gg          , Cv          , Gg          , Gg          , Gd^Fmw      , Gd^Fmw      , Gd^Fmw      , Gd^Fmw      , Gd^Fmw      , Gg          , Gd^Fmw      , Gd^Fmw      , Hhd^Fmw     , Gd^Fmw      
Ha^Fda      , Ha^Fda      , Ha^Fda      , Hhd^Fmw     , Gd^Fmw      , Gd^Fmw      , Gg          , Gd^Fmw      , Gg          , Gg          , Gg          , Gg          , Gg          , Gg          , Gd^Fmw      , Gg          , Gg          , Gg          , Gd^Fmw      , Cv          , Kv          , Gd^Fmw      , Wwg^Bw\     , Aa^Fma      , Cv          , Gd^Fmw      , Gg          , Gg          , Gg          , Gg          , Gg          , Gg          , Gg          , Kv          , Gg          , Gg          , Gg          , Gg          , Gg          , Gg          , Gg          , Gg          , Gd^Fmw      , Hhd^Fmw     , Hhd^Fmw     , Gd^Fmw      
Ms          , Ha^Fda      , Ha^Fda      , Hhd^Fmw     , Gd^Fmw      , Gd^Fmw      , Gg          , Gg^Ve       , Gd^Fmw      , Gg          , Gg          , Gg          , Gd^Fmw      , Gg          , Gd^Fmw      , Gd^Fmw      , Gg          , Gd^Fmw      , Cv          , Cv          , Gd^Fmw      , Cv          , Wwg         , Aa          , Cv          , Cv          , Gd^Fmw      , Gg          , Gg          , Gg          , Gg          , Gg          , Gg          , Cv          , Gg          , Gg          , Gd^Fmw      , Gd^Fmw      , Gd^Fmw      , Gd^Fmw      , Gg^Ve       , Gd^Fmw      , Gd^Fmw      , Gd^Fmw      , Hhd^Fmw     , Hhd^Fmw     
Ms          , Ms          , Ha^Fda      , Hhd^Fmw     , Gd^Fmw      , Gd^Fmw      , Gd^Fmw      , Gg          , Gg          , Gd^Fmw      , Gd^Fmw      , Gg          , Gg          , Gg          , Cv          , Gs^Fdw      , Gd^Fmw      , Gg          , Gg          , Cv          , Wwg         , Wwg         , Hhd^Fmw     , Wwg         , 1 Cv        , 2 Kv        , Cv          , Gg          , Gd^Fmw      , Gd^Fmw      , Hhd^Fmw     , Gg          , Gd^Fmw      , Cv          , Gg          , Gd^Fmw      , Gg          , Gd^Fmw      , Gd^Fmw      , Gs^Fdw      , Gd^Fmw      , Gg          , Gd^Fmw      , Gd^Fmw      , Gd^Fmw      , Hhd^Fmw     
Ms          , Ha^Fda      , Ha^Fda      , Hhd^Fmw     , Gd^Fmw      , Gd^Fmw      , Gd^Fmw      , Gd^Fmw      , Gd^Fmw      , Gg          , Gg          , Gd^Fmw      , Gg          , Gg          , Cv          , Gd^Fmw      , Hhd^Fmw     , Gg          , Wwg^Bw|     , Wwg         , Cv          , Gd^Fmw      , Gd^Fmw      , Wwg         , Gg          , Cv          , Gg          , Gd^Fmw      , Gd^Fmw      , Hhd^Fmw     , Hhd^Fmw     , Gg          , Gd^Fmw      , Gg          , Gd^Fmw      , Gg          , Gg          , Gg          , Gg          , Gd^Fmw      , Gg          , Gg          , Gd^Fmw      , Gd^Fmw      , Gd^Fmw      , Gd^Fmw      
Ms          , Ha^Fda      , Gd^Fmw      , Hhd^Fmw     , Hhd^Fmw     , Gd^Fmw      , Gd^Fmw      , Gd^Fmw      , Gd^Fmw      , Gd^Fmw      , Gd^Fmw      , Gg          , Wwg^Bw\     , Wwg         , Wwg         , Aa^Fma      , Wwg         , Wwg         , Gg          , Gd^Fmw      , Kv          , Cv          , Cv          , Wwg^Bsb/    , Gg          , Gg          , Gg          , Gg          , Gg          , Gd^Fmw      , Gg          , Gg          , Gg^Ve       , Gd^Fmw      , Gg          , Hhd^Fmw     , Gd^Fmw      , Gg          , Gg          , Gg          , Gg          , Gg          , Gd^Fmw      , Gd^Fmw      , Gd^Fmw      , Gd^Fmw      
Ha^Fda      , Ha^Fda      , Gd^Fmw      , Hhd^Fmw     , Gs^Fdw      , Hhd^Fmw     , Gd^Fmw      , Gd^Fmw      , Gd^Fmw      , Gg          , Wwg         , Wwg         , Gg          , Gg          , Gg          , Wwg         , Gd^Fmw      , Gg          , Gg          , Gg          , Cv          , Cv          , Cv          , Wwg         , Gd^Fmw      , Gd^Fmw      , Gd^Fmw      , Gg          , Gg          , Gg          , Gg          , Gg          , Cv          , Gg          , Gg          , Gg          , Gg          , Gg          , Gd^Fmw      , Gd^Fmw      , Gg          , Gg          , Gd^Fmw      , Gd^Fmw      , Gd^Fmw      , Hhd^Fmw     
Ha^Fda      , Ha^Fda      , Gd^Fmw      , Hhd^Fmw     , Hhd^Fmw     , Gd^Fmw      , Gd^Fmw      , Gd^Fmw      , Wwg         , Wwg         , Gg          , Gd^Fmw      , Gg          , Gd^Fmw      , Gg          , Gg          , Gg          , Cv          , Cv          , Gg          , Gg          , Gd^Fmw      , Gd^Fmw      , Wwg         , Wwg         , Gs^Fdw      , Gg          , Gg          , Gg          , Gg          , Gg          , Cv          , Gg          , Gg          , Gg          , Gg          , Gg          , Gg          , Gs^Fdw      , Hhd^Fmw     , Gg^Ve       , Gd^Fmw      , Gd^Fmw      , Gd^Fmw      , Hhd^Fmw     , Gd^Fmw      
Hhd^Fmw     , Gd^Fmw      , Gd^Fmw      , Gd^Fmw      , Hhd^Fmw     , Hhd^Fmw     , Wwg         , Wwg         , Gd^Fmw      , Gd^Fmw      , Gg          , Gg          , Gd^Fmw      , Gg          , Gg          , Gg          , Gd^Fmw      , Gg          , Gg          , Gg          , Gg          , Gg          , Gg          , Gd^Fmw      , Gg          , Wwg^Bw/     , Gg^Ve       , Gg          , Gg          , Gg          , Gg          , Gg          , Gg          , Gg          , Gg          , Gg          , Gg          , Gg          , Gd^Fmw      , Hhd^Fmw     , Gg          , Gd^Fmw      , Gd^Fmw      , Gd^Fmw      , Hhd^Fmw     , Hhd^Fmw     
Gd^Fmw      , Hhd^Fmw     , Wwg         , Wwg         , Wwg         , Wwg         , Gd^Fmw      , Gd^Fmw      , Gd^Fmw      , Gd^Fmw      , Gg          , Gg          , Gg          , Gd^Fmw      , Gd^Fmw      , Gg          , Gg          , Gg          , Gg^Ve       , Gg          , Gd^Fmw      , Gg          , Gg          , Gd^Fmw      , Gg          , Wwg         , Wwg         , Gg          , Gg          , Gg          , Cv          , Gg          , Gg          , Gg          , Gg          , Gg          , Gg          , Gg          , Gg          , Gd^Fmw      , Gg          , Gd^Fmw      , Gg          , Hhd^Fmw     , Hhd^Fmw     , Ha^Fda      
Wwg         , Wwg         , Gd^Fmw      , Gd^Fmw      , Gd^Fmw      , Gs^Fdw      , Gs^Fdw      , Gd^Fmw      , Gd^Fmw      , Gd^Fmw      , Gd^Fmw      , Gg          , Gg          , Gg          , Gg          , Gg          , Gg          , Gg          , Gg          , Cv          , Gd^Fmw      , Gd^Fmw      , Hhd^Fmw     , Gg          , Cv          , Gd^Fmw      , Wwg         , Gg          , Cv          , Kv          , Gg          , Gg          , Gs^Fdw      , Gd^Fmw      , Gg          , Gg          , Gg          , Gd^Fmw      , Gg          , Gg          , Gg          , Gd^Fmw      , Gg          , Gd^Fmw      , Ha^Fda      , Ha^Fda      
Gd^Fmw      , Gd^Fmw      , Gd^Fmw      , Gs^Fdw      , Gd^Fmw      , Gs^Fdw      , Gg^Ve       , Gd^Fmw      , Gd^Fmw      , Gd^Fmw      , Gd^Fmw      , Gd^Fmw      , Gd^Fmw      , Gg          , Gg          , Gg          , Gg          , Gg          , Gg          , Gg          , Gg          , Hhd^Fmw     , Gd^Fmw      , Gd^Fmw      , Gg          , Gg          , Wwg         , Gd^Fmw      , Gd^Fmw      , Gg          , Gg          , Gd^Fmw      , Gg          , Gg          , Gg          , Gg          , Gg          , Gd^Fmw      , Gg          , Gg          , Gg          , Gg          , Gd^Fmw      , Gd^Fmw      , Ha^Fda      , Ha^Fda      
Gd^Fmw      , Gd^Fmw      , Gd^Fmw      , Gd^Fmw      , Gd^Fmw      , Gs^Fdw      , Gd^Fmw      , Gs^Fdw      , Gd^Fmw      , Gd^Fmw      , Gd^Fmw      , Gd^Fmw      , Gd^Fmw      , Gd^Fmw      , Gd^Fmw      , Gd^Fmw      , Gd^Fmw      , Gg          , Gg          , Gg          , Gg          , Gg          , Gg          , Cv          , Cv          , Wwg         , Gd^Fmw      , Gg          , Gg          , Gg          , Gg          , Gg          , Gg          , Gg          , Gg          , Gg          , Gg          , Gg          , Gg          , Gg          , Gg          , Gd^Fmw      , Gd^Fmw      , Gd^Fmw      , Ha^Fda      , Ha^Fda      
Ha^Fda      , Gd^Fmw      , Gd^Fmw      , Hhd^Fmw     , Hhd^Fmw     , Gd^Fmw      , Gs^Fdw      , Gd^Fmw      , Gd^Fmw      , Gd^Fmw      , Hhd^Fmw     , Gd^Fmw      , Gd^Fmw      , Gd^Fmw      , Gd^Fmw      , Gd^Fmw      , Gg^Ve       , Gd^Fmw      , Gd^Fmw      , Gg          , Gd^Fmw      , Gd^Fmw      , Gd^Fmw      , Gg          , Gg          , Wwg         , Gd^Fmw      , Gg          , Gg          , Gd^Fmw      , Gg          , Gd^Fmw      , Gs^Fdw      , Gd^Fmw      , Gs^Fdw      , Gd^Fmw      , Gg^Ve       , Gg          , Gg          , Gg          , Gd^Fmw      , Gs^Fdw      , Gd^Fmw      , Gd^Fmw      , Ha^Fda      , Ha^Fda      
Ha^Fda      , Ha^Fda      , Ha^Fda      , Gd^Fmw      , Gd^Fmw      , Hhd^Fmw     , Gs^Fdw      , Gd^Fmw      , Gd^Fmw      , Hhd^Fmw     , Hhd^Fmw     , Hhd^Fmw     , Hhd^Fmw     , Gd^Fmw      , Gd^Fmw      , Gd^Fmw      , Gd^Fmw      , Gd^Fmw      , Gd^Fmw      , Gd^Fmw      , Gd^Fmw      , Gd^Fmw      , Gd^Fmw      , Gd^Fmw      , Gd^Fmw      , Wwg^Bw/     , Wwg         , Gg          , Gg          , Gg          , Gg          , Gg          , Gg          , Gg          , Gg          , Gg          , Gg          , Gg          , Gd^Fmw      , Gg          , Gd^Fmw      , Gd^Fmw      , Aa^Vea      , Ha^Fda      , Ha^Fda      , Ha^Fda      
Ms          , Ha^Fda      , Ha^Fda      , Gd^Fmw      , Gs^Fdw      , Gd^Fmw      , Gd^Fmw      , Gs^Fdw      , Gs^Fdw      , Gd^Fmw      , Co          , Co          , Co          , Co          , Hhd^Fmw     , Hhd^Fmw     , Hhd^Fmw     , Gd^Fmw      , Gd^Fmw      , Gd^Fmw      , Gs^Fdw      , Gd^Fmw      , Gd^Fmw      , Gd^Fmw      , Gd^Fmw      , Gd^Fmw      , Wwg         , Gg          , Gd^Fmw      , Gd^Fmw      , Gd^Fmw      , Gd^Fmw      , Gg          , Gd^Fmw      , Gg          , Gd^Fmw      , Gg          , Gg          , Gg          , Gg          , Gd^Fmw      , Ha^Fda      , Ha^Fda      , Ha^Fda      , Ms          , Ha^Fda      
Ms          , Ha^Fda      , Ha^Fda      , Ha^Fda      , Ha^Fda      , Ha^Fda      , Gs^Fdw      , Gs^Fdw      , Gd^Fmw      , Gs^Fdw      , Co          , Co          , 4 Ko        , Co          , Hhd^Fmw     , Hhd^Fmw     , Gd^Fmw      , Gd^Fmw      , Gd^Fmw      , Hhd^Fmw     , Gd^Fmw      , Gd^Fmw      , Gd^Fmw      , Gd^Fmw      , Gd^Fmw      , Wwg         , Gd^Fmw      , Gd^Fmw      , Gd^Fmw      , Gd^Fmw      , Gd^Fmw      , Gg^Ve       , Gd^Fmw      , Gg          , Gd^Fmw      , Gg          , Gd^Fmw      , Gd^Fmw      , Gd^Fmw      , Gd^Fmw      , Ha^Fda      , Ha^Fda      , Ha^Fda      , Ha^Fda      , Ms          , Ms          
Ms          , Ms          , Ha^Fda      , Ha^Fda      , Ha^Fda      , Ha^Fda      , Ha^Fda      , Ha^Fda      , Ha^Fda      , Gd^Fmw      , Gd^Fmw      , Co          , Co          , Co          , Gd^Fmw      , Gd^Fmw      , Ha^Fda      , Ha^Fda      , Ha^Fda      , Ha^Fda      , Ha^Fda      , Gd^Fmw      , Ha^Fda      , Gd^Fmw      , Gd^Fmw      , Wwg         , Ai          , Gd^Fmw      , Gd^Fmw      , Gd^Fmw      , Hhd^Fmw     , Gd^Fmw      , Gd^Fmw      , Gd^Fmw      , Gd^Fmw      , Gd^Fmw      , Ha^Fda      , Ha^Fda      , Ha^Fda      , Ha^Fda      , Ha^Fda      , Ha^Fda      , Ha^Fda      , Ms          , Ms          , Ms          
Ms          , Ms          , Ha^Fda      , Ha^Fda      , Ha^Fda      , Ha^Fda      , Ha^Fda      , Ha^Fda      , Ha^Fda      , Gd^Fmw      , Hhd^Fmw     , Hhd^Fmw     , Hhd^Fmw     , Gd^Fmw      , Gd^Fmw      , Ha^Fda      , Ha^Fda      , Ha^Fda      , Ms          , Ms          , Ms          , Ha^Fda      , Ha^Fda      , Ha^Fda      , Ha^Fda      , Ha^Fda      , Ai          , Ha^Fda      , Ha^Fda      , Hhd^Fmw     , Ha^Fda      , Ha^Fda      , Ha^Fda      , Ha^Fda      , Ha^Fda      , Ha^Fda      , Ha^Fda      , Ha^Fda      , Ha^Fda      , Ms          , Ms          , Ms          , Ms          , Ms          , Ms          , Ms          
