border_size=1
usage=map

Md^Xm       , Md^Xm       , Md^Xm       , Md^Xm       , Md^Xm       , Md^Xm       , Md^Xm       , Md^Xm       , Md^Xm       , Md^Xm       , Md^Xm       , Md^Xm       , Md^Xm       , Md^Xm       , Md^Xm       , Md^Xm       , Md^Xm       , Md^Xm       , Md^Xm       , Md^Xm       , Md^Xm       , Md^Xm       , Md^Xm       , Md^Xm       , Md^Xm       , Md^Xm       , Md^Xm       , Md^Xm       , Md^Xm       , Md^Xm       , Md^Xm       , Md^Xm       , Md^Xm       , Md^Xm       , Md^Xm       , Md^Xm       , Md^Xm       , Md^Xm       , Md^Xm       , Md^Xm       , Md          , Md          , Uh          , Uh          , Zwsl        , Zwsl        , Zwsl        , Zwsl        , Uh          , Uh          , Uh          , Md          , Md          , Md          , Md^Xm       , Md^Xm       , Md^Xm       , Md^Xm       
Md^Xm       , Md^Xm       , Md^Xm       , Md^Xm       , Md^Xm       , Md^Xm       , Md^Xm       , Md^Xm       , Md^Xm       , Md^Xm       , Uh          , Md^Xm       , Md^Xm       , Md^Xm       , Md^Xm       , Md^Xm       , Md^Xm       , Md^Xm       , Md^Xm       , Md^Xm       , Md^Xm       , Md^Xm       , Md^Xm       , Md^Xm       , Md^Xm       , Md^Xm       , Md^Xm       , Md^Xm       , Md^Xm       , Md^Xm       , Md^Xm       , Md^Xm       , Md^Xm       , Md^Xm       , Md^Xm       , Md^Xm       , Md^Xm       , Md^Xm       , Md^Xm       , Md^Xm       , Md          , Md          , Uh          , Uh          , Zwsl        , Zwsl        , Zvw         , Zvw         , Uh          , Uh          , Md          , Md          , Md          , Md^Xm       , Md^Xm       , Md^Xm       , Md^Xm       , Md^Xm       
Md^Xm       , Md^Xm       , Md^Xm       , Md^Xm       , Md^Xm       , Md^Xm       , Md^Xm       , Md^Xm       , Md^Xm       , Qxua        , Md^Xm       , Uh          , Uh          , Md          , Md          , Md^Xm       , Md          , Md          , Md          , Md^Xm       , Md          , Md^Xm       , Md^Xm       , Md^Xm       , Md^Xm       , Mv          , Md^Xm       , Md^Xm       , Md^Xm       , Md^Xm       , Md^Xm       , Md^Xm       , Md^Xm       , Md^Xm       , Md^Xm       , Md^Xm       , Md^Xm       , Md^Xm       , Md^Xm       , Md          , Md          , Md          , Uh          , Zwsl        , Zvw         , Zvw         , Zwsl^Vzps    , Zwsl        , Uh          , Md          , Md          , Md          , Md^Xm       , Md^Xm       , Md^Xm       , Md^Xm       , Md^Xm       , Md^Xm       
Md^Xm       , Md^Xm       , Md^Xm       , Md^Xm       , Md^Xm       , Md^Xm       , Md^Xm       , Md^Xm       , Md^Xm       , Md^Xm       , Md^Xm       , Md^Xm       , Md^Xm       , Md          , Md          , Md          , Uh          , Md          , Md          , Md          , Md          , Md          , Md          , Md^Xm       , Qlf         , Qlf         , Md^Xm       , Md^Xm       , Md^Xm       , Md^Xm       , Md^Xm       , Md^Xm       , Md^Xm       , Md^Xm       , Md^Xm       , Md^Xm       , Md^Xm       , Md^Xm       , Md^Xm       , Md          , Md          , Uh          , Uh          , Zvw         , Zwsl        , Zwsl        , Uh          , Uh          , Uh          , Md          , Md          , Md^Xm       , Md^Xm       , Md^Xm       , Md^Xm       , Md^Xm       , Md^Xm       , Md^Xm       
Md^Xm       , Md^Xm       , Md^Xm       , Md^Xm       , Md^Xm       , Md^Xm       , Md^Xm       , Md^Xm       , Md          , Md^Xm       , Md          , Md          , Md          , Md          , Uh          , Uh          , Uh          , Uh          , Uh          , Md          , Uh          , Md          , Md          , Md          , Qlf         , Md^Xm       , Md^Xm       , Md^Xm       , Md^Xm       , Md^Xm       , Md^Xm       , Md^Xm       , Md^Xm       , Md^Xm       , Md^Xm       , Md^Xm       , Md^Xm       , Md^Xm       , Md          , Md          , Md          , Uh          , Uh          , Zvw         , Zwsl        , Zvw         , Uh          , Uh          , Md          , Md          , Md          , Md^Xm       , Md^Xm       , Md^Xm       , Md^Xm       , Md^Xm       , Qxua        , Qxua        
Md^Xm       , Md^Xm       , Md^Xm       , Md^Xm       , Md^Xm       , Md^Xm       , Md^Xm       , Md^Xm       , Md          , Md          , Md          , Md          , Uh          , Uh          , Uh          , Chr         , Chr         , Chr         , Uh          , Uh          , Uh          , Uh          , Qlf         , Qlf         , Md          , Md          , Md          , Md^Xm       , Md^Xm       , Md^Xm       , Md^Xm       , Md^Xm       , Md          , Md          , Md          , Md          , Md          , Md          , Md          , Md          , Uh          , Uh          , Zvw         , Zvw         , Zwsl        , Zvw         , Uh          , Uh          , Uh          , Md          , Md          , Md          , Md          , Md^Xm       , Md^Xm       , Qxua        , Qxua        , Qxua        
Md^Xm       , Md^Xm       , Md^Xm       , Md^Xm       , Md^Xm       , Md^Xm       , Md          , Md          , Uh          , Md          , Md          , Uh          , Uh          , Uh          , Uh          , Chr         , 2 Khr       , Chr         , Chr         , Uh          , Zwsl        , Uh          , Qlf         , Uh          , Uh          , Md          , Md          , Md          , Md          , Md          , Md          , Md          , Md          , Md          , Md          , Md          , Md          , Md          , Uh          , Uh          , Uh          , Uh          , Zwsl        , Zvw         , Zwsl        , Zwsl        , Zwsl        , Uh          , Uh          , Uh          , Md          , Md          , Md          , Md          , Qxua        , Qxua        , Qxua        , Qxua        
Md^Xm       , Md^Xm       , Md^Xm       , Md^Xm       , Md^Xm       , Md          , Md          , Uh          , Uh          , Uh          , Uh          , Uh          , Uh          , Uh          , Chr         , Chr         , Chr         , Chr         , Chr         , Zwsl        , Zvw         , Zvw         , Qlf         , Uh          , Uh          , Uh          , Uh          , Md          , Md          , Md          , Md          , Md          , Uh          , Uh          , Uh          , Uh          , Uh          , Uh          , Uh          , Zwsl        , Zwsl        , Zvw         , Zwsl        , Zwsl        , Zvw         , Zwsl        , Zwsl        , Zwsl        , Zwsl        , Uh          , Uh          , Md          , Md          , Md          , Qxua        , Qxua        , Qxua        , Qxua        
Md^Xm       , Md^Xm       , Md^Xm       , Md^Xm       , Md          , Md          , Uh          , Uh          , Uh          , Zwsl        , Zwsl        , Uh          , Zwsl^Br/    , Zwsl^Br/    , Zwsl        , Chr         , Chr         , Chr         , Chr         , Zvw         , Zwsl        , Qlf         , Zwsl        , Zvw         , Zvw         , Uh          , Uh          , Uh          , Uh          , Uh          , Uh          , Uh          , Uh          , Uh          , Zwsl        , Uh          , Zwsl        , Zwsl        , Zwsl        , Zwsl        , Zwsl        , Zwsl        , Zwsl^Vzps    , Zvw         , Zvw         , Zvw         , Zvw         , Zwsl        , Zwsl        , Zwsl        , Uh          , Uh          , Uh          , Md          , Qxua        , Qxua        , Qxua        , Qxua        
Md^Xm       , Md^Xm       , Md          , Md          , Md          , Uh          , Uh          , Uh          , Zvw         , Zwsl        , Zwsl^Br|    , Zwsl^Br/    , Zwsl        , Zwsl        , Uh          , Uh          , Uh          , Uh          , Zvw         , Zvw         , Zvw         , Qlf^Bs\     , Zvw         , Zvw         , Zvw         , Zvw         , Zwsl        , Uh          , Zvw         , Uh          , Zwsl        , Uh          , Zwsl        , Zwsl        , Zwsl        , Zwsl        , Zwsl        , Zwsl        , Zwsl        , Zwsl        , Zwsl        , Zwsl        , Zwsl        , Zwsl        , Zwsl        , Zwsl        , Uh          , Zvw         , Zwsl        , Zvw         , Zvw         , Uh          , Uh          , Uh          , Qxua        , Qxua        , Qxua        , Qxua        
Md          , Md          , Md          , Md          , Uh          , Uh          , Uh          , Uh          , Zvw         , Zwsl        , Zwsl^Br|    , Zwsl        , Uh          , Uh          , Md          , Md          , Uh          , Uh          , Zwsl        , Zvw         , Zvw         , Qlf         , Qlf         , Zvw         , Zwsl        , Zwsl^Vzps    , Zwsl        , Zvw         , Zwsl        , Zwsl        , Zwsl        , Zwsl        , Zwsl        , Zwsl        , Zwsl        , Zwsl        , Zvw         , Zwsl        , Zwsl        , Zwsl        , Zwsl        , Zwsl        , Zwsl        , Zwsl        , Zvw         , Uh          , Uh          , Uh          , Zwsl        , Zwsl        , Zvw         , Uh          , Uh          , Qxua        , Qxua        , Qxua        , Qxua        , Qxua        
Md          , Md          , Uh          , Uh          , Uh          , Uh          , Uh          , Uh          , Zwsl        , Zwsl        , Zwsl^Br|    , Zwsl        , Zwsl        , Uh          , Uh          , Uh          , Zwsl        , Zvw         , Zwsl        , Zwsl^Vzps    , Zvw         , Zvw         , Qlf         , Zvw         , Zvw         , Zwsl        , Uh          , Zwsl        , Zwsl        , Zwsl        , Zwsl        , Zwsl        , Zwsl        , Zwsl^Vzps    , Zwsl        , Zvw         , Uh          , Uh          , Uh          , Zwsl        , Zwsl        , Zwsl        , Zwsl        , Zvw         , Zvw         , Uh          , Uh          , Uh          , Zwsl        , Zwsl        , Zvw         , Zvw         , Qxua        , Qxua        , Qxua        , Qxua        , Qxua        , Qxua        
Uh          , Uh          , Uh          , Uh          , Uh          , Uh          , Zwsl        , Zwsl        , Zvw         , Zwsl        , Zvw         , Zwsl^Br\    , Zwsl^Br\    , Zvw         , Zvw         , Uh          , Zwsl        , Zwsl        , Zwsl        , Zvw         , Zvw         , Qlf         , Zvw         , Zvw         , Zvw         , Uh          , Md          , Uh          , Uh          , Zwsl        , Zvw         , Zwsl        , Zwsl        , Zwsl        , Zwsl        , Zwsl        , Uh          , Uh          , Zwsl        , Zwsl        , Zwsl        , Zwsl^Vzps    , Zwsl        , Zwsl        , Zwsl        , Zwsl        , Zwsl        , Uh          , Zwsl        , Zwsl        , Zvw         , Zvw         , Qxua        , Qxua        , Qxua        , Qxua        , Qxua        , Qxua        
Uh          , Uh          , Zwsl        , Uh          , Zwsl        , Zwsl        , Zwsl        , Zwsl        , Zvw         , Zwsl        , Zvw         , Zvw         , Zvw         , Zwsl^Br\    , Zwsl^Br\    , Zvw         , Zwsl        , Zwsl        , Zvw         , Zvw         , Zvw         , Qlf         , Qlf         , Zvw         , Zvw         , Uh          , Uh          , Uh^Vzps      , Zwsl        , Zwsl        , Zwsl        , Zvw         , Zvw         , Zwsl        , Zwsl        , Uh          , Uh          , Uh          , Zvw         , Zvw         , Zvw         , Zwsl        , Zvw         , Zvw         , Zwsl        , Zwsl        , Zwsl        , Zwsl        , Zvw         , Zwsl        , Zwsl        , Zvw         , Qxua        , Qxua        , Qxua        , Qxua        , Qxua        , Qxua        
Zwsl        , Zvw         , Zvw         , Zwsl        , Zwsl        , Zwsl        , Zwsl        , Zvw^Vzps     , Zwsl        , Zwsl        , Zwsl        , Zvw         , Zwsl        , Zwsl        , Zwsl        , Zwsl^Br\    , Zwsl^Br\    , Zwsl        , Zvw         , Zwsl        , Zwsl        , Zvw         , Zvw         , Qlf         , Qlf^Bs/     , Zwsl        , Zvw         , Zvw         , Zvw         , Zwsl        , Zvw         , Zvw         , Zvw         , Zvw         , Zvw         , Zwsl        , Zvw         , Zwsl        , Zwsl        , Zvw         , Zwsl        , Zvw         , Zwsl        , Zwsl        , Zwsl        , Zwsl        , Zwsl        , Zvw         , Zwsl        , Zwsl^Vzps    , Zwsl        , Qxua        , Qxua        , Qxua        , Qxua        , Qxua        , Qxua        , Qxua        
Zwsl        , Zwsl        , Zwsl        , Zwsl        , Zwsl        , Zwsl        , Zwsl        , Zvw         , Uh          , Zwsl        , Zvw         , Zwsl        , Zvw         , Zvw         , Zwsl        , Zwsl        , Zwsl        , Zwsl^Br\    , Zwsl^Br\    , Zvw         , Zwsl        , Zwsl        , Zwsl        , Zvw         , Zwsl        , Qlf         , Qlf         , Zvw         , Zvw         , Zvw         , Qlf         , Zvw         , Zvw         , Zvw         , Zvw         , Zvw         , Zvw         , Zwsl        , Zwsl        , Zwsl        , Zvw         , Zwsl        , Zvw         , Zwsl        , Zwsl        , Zwsl        , Zwsl        , Zwsl        , Zwsl        , Zwsl        , Zwsl        , Qxua        , Qxua        , Qxua        , Qxua        , Qxua        , Qxua        , Qxua        
Zwsl        , Zwsl        , Zwsl        , Zvw         , Zwsl        , Zwsl        , Zwsl        , Uh          , Uh          , Uh          , Uh          , Zvw         , Zwsl        , Zwsl        , Zwsl        , Zvw         , Zwsl        , Zvw         , Zvw         , Zwsl^Br\    , Zvw^Br|     , Zwsl        , Zvw         , Zwsl        , Zvw         , Zvw         , Zvw         , Qlf         , Qlf         , Qlf         , Qlf         , Qlf         , Qlf         , Zvw         , Zvw         , Zvw         , Zwsl        , Zvw         , Zvw         , Zwsl^Vzps    , Zvw         , Zvw         , Zvw         , Zvw         , Zvw         , Zvw         , Zvw         , Zvw         , Zvw         , Zvw         , Qxua        , Qxua        , Qxua        , Qxua        , Qxua        , Qxua        , Qxua        , Qxua        
Zwsl        , Zwsl        , Zwsl        , 1 Zvw       , Zwsl        , Zwsl        , Uh          , Uh          , Uh          , Md          , Uh          , Uh          , Zwsl        , Zwsl        , Zwsl        , Zwsl        , Zvw         , Zwsl        , Zwsl        , Zvw         , Zvw^Br|     , Zvw         , Zvw         , Zvw         , Zwsl        , Zvw         , Zvw         , Qlf         , Qlf         , Qlf         , Qlf         , Qlf         , Qlf         , Zvw         , Zvw         , Zvw         , Zvw         , Zvw         , Zvw         , Zwsl        , Zwsl        , Zvw         , Zwsl        , Zvw         , Zwsl        , Zvw         , Zwsl        , Zvw         , Zwsl        , Zwsl        , Zwsl        , Qxua        , Qxua        , Qxua        , Qxua        , Qxua        , Qxua        , Qxua        
Zwsl        , Zwsl        , Zwsl        , Zvw         , Zvw         , Zwsl        , Zwsl        , Uh          , Zwsl        , Uh          , Zwsl        , Uh          , Zwsl        , Zwsl        , Zwsl        , Zwsl        , Zwsl        , Zwsl        , Zwsl        , Zwsl        , Zwsl        , Zwsl^Br\    , Zwsl^Br\    , Zwsl        , Zwsl        , Zwsl^Vzps    , Zvw         , Zvw         , Qxua        , Qlf         , Qlf         , Qlf         , Qlf         , Zvw         , Zvw         , Zvw         , Zvw         , Zvw         , Zwsl        , Zwsl        , Zwsl        , Zwsl        , Zwsl        , Zwsl        , Zwsl        , Zvw         , Chr         , Chr         , Chr         , Zwsl        , Zwsl        , Zvw         , Zvw         , Qxua        , Qxua        , Qxua        , Qxua        , Qxua        
Zwsl        , Zwsl        , Zvw         , Zwsl^Vzps    , Zvw         , Zvw         , Zwsl        , Zwsl        , Zwsl        , Zwsl        , Zwsl        , Zwsl        , Zwsl        , Zwsl        , Zwsl        , Zwsl^Vzps    , Zwsl        , Zwsl        , Zwsl        , Zwsl        , Zwsl        , Zvw         , Zwsl        , Zwsl^Br\    , Zvw^Br\     , Zwsl        , Zwsl        , Zvw         , Qxua        , Qxua        , Qxua        , Qlf         , Qlf         , Zvw         , Zvw         , Zwsl        , Zwsl        , Zwsl        , Zwsl        , Zwsl        , Zwsl        , Zwsl        , Zvw         , Zwsl        , Zwsl        , Chr         , Chr         , Chr         , 4 Khr       , Chr         , Zwsl        , Zwsl        , Zvw         , Zwsl        , Zwsl        , Qxua        , Qxua        , Qxua        
Zwsl        , Zvw         , Zwsl        , Zvw         , Zvw         , Zvw         , Zvw         , Zvw         , Zvw         , Zwsl        , Zwsl        , Zwsl        , Zwsl        , Zvw         , Zvw         , Zvw         , Zvw         , Zvw         , Zvw         , Zwsl        , Zwsl        , Zwsl        , Uh          , Zvw         , Uh          , Zwsl^Br\    , Zwsl^Br\    , Zwsl        , Zvw         , Qxua        , Qxua        , Qxua        , Zvw         , Zvw         , Zvw         , Zvw         , Zwsl        , Zwsl^Vzps    , Zvw         , Zwsl        , Zwsl        , Zvw         , Zwsl        , Zvw         , Zvw         , Zwsl        , Chr         , Chr         , Chr         , Chr         , Zvw         , Zwsl        , Zwsl        , Zwsl        , Zwsl        , Zwsl        , Zwsl        , Qxua        
Qxua        , Zvw         , Zwsl        , Zwsl        , Zwsl        , Zwsl        , Zwsl        , Zwsl        , Zvw         , Zvw         , Zvw         , Zvw         , Zvw         , Zwsl        , Zwsl        , Zvw         , Zwsl        , Zwsl        , Zwsl        , Zwsl        , Zvw         , Uh          , Uh          , Uh          , Uh          , Zwsl        , Zwsl        , Zwsl^Br\    , Zwsl^Br|    , Zwsl        , Zvw         , Zvw         , Zvw         , Zvw         , Zwsl        , Zwsl        , Uh          , Uh          , Uh          , Zvw         , Zvw         , Zwsl        , Zwsl        , Zwsl        , Zwsl        , Zwsl^Br/    , Zwsl        , Chr         , Chr         , Chr         , Zwsl        , Zwsl        , Zwsl^Vzps    , Zwsl        , Zwsl        , Zvw         , Zwsl        , Zwsl        
Qxua        , Qxua        , Zwsl        , Zwsl        , Zvw         , Zwsl        , Zvw         , Zwsl        , Zvw         , Zvw         , Zvw         , Zvw         , Zwsl        , Uh          , Uh          , Zvw         , Zwsl        , Zwsl        , Zwsl        , Zwsl        , Zwsl        , Zvw         , Uh          , Md          , Uh          , Uh          , Zwsl        , Zvw         , Zwsl^Br|    , Zwsl        , Zwsl        , Zwsl        , Zwsl        , Zwsl        , Zwsl        , Uh          , Uh          , Uh          , Md          , Uh          , Zvw         , Zvw         , Zvw         , Zvw         , Zvw         , Zwsl^Br|    , Zvw         , Zwsl        , Zwsl        , Zwsl        , Zwsl        , Zwsl        , Zwsl        , Zwsl        , Zvw         , Zvw         , Zwsl        , Zwsl        
Qxua        , Qxua        , Qxua        , Zvw         , Zwsl        , Zwsl        , Zwsl        , Zwsl        , Zwsl        , Zvw         , Zvw         , Zwsl        , Uh          , Uh          , Uh          , Uh          , Uh          , Zwsl        , Zvw         , Zwsl        , Zwsl        , Zwsl        , Zwsl        , Uh          , Zwsl        , Zwsl        , Zwsl        , Zwsl        , Zwsl^Br|    , Zwsl        , Zwsl        , Zwsl        , Zvw         , Zwsl        , Zwsl^Vzps    , Zwsl        , Uh          , Md          , Uh          , Uh          , Uh          , Uh          , Zvw         , Zvw         , Zwsl^Br/    , Zwsl^Br/    , Zvw         , Zwsl        , Zwsl        , Zwsl        , Zwsl        , Zwsl        , Zvw         , Zvw         , Zwsl        , Zvw         , Zwsl        , Zvw         
Qxua        , Qxua        , Qxua        , Zwsl        , Zvw         , Zvw         , Zvw         , Zwsl        , Zwsl        , Zwsl^Vzps    , Zwsl        , Zwsl        , Uh          , Md          , Uh          , Uh          , Zwsl        , Uh          , Zvw         , Zvw         , Zvw         , Zwsl        , Zvw         , Zvw         , Zvw         , Zvw^Vzps     , Zwsl        , Zvw         , Zwsl^Br|    , Zvw         , Zvw         , Zvw         , Zvw         , Zvw         , Zvw         , Zwsl        , Zwsl        , Uh          , Uh          , Uh          , Zvw         , Zvw         , Zwsl^Br/    , Zwsl^Br/    , Zwsl        , Zvw         , Zwsl        , Zwsl        , Zvw         , Zvw         , Qxua        , Zvw         , Zvw         , Zvw         , Zwsl        , Zvw         , Zvw         , Zvw         
Qxua        , Qxua        , Qxua        , Qxua        , Qxua        , Zwsl        , Zwsl        , Zvw         , Zwsl        , Zwsl        , Zvw         , Uh          , Uh          , Uh          , Uh          , Zwsl        , Zwsl        , Zwsl        , Zvw         , Zvw         , Zvw         , Zvw         , Zvw         , Zvw         , Zvw         , Zvw         , Zwsl        , Zvw         , Zvw^Br|     , Zvw         , Zvw         , Zvw         , Zvw         , Zvw         , Zvw         , Zvw         , Zwsl        , Zvw         , Zvw         , Zvw         , Zwsl^Br/    , Zvw^Br/     , Zwsl        , Zwsl^Vzps    , Zwsl        , Zwsl        , Zwsl        , Zwsl        , Qxua        , Qxua        , Qxua        , Zvw         , Zvw         , Zvw         , Zvw         , Zvw         , Zwsl        , Zvw         
Qxua        , Qxua        , Qxua        , Qxua        , Qxua        , Qxua        , Zwsl        , Zwsl        , Zvw         , Zwsl        , Zwsl        , Zwsl        , Zwsl        , Zvw         , Zvw         , Zwsl        , Zwsl        , Zwsl        , Zwsl        , Zvw         , Zvw         , Zvw         , Zvw         , Zvw         , Zwsl        , Zwsl        , Zwsl        , Zwsl        , Zwsl^Br\    , Zvw         , Zwsl        , Zwsl        , Zwsl        , Zvw         , Zwsl        , Zwsl        , Zwsl        , Zvw         , Zwsl^Br/    , Zwsl^Br/    , Zwsl        , Zwsl        , Zvw         , Zwsl        , Zvw         , Zvw         , Zvw         , Qxua        , Qxua        , Qxua        , Qxua        , Qxua        , Zvw         , Zvw         , Zvw         , Zvw         , Zvw         , Zwsl        
Qxua        , Qxua        , Qxua        , Qxua        , Qxua        , Qxua        , Qxua        , Zvw         , Zvw         , Zvw         , Zvw         , Zwsl        , Zwsl        , Zwsl        , Zwsl        , Zwsl        , Zwsl        , Zvw         , Zwsl        , Zwsl        , Zwsl        , Zvw         , Zwsl        , Zwsl        , Zvw         , Zvw         , Zwsl        , Zwsl        , Zvw         , Zwsl^Br\    , Zwsl^Br\    , Zvw         , Zvw         , Zwsl        , Zwsl        , Zwsl        , Zwsl^Br/    , Zwsl^Br/    , Zvw         , Zwsl        , Zvw         , Zwsl        , Zwsl        , Zvw         , Zwsl        , Zwsl        , Qxua        , Qxua        , Qxua        , Qxua        , Qxua        , Qxua        , Qxua        , Zvw         , Qxua        , Zvw         , Zvw         , Zvw         
Qxua        , Qxua        , Qxua        , Qxua        , Qxua        , Qxua        , Qxua        , Zvw         , Qxua        , Zwsl        , Zwsl        , Zvw         , Zvw         , Zvw         , Zwsl        , Zwsl        , Zwsl        , Zwsl        , Zwsl^Vzps    , Zwsl        , Zwsl        , Zwsl        , Zwsl        , Zvw         , Zvw         , Zvw         , Zwsl        , Zwsl        , Zwsl        , Zvw         , Zvw         , Zwsl^Br\    , Zwsl^Br\    , Zwsl        , Zwsl^Br/    , Zwsl^Br/    , Zwsl        , Zwsl        , Zwsl        , Zwsl        , Zwsl        , Zwsl        , Zwsl        , Zwsl        , Qxua        , Qxua        , Qxua        , Qxua        , Qxua        , Qxua        , Qxua        , Qxua        , Qxua        , Qxua        , Qxua        , Qxua        , Qxua        , Zvw         
Qxua        , Qxua        , Qxua        , Qxua        , Qxua        , Qxua        , Qxua        , Qxua        , Qxua        , Qxua        , Qxua        , Zwsl        , Zwsl        , Zvw         , Zwsl        , Zvw         , Zvw         , Zwsl        , Zvw         , Zwsl        , Zwsl        , Zvw         , Zvw         , Zwsl        , Zwsl        , Zwsl        , Zwsl        , Zwsl^Vzps    , Zwsl        , Zwsl        , Zwsl        , Zwsl        , Zwsl        , Zvw^Br\     , Zvw^Br|     , Zwsl        , Zwsl        , Zwsl        , Zwsl        , Zvw         , Zvw         , Zvw         , Qxua        , Qxua        , Qxua        , Qxua        , Qxua        , Qxua        , Qxua        , Qxua        , Qxua        , Qxua        , Qxua        , Qxua        , Qxua        , Qxua        , Qxua        , Qxua        
Qxua        , Qxua        , Qxua        , Qxua        , Qxua        , Qxua        , Qxua        , Qxua        , Qxua        , Qxua        , Qxua        , Qxua        , Qxua        , Zwsl        , Qxua        , Zwsl        , Zwsl        , Zvw         , Zwsl        , Zvw         , Zvw         , Zvw         , Zvw         , Zwsl        , Zvw         , Zvw         , Zvw         , Zwsl        , Zvw         , Zvw         , Zvw         , Zwsl        , Zwsl        , Zwsl        , Chr         , Zwsl        , Chr         , Zwsl        , Zvw         , Zvw         , Qxua        , Qxua        , Qxua        , Qxua        , Qxua        , Qxua        , Qxua        , Qxua        , Qxua        , Qxua        , Qxua        , Qxua        , Qxua        , Qxua        , Qxua        , Qxua        , Qxua        , Qxua        
Qxua        , Qxua        , Qxua        , Qxua        , Qxua        , Qxua        , Qxua        , Qxua        , Qxua        , Qxua        , Qxua        , Qxua        , Qxua        , Qxua        , Qxua        , Qxua        , Qxua        , Zwsl        , Zwsl        , Zwsl        , Zwsl        , Zwsl        , Zwsl        , Zvw         , Zwsl        , Zwsl        , Zvw         , Zvw         , Zvw         , Zvw         , Zvw         , Zvw         , Chr         , Chr         , Chr         , Chr         , Chr         , Chr         , Qxua        , Zvw         , Qxua        , Qxua        , Qxua        , Qxua        , Qxua        , Qxua        , Qxua        , Qxua        , Qxua        , Qxua        , Qxua        , Qxua        , Qxua        , Qxua        , Qxua        , Qxua        , Qxua        , Qxua        
Qxua        , Qxua        , Qxua        , Qxua        , Qxua        , Qxua        , Qxua        , Qxua        , Qxua        , Qxua        , Qxua        , Qxua        , Qxua        , Qxua        , Qxua        , Qxua        , Qxua        , Qxua        , Qxua        , Zwsl        , Zwsl        , Zwsl        , Qxua        , Zwsl        , Qxua        , Qxua        , Qxua        , Zvw         , Zvw         , Zvw         , Zvw         , Zvw         , Qxua        , Chr         , Qxua        , 3 Khr       , Qxua        , Qxua        , Qxua        , Qxua        , Qxua        , Qxua        , Qxua        , Qxua        , Qxua        , Qxua        , Qxua        , Qxua        , Qxua        , Qxua        , Qxua        , Qxua        , Qxua        , Qxua        , Qxua        , Qxua        , Qxua        , Qxua        
Qxua        , Qxua        , Qxua        , Qxua        , Qxua        , Qxua        , Qxua        , Qxua        , Qxua        , Qxua        , Qxua        , Qxua        , Qxua        , Qxua        , Qxua        , Qxua        , Qxua        , Qxua        , Qxua        , Qxua        , Qxua        , Qxua        , Qxua        , Qxua        , Qxua        , Qxua        , Qxua        , Qxua        , Qxua        , Qxua        , Qxua        , Qxua        , Qxua        , Qxua        , Qxua        , Qxua        , Qxua        , Qxua        , Qxua        , Qxua        , Qxua        , Qxua        , Qxua        , Qxua        , Qxua        , Qxua        , Qxua        , Qxua        , Qxua        , Qxua        , Qxua        , Qxua        , Qxua        , Qxua        , Qxua        , Qxua        , Qxua        , Qxua        
Qxua        , Qxua        , Qxua        , Qxua        , Qxua        , Qxua        , Qxua        , Qxua        , Qxua        , Qxua        , Qxua        , Qxua        , Qxua        , Qxua        , Qxua        , Qxua        , Qxua        , Qxua        , Qxua        , Qxua        , Qxua        , Qxua        , Qxua        , Qxua        , Qxua        , Qxua        , Qxua        , Qxua        , Qxua        , Qxua        , Qxua        , Qxua        , Qxua        , Qxua        , Qxua        , Qxua        , Qxua        , Qxua        , Qxua        , Qxua        , Qxua        , Qxua        , Qxua        , Qxua        , Qxua        , Qxua        , Qxua        , Qxua        , Qxua        , Qxua        , Qxua        , Qxua        , Qxua        , Qxua        , Qxua        , Qxua        , Qxua        , Qxua        
