border_size=1
usage=map

Aa          , Aa          , Aa^Gvs      , Aa^Gvs      , Aa^Gvs      , Aa          , Aa^Gvs      , Aa          , Aa          , Aa          , Aa          , Aa          , Aa^Gvs      , Aa          , Aa          , Aa          , Rrc         , Rrc         , Rrc         , Rrc         , Rrc         , Rrc         , Wwg         , Rrc         , Rrc         , Rrc         , Kha         , Cha         , Kha         , Cha         , Rrc         , Rrc         , Rrc         , Rrc         , Rrc^Vhca    , Cha         , Cha         , Aa^Gvs      , Aa^Gvs      , Aa^Gvs      , Aa^Gvs      , Aa^Gvs      , Aa^Gvs      , Aa^Gvs      , Aa^Gvs      , Aa^Gvs      
Aa          , Aa          , Aa^Gvs      , Aa^Gvs      , Aa^Gvs      , Aa          , Aa^Gvs      , Aa^Gvs      , Aa^Gvs      , Aa          , Aa          , Aa^Gvs      , Aa^Gvs      , Aa^Gvs      , Aa^Gvs      , Aa          , Aa          , Rrc         , Cha         , Rrc         , Rrc         , Rrc^Vhca    , Wwg         , Rrc         , Rrc         , Cha         , Cha         , 6 Kha       , Cha         , Cha         , Rrc         , Rrc^Vhca    , Rrc         , Rrc         , Rrc         , Rrc         , Aa          , Aa^Gvs      , Aa          , Aa          , Aa^Vha      , Aa          , Aa^Es       , Aa^Gvs      , Aa^Gvs      , Aa^Gvs      
Aa          , Aa^Gvs      , Aa^Gvs      , Aa^Gvs      , Aa^Vha      , Aa          , Aa          , Aa^Gvs      , Aa^Vha      , Aa          , Aa          , Aa^Vha      , Aa          , Aa          , Aa^Gvs      , Aa^Gvs      , Aa^Gvs      , Aa          , Cha         , Rrc         , Rrc^Vhca    , Wwg^Bsb\    , Rrc         , Rrc^Vhca    , Rrc         , Cha         , Cha         , Cha         , Rrc         , Rrc         , Rrc         , Rrc         , Rrc^Vhca    , Rrc         , Cha         , Aa          , Aa          , Aa^Vha      , Aa          , Aa          , Aa^Gvs      , Aa^Gvs      , Aa^Gvs      , Aa          , Aa          , Aa          
Aa          , Aa          , Aa          , Aa          , Aa          , Aa          , Aa          , Aa          , Aa^Gvs      , Aa          , Aa          , Aa          , Aa^Wm       , Aa          , Aa          , Aa^Gvs      , Aa^Gvs      , Aa          , Rrc         , Rrc         , Rrc         , Wwg^Bsb/    , Rrc^Vhca    , Rrc         , Rrc         , Rrc         , Rrc         , Cha         , Rrc         , Rrc         , Rrc^Vhca    , Rrc         , Rrc         , Cha         , Aa          , Aa          , Aa          , Aa          , Aa          , Aa          , Aa          , Aa^Gvs      , Aa^Gvs      , Aa^Gvs      , Aa          , Aa          
Aa          , Aa          , Aa          , Aa          , Cha         , Aa          , Aa          , Aa^Gvs      , Aa^Gvs      , Aa^Gvs      , Aa^Gvs      , Aa          , Rrc         , Rrc         , Rrc         , Aa^Vha      , Rrc         , Rrc         , Aa          , Cha         , Cha         , Wwg         , Wwg^Bsb/    , Rrc         , Rrc         , Rrc         , Rrc^Vhca    , Rrc         , Rrc         , Rrc         , Rrc         , Rrc         , Rrc         , Rrc         , Aa          , Aa          , Aa^Vha      , Aa          , Aa          , Aa          , Aa          , Aa^Gvs      , Aa          , Aa          , Aa^Vha      , Aa          
Aa          , Aa          , Cha         , 5 Kha       , Aa          , Aa          , Aa          , Aa^Vha      , Aa^Gvs      , Aa^Gvs      , Rrc         , Rrc         , Aa          , Aa          , Aa          , Rrc         , Aa          , Aa          , Aa          , Aa          , Aa          , Rrc         , Wwg         , Cha         , Cha         , Rrc         , Rrc         , Rrc         , Rrc         , Rrc^Vhca    , Rrc         , Cha         , Aa          , Aa          , Aa          , Aa          , Aa^Gvs      , Aa^Gvs      , Aa^Gvs      , Aa          , Aa          , Aa          , Aa^Gvs      , Aa^Gvs      , Aa^Gvs      , Aa          
Aa          , Cha         , Rrc         , Cha         , Aa          , Aa^Es       , Aa          , Aa          , Rrc         , Rrc         , Aa          , Aa^Vha      , Aa^Gvs      , Aa          , Aa          , Aa          , Aa^Gvs      , Aa^Gvs      , Aa^Vha      , Aa          , Aa          , Rrc         , Aa          , Wwg         , Aa          , Cha         , Cha         , Rrc         , Rrc         , Rrc         , Cha         , Cha         , Aa          , Aa          , Aa          , Aa^Gvs      , Aa^Gvs      , Aa^Gvs      , Aa          , Aa          , Aa          , Aa          , Aa^Gvs      , Aa^Gvs      , Aa^Gvs      , Aa          
Rrc         , Rrc         , Aa          , Rrc         , Rrc         , Rrc         , Rrc         , Rrc         , Rrc         , Aa          , Aa          , Aa^Gvs      , Aa^Gvs      , Aa^Gvs      , Aa          , Aa^Gvs      , Aa^Gvs      , Aa^Gvs      , Aa          , Aa          , Rrc         , Rrc         , Aa^Gvs      , Wwg         , Ai          , Aa          , Aa          , Aa          , Aa          , Rrc         , Rrc         , Aa          , Aa          , Aa          , Aa          , Aa^Gvs      , Aa          , Aa^Gvs      , Aa          , Aa^Es       , Aa          , Aa          , Aa          , Aa^Gvs      , Aa^Gvs      , Aa          
Aa          , Aa          , Aa          , Aa          , Aa          , Aa          , Aa          , Aa          , Rrc         , Aa          , Aa          , Aa^Gvs      , Aa          , Aa^Gvs      , Aa          , Aa^Gvs      , Aa^Gvs      , Aa^Gvs      , Aa          , Aa          , Rrc         , Aa          , Aa^Gvs      , Aa^Gvs      , Ai          , Aa          , Aa          , Aa          , Aa^Vha      , Aa          , Aa          , Rrc         , Rrc         , Aa          , Aa          , Aa          , Rrc         , Aa          , Cha         , Aa          , Cha         , Aa          , Cha         , Aa          , Aa          , Aa          
Aa          , Aa          , Aa^Gvs      , Aa^Gvs      , Aa^Gvs      , Aa          , Aa          , Aa          , Aa          , Rrc         , Rrc         , Aa          , Aa          , Aa          , Aa          , Aa^Gvs      , Aa^Gvs      , Aa^Gvs      , Aa          , Aa          , Rrc         , Aa^Vha      , Aa          , Aa^Gvs      , Wwg         , Aa          , Aa          , Aa          , Aa^Gvs      , Aa^Gvs      , Aa^Gvs      , Aa          , Aa          , Rrc         , Rrc         , Rrc         , Aa          , Rrc         , Rrc         , Cha         , Cha         , 3 Kha       , Cha         , Aa          , Aa          , Aa          
Aa          , Aa^Gvs      , Aa^Gvs      , Aa^Gvs      , Aa^Gvs      , Aa^Gvs      , Aa          , Aa          , Aa          , Aa          , Aa          , Rrc         , Rrc         , Aa          , Aa          , Aa^Gvs      , Aa          , Aa^Vha      , Rrc         , Rrc         , Aa          , Aa          , Aa          , Aa          , Ai          , Gg          , Gg          , Gg          , Gg          , Aa^Gvs      , Aa^Gvs      , Aa          , Aa          , Aa          , Aa          , Aa          , Aa^Es       , Aa          , Rrc         , Cha         , Cha         , Cha         , Aa          , Aa          , Aa          , Aa          
Aa          , Aa^Gvs      , Aa          , Aa^Vha      , Aa          , Aa          , Aa^Gvs      , Aa          , Aa^Gvs      , Aa          , Aa          , Aa^Es       , Aa          , Rrc         , Rrc         , Aa          , Rrc         , Rrc         , Aa          , Aa          , Aa^Gvs      , Aa          , Gg          , Aa          , Ai          , Gg          , Gg^Es       , Gg          , Gg^Gvs      , Aa          , Aa          , Aa          , Aa^Gvs      , Aa^Gvs      , Aa^Gvs      , Aa          , Aa          , Aa          , Rrc         , Rrc         , Rrc         , Aa          , Aa          , Aa          , Rrc         , Rrc         
Aa          , Aa          , Aa          , Aa          , Aa          , Aa^Gvs      , Aa^Vha      , Aa^Gvs      , Aa^Gvs      , Aa          , Aa          , Aa          , Aa^Gvs      , Aa          , Aa          , Rrc         , Aa          , Aa          , Aa^Vha      , Aa^Gvs      , Gg^Gvs      , Gg^Gvs      , Gg          , Gg          , Ai          , Gg^Wm       , Aa^Gvs      , Aa^Gvs      , Aa^Vha      , Gg          , Gg          , Aa          , Aa          , Aa^Gvs      , Aa^Gvs      , Aa^Gvs      , Aa          , Aa          , Rrc         , Aa          , Aa          , Rrc         , Rrc         , Rrc         , Aa          , Aa          
Aa^Gvs      , Aa^Gvs      , Aa^Vha      , Aa          , Aa^Es       , Aa          , Aa          , Aa^Gvs      , Aa          , Aa          , Aa          , Aa^Gvs      , Aa^Gvs      , Aa^Gvs      , Aa          , Rrc         , Aa          , Aa          , Aa^Gvs      , Aa^Gvs      , Gg          , Gg^Gvs      , Gg^Gvs      , Gg          , Gg          , Wwg         , Gg          , Aa^Gvs      , Aa^Gvs      , Gg          , Gg^Es       , Gg          , Gg^Gvs      , Aa^Gvs      , Aa          , Aa^Vha      , Aa^Es       , Aa          , Rrc         , Aa          , Aa^Gvs      , Aa          , Aa          , Aa          , Aa^Vha      , Aa^Gvs      
Aa^Gvs      , Aa^Gvs      , Aa          , Aa          , Aa          , Aa          , Aa^Gvs      , Aa^Gvs      , Aa^Vha      , Aa          , Aa          , Aa^Gvs      , Aa^Gvs      , Aa^Vha      , Rrc         , Rrc         , Gg          , Aa          , Aa          , Aa          , Aa          , Aa^Gvs      , Gg^Gvs      , Gg^Gvs      , Aa          , Ai          , Aa          , Gg^Gvs      , Gg^Gvs      , Gg          , Gg          , Aa^Gvs      , Aa^Gvs      , Aa          , Aa          , Aa          , Aa          , Aa          , Rrc         , Aa^Gvs      , Aa^Gvs      , Aa^Gvs      , Aa^Vha      , Aa          , Aa          , Aa^Gvs      
Aa^Gvs      , Aa^Gvs      , Cha         , Cha         , Aa          , Aa^Gvs      , Aa^Gvs      , Aa^Gvs      , Aa          , Aa^Es       , Aa          , Aa          , Rrc         , Rrc         , Gg          , Gg          , Gg^Gvs      , Gg          , Gg          , Aa          , Aa          , Aa^Gvs      , Aa^Vha      , Aa^Gvs      , Aa          , Ai          , Aa          , Aa^Gvs      , Aa^Gvs      , Gg^Gvs      , Aa^Gvs      , Gg^Gvs      , Aa^Gvs      , Aa^Vha      , Aa          , Aa^Vha      , Aa^Gvs      , Aa          , Rrc         , Aa^Gvs      , Aa          , Aa^Gvs      , Aa          , Aa          , Aa          , Aa          
Aa          , Aa          , 4 Kha       , Aa          , Aa          , Aa          , Aa          , Aa          , Rrc         , Aa          , Rrc         , Rrc         , Gg^Wm       , Gg          , Gg^Gvs      , Gg^Gvs      , Aa^Gvs      , Gg          , Gg          , Gg          , Aa          , Gg          , Gg          , Aa          , Gg          , Ai          , Ai          , Aa^Gvs      , Gg^Gvs      , Gg^Gvs      , Gg          , Aa^Gvs      , Aa^Gvs      , Gg^Gvs      , Aa^Gvs      , Aa^Gvs      , Aa^Gvs      , Aa          , Rrc         , Aa          , Aa          , Aa          , Cha         , Aa^Es       , Aa          , Aa          
Rrc         , Cha         , Cha         , Aa          , Aa          , Aa          , Rrc         , Rrc         , Gg          , Rrc         , Rp          , Gg          , Gg          , Gg^Gvs      , Aa^Gvs      , Aa^Gvs      , Gg          , Gg          , Gg^Gvs      , Aa          , Aa          , Gg          , Gg          , Gg          , Aa          , Gg          , Wwg         , Gg          , Gg          , Aa^Vha      , Gg          , Aa^Gvs      , Gg          , Gg          , Aa^Gvs      , Aa^Gvs      , Aa^Gvs      , Aa          , Aa          , Rrc         , Rrc         , Aa          , Aa          , Cha         , Aa          , Aa          
Aa          , Rrc         , Rrc         , Aa          , Rrc         , Rrc         , Gg^Gvs      , Gg          , Gg^Gvs      , Aa^Vha      , Gg          , Rp          , Rp          , Aa^Vha      , Gg          , Aa          , Aa^Vha      , Gg^Gvs      , Gg^Gvs      , Aa^Gvs      , Aa          , Gg^Gvs      , Aa^Gvs      , Aa^Gvs      , Aa^Vha      , Gg^Gvs      , Gg^Gvs      , Wwg         , Ai          , Gg          , Aa          , Aa          , Aa          , Gg          , Gg          , Aa^Gvs      , Gg          , Aa          , Aa          , Aa          , Aa          , Rrc         , Cha         , 2 Kha       , Aa          , Aa          
Ha^Fpa      , Aa          , Aa          , Rrc         , Gg          , Gg          , Gg^Gvs      , Aa^Gvs      , Aa          , Aa^Gvs      , Aa^Gvs      , Aa          , Gg          , Rp          , Rp          , Gg          , Gg          , Gg^Gvs      , Gg^Gvs      , Gg^Gvs      , Gg          , Gg^Gvs      , Gg          , Aa          , Gg^Gvs      , Gg^Gvs      , Aa^Gvs      , Aa          , Gg          , Ai          , Aa          , Gg          , Gg^Es       , Aa          , Gg          , Gg^Gvs      , Gg^Gvs      , Aa^Vha      , Gg          , Gg          , Rp          , Rrc         , Rrc         , Cha         , Rrc         , Rrc         
Ha^Fpa      , Ha^Fpa      , Aa          , Aa          , Aa^Es       , Gg          , Gg          , Gg^Gvs      , Gg          , Gg          , Gg          , Gg^Gvs      , Gg^Gvs      , Gg^Gvs      , Gg^Es       , Rp          , Rp          , Gg          , Gg          , Gg          , Aa          , Gg          , Gg          , Gg          , Aa          , Aa^Gvs      , Aa          , Aa          , Gg          , Wwg         , Ai          , Aa          , Gg^Gvs      , Gg          , Gg^Gvs      , Gg^Gvs      , Gg          , Gg^Gvs      , Rp          , Rp          , Aa^Vha      , Aa^Gvs      , Aa^Gvs      , Rrc         , Ha^Fpa      , Ha^Fpa      
Ha^Fpa      , Ha^Fpa      , Ha^Fpa      , Aa          , Aa          , Aa          , Gg^Gvs      , Gg          , Aa^Vha      , Aa          , Aa          , Gg^Gvs      , Gg^Gvs      , Gg^Gvs      , Gg^Gvs      , Gg          , Gg          , Rp          , Rp          , Aa          , Aa          , Aa^Gvs      , Aa^Gvs      , Gg^Gvs      , Gg^Gvs      , Aa          , Aa          , Aa          , Gg^Gvs      , Gg          , Ai          , Gg          , Aa^Gvs      , Gg^Gvs      , Gg^Gvs      , Gg          , Rp          , Rp          , Gg^Gvs      , Gg          , Aa          , Aa^Gvs      , Aa^Gvs      , Aa          , Ha^Fpa      , Ha^Fpa      
Ms          , Ha^Fpa      , Ha^Fpa      , Ha^Fpa      , Aa          , Aa          , Aa^Gvs      , Gg^Gvs      , Gg          , Aa          , Aa          , Aa          , Aa          , Gg^Gvs      , Aa^Vha      , Gg          , Gg          , Aa          , Gg          , Rp          , Gg          , Aa          , Aa          , Aa^Vha      , Aa^Gvs      , Aa^Gvs      , Gg          , Gg^Gvs      , Gg^Gvs      , Gg^Gvs      , Wwg         , Aa          , Aa^Vha      , Aa^Gvs      , Gg          , Rp          , Aa^Vha      , Aa^Gvs      , Aa^Gvs      , Gg^Gvs      , Aa^Gvs      , Aa          , Aa          , Ha^Fpa      , Ms          , Ms          
Ms          , Ms          , Ha^Fpa      , Ha^Fpa      , Aa          , Aa^Gvs      , Aa^Gvs      , Aa^Gvs      , Aa          , Aa          , Aa          , Gg          , Aa^Vha      , Aa          , Gg^Gvs      , Gg          , Gg          , Aa          , Aa          , Rp          , Rp          , Gg          , Gg          , Aa          , Gg          , Gg          , Gg          , Aa^Vha      , Aa          , Aa^Gvs      , Ai          , Gg          , Gg          , Gg          , Rp          , Rp          , Gg          , Gg^Gvs      , Aa          , Aa^Gvs      , Aa          , Aa          , Ha^Fpa      , Ha^Fpa      , Ms          , Ms          
Ms          , Ms          , Ha^Fpa      , Ha^Fpa      , Ha^Fpa      , Aa          , Aa          , Aa          , Aa          , Gg          , Gg          , Aa^Gvs      , Aa^Gvs      , Gg^Gvs      , Gg^Gvs      , Gg          , Gg          , Gg          , Gg          , Gg          , Gg          , Rp          , Rp          , Gg          , Gg          , Gg^Gvs      , Gg^Gvs      , Aa          , Gg          , Gg          , Ai          , Gg          , Rp          , Rp          , Gg          , Gg          , Aa^Gvs      , Aa          , Aa          , Aa          , Aa          , Ha^Fpa      , Ha^Fpa      , Ms          , Ms          , Ms          
Ms^Xm       , Ms          , Ms          , Ha^Fpa      , Ha^Fpa      , Ha^Fpa      , Ha^Fpa      , Aa          , Aa          , Aa          , Aa          , Aa^Gvs      , Aa^Gvs      , Aa^Gvs      , Aa^Gvs      , Gg          , Gg          , Gg^Es       , Gg^Gvs      , Gg^Gvs      , Gg^Gvs      , Gg^Gvs      , Rp          , Gg          , Aa^Vha      , Gg^Gvs      , Gg^Gvs      , Gg^Es       , Gg          , Gg          , Ai          , Gg^Wm       , Rp          , Gg          , Gg^Gvs      , Gg^Gvs      , Aa^Gvs      , Aa          , Aa          , Aa          , Aa          , Ha^Fpa      , Ms          , Ms          , Ms          , Ms          
Ms^Xm       , Ms^Xm       , Ms          , Ms          , Ms          , Ha^Fpa      , Ha^Fpa      , Ha^Fpa      , Aa          , Aa          , Aa          , Aa          , Aa          , Aa^Gvs      , Aa          , Gg          , Gg          , Gg          , Gg^Gvs      , Gg^Gvs      , Gg^Gvs      , Aa^Vha      , Gg          , Rp          , Rp          , Gg^Gvs      , Aa          , Aa          , Gg          , Wwg         , Rp          , Rp          , Gg          , Gg          , Aa          , Aa^Vha      , Aa^Gvs      , Aa          , Aa          , Aa^Es       , Aa          , Ha^Fpa      , Ms          , Ms          , Ms^Xm       , Ms^Xm       
Ms^Xm       , Ms^Xm       , Ms^Xm       , Ms          , Ms          , Ms          , Ha^Fpa      , Ha^Fpa      , Ha^Fpa      , Aa          , Aa          , Aa^Es       , Aa          , Aa          , Aa^Gvs      , Aa^Gvs      , Aa^Gvs      , Aa^Gvs      , Aa          , Gg          , Aa          , Gg^Gvs      , Gg          , Gg          , Rp          , Gg          , Aa          , Aa          , Rp          , Ai^Bsb/     , Gg          , Aa          , Aa^Gvs      , Aa          , Aa          , Aa^Gvs      , Aa^Gvs      , Aa^Gvs      , Aa          , Aa          , Ha^Fpa      , Ha^Fpa      , Ms          , Ms          , Ms^Xm       , Ms^Xm       
Ms^Xm       , Ms^Xm       , Ms^Xm       , Ms          , Ms          , Ms          , Ms          , Ha^Fpa      , Ha^Fpa      , Ha^Fpa      , Ha^Fpa      , Aa          , Ha^Fpa      , Aa          , Aa          , Aa^Gvs      , Aa^Gvs      , Aa^Gvs      , Aa^Gvs      , Aa          , Aa          , Aa          , Gg^Gvs      , Gg          , Gg          , Rp          , Rp          , Gg          , Rp          , Ai          , Aa          , Aa          , Aa^Gvs      , Aa^Gvs      , Aa^Gvs      , Aa          , Aa          , Aa          , Ha^Fpa      , Ha^Fpa      , Ha^Fpa      , Ha^Fpa      , Ms          , Ms          , Ms^Xm       , Ms^Xm       
Ms^Xm       , Ms^Xm       , Ms^Xm       , Ms^Xm       , Ms          , Ms          , Ms          , Ms          , Ms          , Ha^Fpa      , Ha^Fpa      , Ha^Fpa      , Ha^Fpa      , Ha^Fpa      , Aa          , Aa          , Aa          , Aa^Gvs      , Aa^Vha      , Aa          , Aa          , Aa^Gvs      , Gg^Gvs      , Gg^Gvs      , Aa^Vha      , Gg          , Rp          , Rp          , Wwg         , Ai          , Aa          , Aa^Vha      , Aa^Gvs      , Aa^Gvs      , Aa          , Aa          , Ha^Fpa      , Ha^Fpa      , Ha^Fpa      , Ha^Fpa      , Ha^Fpa      , Ha^Fpa      , Ms          , Ms          , Ms^Xm       , Ms^Xm       
Ms^Xm       , Ms^Xm       , Ms^Xm       , Ms^Xm       , Ms^Xm       , Ms          , Ms          , Ms          , Ms          , Ms          , Ms          , Ha^Fpa      , Ha^Fpa      , Ha^Fpa      , Ha^Fpa      , Aa          , Aa          , Aa          , Aa          , Aa^Es       , Aa          , Aa          , Gg          , Gg^Gvs      , Gg          , Gg          , Rp          , Gg          , Wwg         , Gg          , Aa          , Aa          , Aa          , Aa          , Ha^Fpa      , Ha^Fpa      , Ha^Fpa      , Ha^Fpa      , Ha^Fpa      , Ha^Fpa      , Ms          , Ms          , Ms          , Ms^Xm       , Ms^Xm       , Ms^Xm       
Ms^Xm       , Ms^Xm       , Ms^Xm       , Ms^Xm       , Ms^Xm       , Ms^Xm       , Ms^Xm       , Ms^Xm       , Ms^Xm       , Ms          , Ms          , Ms          , Ms          , Ha^Fpa      , Ha^Fpa      , Ha^Fpa      , Ha^Fpa      , Ha^Fpa      , Ha^Fpa      , Aa          , Aa          , Aa          , Aa          , Chr         , Chr         , Chr         , Rp          , Gg          , Ai          , Gg          , Aa          , Aa          , Aa          , Ha^Fpa      , Ha^Fpa      , Ha^Fpa      , Ha^Fpa      , Ha^Fpa      , Ms          , Ms          , Ms          , Ms          , Ms^Xm       , Ms^Xm       , Ms^Xm       , Ms^Xm       
Ms^Xm       , Ms^Xm       , Ms^Xm       , Ms^Xm       , Ms^Xm       , Ms^Xm       , Ms^Xm       , Ms^Xm       , Ms^Xm       , Ms^Xm       , Ms^Xm       , Ms          , Ms          , Ms          , Ms          , Ha^Fpa      , Ha^Fpa      , Ha^Fpa      , Ha^Fpa      , Ha^Fpa      , Ha^Fpa      , Ha^Fpa      , Aa          , 1 Khr       , Chr         , Chr         , Rp          , Ai          , Aa          , Aa          , Ha^Fpa      , Ha^Fpa      , Ha^Fpa      , Ha^Fpa      , Ms          , Ms          , Ms          , Ms          , Ms          , Ms          , Ms^Xm       , Ms^Xm       , Ms^Xm       , Ms^Xm       , Ms^Xm       , Ms^Xm       
Ms^Xm       , Ms^Xm       , Ms^Xm       , Ms^Xm       , Ms^Xm       , Ms^Xm       , Ms^Xm       , Ms^Xm       , Ms^Xm       , Ms^Xm       , Ms^Xm       , Ms^Xm       , Ms^Xm       , Ms          , Ms          , Ms          , Ms          , Ms          , Ms          , Ha^Fpa      , Ha^Fpa      , Ha^Fpa      , Aa          , Aa          , Chr         , Chr         , Rp          , Wwg         , Ha^Fpa      , Ha^Fpa      , Ha^Fpa      , Ha^Fpa      , Ha^Fpa      , Ms          , Ms          , Ms          , Ms          , Ms          , Ms^Xm       , Ms^Xm       , Ms^Xm       , Ms^Xm       , Ms^Xm       , Ms^Xm       , Ms^Xm       , Ms^Xm       
Ms^Xm       , Ms^Xm       , Ms^Xm       , Ms^Xm       , Ms^Xm       , Ms^Xm       , Ms^Xm       , Ms^Xm       , Ms^Xm       , Ms^Xm       , Ms^Xm       , Ms^Xm       , Ms^Xm       , Ms^Xm       , Ms^Xm       , Ms          , Ms          , Ms          , Ms          , Ms          , Ha^Fpa      , Ha^Fpa      , Ha^Fpa      , Aa          , Aa          , Aa          , Rp          , Wwg         , Ha^Fpa      , Ha^Fpa      , Ms          , Ms          , Ms          , Ms          , Ms^Xm       , Ms^Xm       , Ms^Xm       , Ms^Xm       , Ms^Xm       , Ms^Xm       , Ms^Xm       , Ms^Xm       , Ms^Xm       , Ms^Xm       , Ms^Xm       , Ms^Xm       
