border_size=1
usage=map

Gs^Fds      , Gs^Fds      , Gs^Fms      , Gs^Fms      , Gs^Fds      , Gs^Fds      , Gs^Fms      , Gs^Fds      , Gs^Fms      , Gs^Fms      , Gs^Fms      , Gs^Fds      , Gs^Fds      , Gs^Fds      , Gs^Fms      , Gs^Fms      , Gs^Fms      , Gs^Fms      , Gs^Fmw      , Gs^Fmw      , Gs^Fdw      , Gs^Fdw      , Gs^Fdw      , Re          , Re          , Re          , Gs^Fdw      , Gs^Fdw      , Gs^Fmw      , Gs^Fmw      , Gs^Fds      , Gs^Fds      , Gs^Fms      , Gs^Fms      , Gg^Fet      , Gs^Fms      , Gs^Fms      , Gs^Fms      , Gs^Fds      , Hh^Fms      , Hh^Fds      , Hh^Fds      , Hh^Fds      , Hh^Fms      , Hh^Fds      , Gs^Fds      
Gs^Fms      , Gs^Fms      , Gs^Fms      , Gs^Fds      , Gg^Ve       , Gs^Fds      , Gs^Fds      , Gs^Fms      , Gs^Fms      , Gs^Fms      , Gg^Fet      , Gs^Fds      , Gs^Fms      , Gs^Fms      , Gs^Fms      , Gs^Fms      , Gs^Fds      , Gs^Fms      , Gs^Fmw      , Gs^Fmw      , Gs^Fdw      , Gs^Fdw      , Re          , Re          , Re          , Re          , Gs^Fdw      , Gs^Fdw      , Gs^Fmw      , Gs^Fms      , Gs^Fms      , Gg^Ve       , Gs^Fms      , Gs^Fms      , Gs^Fms      , Gs^Fms      , Gs^Fms      , Gs^Fms      , Gs^Fds      , Hh^Fms      , Hh^Fms      , Hh^Fds      , Hh^Fds      , Hh^Fds      , Hh^Fds      , Gs^Fds      
Gs^Fms      , Gs^Fms      , Gs^Fds      , Gs^Fds      , Gs^Fds      , Gs^Fms      , Gs^Fms      , Gs^Fms      , Gs^Fds      , Gs^Fms      , Gs^Fds      , Gs^Fds      , Gg^Fet      , Gs^Fms      , Gs^Fds      , Gg^Ve       , Gs^Fms      , Gs^Fms      , Gs^Fmw      , Gs^Fmw      , Gs^Fdw      , Gs^Fdw      , Ce          , Re          , Ce          , Gs^Fdw      , Gs^Fdw      , Gs^Fmw      , Gs^Fmw      , Gs^Fms      , Gs^Fds      , Gs^Fms      , Gs^Fms      , Gs^Fms      , Gg^Ve       , Gs^Fds      , Gs^Fds      , Gs^Fds      , Gg^Ve       , Hh^Fds      , Gs^Fms      , Gg^Ve       , Hh^Fds      , Hh^Fds      , Hh^Fds      , Gs^Fds      
Gs^Fms      , Gs^Fms      , Gs^Fms      , Gs^Fms      , Gs^Fds      , Gs^Fms      , Gs^Fms      , Gs^Fds      , Gs^Fds      , Gs^Fds      , Gs^Fds      , Gs^Fds      , Gs^Fds      , Gs^Fds      , Gs^Fms      , Gs^Fms      , Gs^Fms      , Gs^Fms      , Gs^Fmw      , Gs^Fdw      , Gs^Fdw      , Gs^Fdw      , 1 Ke        , Ce          , Ce          , Gs^Fdw      , Gs^Fdw      , Gs^Fmw      , Gs^Fds      , Gs^Fds      , Gs^Fds      , Gs^Fms      , Gs^Fms      , Gs^Fms      , Gs^Fms      , Gs^Fds      , Gs^Fms      , Hh^Fds      , Hh^Fds      , Hh^Fds      , Hh^Fds      , Hh^Fds      , Hh^Fds      , Hh^Fds      , Ww          , Ww          
Gs^Fms      , Gs^Fms      , Gg^Fet      , Gs^Fms      , Gs^Fms      , Gs^Fds      , Gs^Fms      , Gs^Fms      , Cv          , Gg^Fet      , Gg^Ve       , Gs^Fds      , Gs^Fms      , Gs^Fms      , Gs^Fms      , Gs^Fds      , Gs^Fms      , Gs^Fms      , Gs^Fmw      , Gs^Fdw      , Gs^Fdw      , Gs^Fdw      , Ce          , Ce          , Gs^Fdw      , Gs^Fdw      , Gs^Fmw      , Gs^Fmw      , Gs^Fms      , Gg^Fet      , Gs^Fms      , Gs^Fds      , Gs^Fds      , Gs^Fms      , Hh^Fds      , Gs^Fds      , Hh^Fds      , Hh^Fds      , Hh^Fds      , Hh^Fds      , Hh^Fds      , Hh^Fds      , Ww          , Ww          , Ww          , Ww          
Gs^Fms      , Gs^Fms      , Gs^Fds      , Gs^Fds      , Gs^Fds      , Gs^Fms      , Gg^Fet      , Cv          , Gg^Ve       , Cv          , Gs^Fds      , Gs^Fds      , Gs^Fms      , Gs^Fms      , Gs^Fms      , Gg^Ve       , Gs^Fms      , Gs^Fds      , Gs^Fmw      , Gs^Fmw      , Gs^Fdw      , Gs^Fdw      , Re          , Re          , Gs^Fdw      , Gs^Fdw      , Gs^Fmw      , Gs^Fmw      , Gs^Fds      , Gs^Fds      , Gs^Fds      , Gs^Fds      , Gg^Ve       , Gs^Fms      , Hh^Fds      , Gg^Ve       , Hh^Fds      , Hh^Fds      , Hh^Fds      , Hh^Fds      , Ww          , Ww          , Ww          , Ww          , Hh^Fds      , Hh^Fds      
Gs^Fms      , Gs^Fms      , Gs^Fms      , Gs^Fms      , 6 Gs^Fms    , Gs^Fms      , Gs^Fds      , Gs^Fds      , Gs^Fms      , Gs^Fms      , Gs^Fds      , Gs^Fds      , Gs^Fms      , Gs^Fms      , Gs^Fms      , Gs^Fms      , Gs^Fms      , Gs^Fmw      , Gs^Fmw      , Gs^Fdw      , Gs^Fdw      , Re          , Re          , Re          , Gs^Fdw      , Gs^Fdw      , Gs^Fmw      , Gs^Fmw      , Gs^Fms      , Gs^Fms      , Gs^Fms      , Gs^Fms      , Gs^Fms      , Gs^Fms      , Ww          , Ww          , Ww          , Ww          , Ww          , Ww          , Ww          , Ww          , Hh^Fds      , Hh^Fds      , Gs^Fms      , Gs^Fds      
Gs^Fms      , Gs^Fms      , Gs^Fms      , Gs^Fms      , Gs^Fms      , Gs^Fms      , Gs^Fms      , Gs^Fds      , Gs^Fds      , Gs^Fms      , Gs^Fms      , Gs^Fms      , Gs^Fds      , Gs^Fds      , Gg^Ve       , Gs^Fms      , Gs^Fms      , Gs^Fmw      , Gs^Fmw      , Gs^Fmw      , Gs^Fdw      , Re          , Re          , Re          , Gs^Fdw      , Gs^Fmw      , Gs^Fmw      , Gs^Fms      , Ww          , Ww          , Ww          , Gs^Fms      , Ww          , Ww          , Ww          , Ww          , Hh^Fp       , Ww          , Hh^Fds      , Ww          , Hh^Fds      , Gs^Fds      , Hh^Fds      , Gg^Ve       , Gs^Fds      , Gs^Fds      
Gs^Fds      , Gs^Fms      , Gs^Fms      , Gs^Fms      , Gs^Fms      , Gg^Fet      , Gs^Fms      , Gs^Fms      , Gs^Fds      , Gs^Fds      , Gs^Fms      , Gs^Fms      , Gs^Fms      , Gs^Fms      , Gs^Fds      , Gs^Fds      , Gs^Fds      , Gs^Fds      , Gs^Fds      , Gs^Fmw      , Gs^Fdw      , Re          , Wwf         , Wwf         , Wwf         , Gs^Fdw      , Ww          , Ww          , Hh^Fmw      , Hh^Fmw      , Hh^Fmw      , Ww          , Ww          , Ww          , Hh^Fp       , Hh^Fp       , Hh^Fp       , Hh^Fp       , Hh^Fds      , Hh^Fds      , Hh^Fds      , Hh^Fds      , Gs^Fms      , Gs^Fms      , Gs^Fds      , Gs^Fds      
Gs^Fds      , Gs^Fms      , Gs^Fms      , Gs^Fms      , Gg^Ve       , Gs^Fms      , Gs^Fms      , Gs^Fms      , Gs^Fds      , Gs^Fds      , Gs^Fds      , Gg^Fet      , Gs^Fms      , Gs^Fms      , Gs^Fms      , Gs^Fds      , Gs^Fds      , Gs^Fds      , Ww          , Ww          , Ww          , Ww          , Ww          , Ww          , Ww          , Ww          , Gs^Fmw      , Gs^Fmw      , Gs^Fmw      , Hh^Fmw      , Hh^Fmw      , Hh^Fmw      , Hh^Fds      , Hh^Fms      , Hh^Fds      , Hh^Fp       , Hh^Fp       , Hh^Fds      , Hh^Fds      , Hh^Fds      , Gs^Fms      , Gs^Fms      , Gs^Fms      , Gg^Fet      , Gs^Fds      , Gs^Fds      
Gg^Fet      , Gs^Fms      , Gs^Fms      , Gs^Fds      , Gs^Fms      , Gs^Fms      , Gs^Fms      , Gs^Fms      , Gs^Fms      , Gg^Ve       , Gs^Fds      , Gs^Fds      , Gs^Fms      , Gs^Fms      , Ww          , Gs^Fms      , Ww          , Ww          , Gs^Fmw      , Gs^Fmw      , Gs^Fdw      , Re          , Re          , Wwf         , Gs^Fdw      , Gs^Fmw      , Gs^Fmw      , Gs^Fmw      , Gs^Fmw      , Gs^Fmw      , Hh^Fmw      , Hh^Fmw      , Hh^Fds      , Hh^Fms      , Hh^Fds      , Hh^Fmw      , Hh^Fp       , Hh^Fds      , Hh^Fms      , Gs^Fms      , Gs^Fms      , Gg^Ve       , Gs^Fms      , Gs^Fms      , Gs^Fds      , Gs^Fds      
Gs^Fds      , Gs^Fds      , Gs^Fds      , Gs^Fms      , Gg^Ve       , Gs^Fds      , Gs^Fds      , Gs^Fds      , Gs^Fds      , Gs^Fms      , Gs^Fds      , Gs^Fms      , Ww          , Ww          , Ww          , Ww          , Gs^Fmw      , Gs^Fdw      , Gs^Fdw      , Gs^Fmw      , Gs^Fdw      , Re          , Re          , Re          , Re          , Gs^Fdw      , Gs^Fdw      , Gs^Fdw      , Hh^Fdw      , Hh^Fdw      , Hh^Fmw      , Hh^Fmw      , Hh^Fds      , Hh^Fds      , Gg^Ve       , Hh^Fds      , Hh^Fds      , Hh^Fp       , Hh^Fp       , Hh^Fms      , Hh^Fp       , Gs^Fms      , Gs^Fms      , Gs^Fms      , Gg^Fet      , Gs^Fds      
Gs^Fms      , Gs^Fds      , Gs^Fds      , Gs^Fds      , Gs^Fds      , Gs^Fds      , Gs^Fds      , Gs^Fds      , Ww          , Gs^Fds      , Ww          , Ww          , Ww          , Ww          , Gs^Fmw      , Gs^Fmw      , Gs^Fmw      , Gs^Fdw      , Gs^Fdw      , Gs^Fdw      , Re          , Re          , Ce          , Ce          , Ce          , Gs^Fdw      , Re          , Gs^Fdw      , Hh^Fdw      , Hh^Fdw      , Hh^Fmw      , Gs^Fmw      , Hh^Fds      , Hh^Fp       , Hh^Fp       , Hh^Fms      , Hh^Fms      , Hh^Fms      , Hh^Fp       , Hh^Fp       , Gs^Fp       , Hh^Fms      , Gs^Fds      , Gs^Fms      , Gs^Fp       , Gs^Fds      
Gs^Fms      , Gs^Fms      , Gs^Fms      , Gs^Fds      , Gs^Fds      , Gs^Fds      , Ww          , Ww          , Ww          , Ww          , Gs^Fp       , Gs^Fp       , Gs^Fp       , Gs^Fp       , Gs^Fmw      , Gs^Fmw      , Gs^Fmw      , Gs^Fdw      , Gs^Fdw      , Gs^Fdw      , Re          , Ce          , Ce          , 3 Ke        , Ce          , Ce          , Re          , Gs^Fdw      , Hh^Fdw      , Hh^Fmw      , Hh^Fmw      , Hh^Fmw      , Hh^Fms      , Hh^Fms      , Hh^Fds      , Hh^Fp       , Hh^Fp       , Hh^Fp       , Hh^Fp       , Hh^Fp       , Gs^Fp       , Gs^Fds      , Gs^Fds      , Gs^Fds      , Gs^Fp       , Gs^Fp       
Gs^Fms      , Gs^Fms      , Gg^Fet      , Gs^Fds      , Gs^Fds      , Ww          , Ww          , Ww          , Gs^Fms      , Gs^Fms      , Gs^Fp       , Gs^Fp       , Gs^Fp       , Gs^Fp       , Gs^Fp       , Gs^Fmw      , Gs^Fmw      , Gs^Fdw      , Gs^Fdw      , Re          , Re          , Ce          , Ce          , Ce          , Ce          , Ce          , Re          , Re          , Hh^Fdw      , Hh^Fdw      , Hh^Fmw      , Hh^Fmw      , Hh^Fms      , Hh^Fds      , Hh^Fms      , Hh^Fp       , Hh^Fp       , Gg^Ve       , Hh^Fms      , Hh^Fp       , Gs^Fp       , Gs^Fp       , Gs^Fp       , Gg^Ve       , Gs^Fp       , Gs^Fp       
Gs^Fms      , Gs^Fms      , Gs^Fms      , Gs^Fds      , Ww          , Ww          , Ww          , Gs^Fms      , Gs^Fms      , Gs^Fms      , Gs^Fp       , Gs^Fp       , Gs^Fp       , Gs^Fp       , Gs^Fp       , Gs^Fmw      , Gs^Fmw      , Gs^Fdw      , Gs^Fdw      , Re          , Re          , Re          , Re          , Re          , Re          , Re          , Re          , Re          , Hh^Fdw      , Hh^Fdw      , Hh^Fmw      , Hh^Fmw      , Hh^Fms      , Hh^Fms      , Hh^Fms      , Hh^Fms      , Hh^Fms      , Hh^Fds      , Hh^Fds      , Gs^Fp       , Gs^Fp       , Gs^Fds      , Gs^Fp       , Gs^Fds      , Gs^Fp       , Gs^Fds      
Gs^Fms      , Gg^Ve       , Gs^Fms      , Gs^Fms      , Gs^Fds      , Ww          , Ww          , Gs^Fms      , Gs^Fms      , Gs^Fms      , Gs^Fp       , Gs^Fp       , Gs^Fp       , Gs^Fp       , Gs^Fp       , Gs^Fmw      , Gs^Fmw      , Gs^Fdw      , Gs^Fdw      , Re          , Re          , Re          , Re          , Re          , Re          , Re          , Re          , Re          , Hh^Fdw      , Hh^Fdw      , Hh^Fmw      , Hh^Fmw      , Hh^Fms      , Gg^Ve       , Hh^Fds      , Hh^Fms      , Hh^Fms      , Hh^Fds      , Hh^Fds      , Gs^Fp       , Gs^Fds      , Gs^Fp       , Gs^Fp       , Gs^Fp       , Gs^Fds      , Gs^Fds      
Gs^Fp       , Gs^Fp       , Gs^Fp       , Gs^Fms      , Gs^Fp       , Ww          , Ww          , Gs^Fms      , Gs^Fms      , Gs^Fms      , Gg^Ve       , Gg^Ve       , Cv          , Gg^Fet      , Gs^Fp       , Gs^Fmw      , Gs^Fmw      , Gs^Fdw      , Gs^Fdw      , Gs^Fdw      , Gs^Fdw      , Re          , Re          , Re          , Re          , Re          , Gs^Fdw      , Hh^Fdw      , Hh^Fdw      , Hh^Fmw      , Hh^Fmw      , Hh^Fmw      , Hh^Fms      , Hh^Fds      , Hh^Fds      , Hh^Fds      , Hh^Fds      , Hh^Fds      , Gs^Fp       , Gs^Fp       , Gs^Fds      , Gs^Fds      , Gg^Fet      , Gs^Fds      , Gs^Fds      , Gs^Fds      
Gs^Fp       , Gs^Fp       , Gs^Fp       , Gs^Fp       , Gs^Fp       , Gg^Fet      , Gs^Fp       , Ww          , Ww          , Ww          , Ww          , Cv          , Kv          , Cv          , Gg^Ve       , Gs^Fds      , Gs^Fds      , Gs^Fmw      , Gs^Fmw      , Gs^Fmw      , Gs^Fmw      , Gs^Fdw      , Gs^Fdw      , Gs^Fdw      , Gs^Fdw      , Gs^Fdw      , Gs^Fdw      , Hh^Fdw      , Gs^Fmw      , Hh^Fmw      , Hh^Fmw      , Hh^Fmw      , Gs^Fp       , Hh^Fp       , Hh^Fp       , Hh^Fds      , Hh^Fds      , Gs^Fp       , Gs^Fp       , Gs^Fp       , Gs^Fds      , Gs^Fds      , Gs^Fp       , Gs^Fds      , Gg^Ve       , Gs^Fds      
Gs^Fp       , Gs^Fp       , Gs^Fp       , Gg^Fet      , Gs^Fp       , Gs^Fp       , Gg^Ve       , Gs^Fp       , Gs^Fp       , Gs^Fp       , Ww          , Cv          , Cv          , Gg^Fet      , Gs^Fp       , Gs^Fp       , Gs^Fp       , Gs^Fds      , Gs^Fds      , Gs^Fmw      , Gs^Fmw      , Gs^Fmw      , Gs^Fmw      , Gs^Fdw      , Gs^Fdw      , Gs^Fdw      , Gs^Fdw      , Gs^Fdw      , Gs^Fmw      , Gs^Fmw      , Gs^Fmw      , Gs^Fp       , Gs^Fp       , Gs^Fp       , Hh^Fp       , Hh^Fp       , Hh^Fp       , Hh^Fms      , Gs^Fms      , Hh^Fp       , Gg^Ve       , Gs^Fp       , Gs^Fp       , Gs^Fp       , Gs^Fms      , Gs^Fms      
Gs^Fp       , Gs^Fp       , Gs^Fp       , Gs^Fp       , Gs^Fp       , Gs^Fp       , Gs^Fmw      , Gs^Fp       , Gs^Fp       , Gs^Fp       , Ww          , Ww          , Ww          , Ww          , Ww          , Ww          , Ww          , Gs^Fp       , Gs^Fds      , Gs^Fds      , Gs^Fds      , Gs^Fmw      , Gs^Fp       , Gs^Fp       , Gs^Fmw      , Gs^Fmw      , Gs^Fmw      , Gs^Fmw      , Gs^Fms      , Gs^Fmw      , Gs^Fms      , Gg^Ve       , Gs^Fms      , Gs^Fms      , Gs^Fms      , Hh^Fp       , Gs^Fms      , Hh^Fp       , Gs^Fp       , Hh^Fp       , Gs^Fp       , Gs^Fp       , Gs^Fms      , Gs^Fms      , Gs^Fms      , Gs^Fms      
Gs^Fmw      , Gs^Fmw      , Gs^Fmw      , Gs^Fmw      , Gs^Fmw      , Gs^Fmw      , Gs^Fmw      , Gs^Fmw      , Gs^Fmw      , Gs^Fp       , Ww          , Ww          , Gs^Fds      , Gs^Fds      , Cv          , Gg^Fet      , Ww^Bw/      , Gs^Fp       , Gs^Fp       , Gg^Fet      , Gs^Fds      , Gs^Fds      , Gs^Fds      , Gs^Fds      , Gs^Fds      , Gs^Fp       , Gs^Fds      , Gs^Fms      , Gs^Fms      , Gs^Fms      , Gs^Fms      , Gs^Fms      , Gs^Fms      , Gs^Fms      , Gs^Fp       , Gg^Fet      , Gs^Fms      , Gs^Fms      , Gs^Fms      , Gs^Fp       , Gs^Fms      , Gs^Fms      , Gs^Fms      , Gs^Fms      , Ww          , Ww          
Gs^Fmw      , Gs^Fmw      , Gs^Fmw      , Gs^Fmw      , Gs^Fmw      , Gs^Fmw      , Gs^Fdw      , Gs^Fmw      , Ww          , Ww          , Ww          , Gg^Fet      , Gg^Fet      , Cv          , Gg^Fet      , Cv          , Gg^Fet      , Ww          , Ww          , Gs^Fp       , Gs^Fp       , Gs^Fp       , Gs^Fp       , Gg^Ve       , Ww          , Gs^Fds      , Gs^Fds      , Gs^Fds      , Gs^Fms      , Gs^Fms      , Gs^Fms      , Gs^Fp       , Gs^Fms      , Gs^Fp       , Gs^Fms      , Gs^Fp       , Gs^Fp       , Gs^Fms      , Gg^Ve       , Gs^Fms      , Gs^Fms      , Gs^Fms      , Ww          , Ww          , Ww          , Ww          
Gs^Fdw      , Gs^Fdw      , Gs^Fdw      , Gs^Fdw      , Gs^Fdw      , Gs^Fdw      , Gs^Fdw      , Gs^Fdw      , Ww          , Ww          , Cv          , Cv          , Cv          , 2 Kv        , Cv          , Gg^Ve       , Gs^Fds      , Ww          , Ww          , Ww          , Ww          , Ww          , Ww          , Ww          , Ww          , Ww          , Ww          , Ww          , Ww          , Gs^Fms      , Ww          , Gs^Fms      , Gs^Fms      , Gs^Fms      , Gs^Fms      , Gs^Fms      , Gs^Fms      , Gs^Fp       , Ww          , Gs^Fms      , Gs^Fms      , Gs^Fms      , Ww          , Ww          , Gg^Ve       , Gs^Fp       
Gs^Fdw      , Gs^Fdw      , Re          , Gs^Fdw      , Re          , Re          , Re          , Gs^Fdw      , Ww          , Ww          , Gg^Fet      , Gg^Ve       , Cv          , Gg^Ve       , Gg^Ve       , Gg^Fet      , Gg^Fet      , Ww          , Gs^Fms      , Gs^Fms      , Gs^Fms      , Ww          , Ww          , Ww          , Ww          , Ww          , Ww          , Ww          , Ww          , Ww          , Ww          , Gs^Fms      , Gs^Fms      , Gs^Fms      , Ww          , Ww          , Ww          , Ww          , Ww          , Ww          , Ww          , Ww          , Ww          , Gs^Fmw      , Gs^Fmw      , Gs^Fp       
Gs^Fdw      , Gs^Fdw      , Re          , Re          , Ce          , Re          , Re          , Re          , Re          , Ww          , Ww          , Gg^Fet      , Gs^Fds      , Gg^Ve       , Gg^Fet      , Gs^Fds      , Ww          , Ww          , Gs^Fms      , Gs^Fms      , Gs^Fms      , Gs^Fms      , Gs^Fms      , Gs^Fms      , Gs^Fmw      , Ww          , Gs^Fdw      , Ww          , Ww          , Ww          , Ww          , Ww          , Ww          , Ww          , Ww          , Ww          , Ce          , Ww          , Re          , Ww          , Ww          , Ww          , Gs^Fdw      , Gs^Fmw      , Gs^Fmw      , Gs^Fp       
Gs^Fdw      , Re          , Re          , Ce          , 5 Ke        , Ce          , Re          , Re          , Re          , Re          , Re          , Ww          , Ww^Bw|      , Gs^Fds      , Ww          , Ww          , Gs^Fp       , Gs^Fp       , Gs^Fms      , Gs^Fms      , Gs^Fms      , Gs^Fms      , Gs^Fms      , Gs^Fms      , Gs^Fmw      , Gs^Fmw      , Gs^Fdw      , Gs^Fdw      , Gs^Fdw      , Ww          , Ww          , Ww          , Re          , Ww          , Ce          , Ce          , 4 Ke        , Ce          , Re          , Re          , Re          , Re          , Gs^Fdw      , Gs^Fmw      , Gs^Fmw      , Gs^Fmw      
Gs^Fdw      , Re          , Re          , Ce          , Ce          , Ce          , Re          , Re          , Re          , Re          , Ww          , Ww          , Gs^Fds      , Ww          , Gs^Fms      , Gs^Fms      , Gs^Fms      , Gs^Fms      , Gs^Fms      , Gs^Fms      , Gs^Fms      , Gs^Fp       , Gs^Fms      , Gs^Fp       , Gs^Fmw      , Gs^Fmw      , Gs^Fmw      , Gs^Fdw      , Gs^Fdw      , Re          , Re          , Re          , Re          , Re          , Re          , Ce          , Ce          , Ce          , Re          , Re          , Re          , Re          , Gs^Fdw      , Gs^Fdw      , Gs^Fmw      , Gs^Fmw      
Gs^Fdw      , Gs^Fdw      , Re          , Re          , Re          , Re          , Re          , Re          , Re          , Ww          , Ww          , Gs^Fds      , Ww          , Ww          , Gs^Fms      , Gs^Fms      , Gs^Fms      , Gs^Fms      , Gs^Fms      , Gg^Ve       , Gs^Fp       , Gs^Fms      , Gs^Fms      , Gs^Fms      , Gs^Fmw      , Gs^Fmw      , Gs^Fmw      , Gs^Fdw      , Gs^Fdw      , Gs^Fdw      , Gs^Fdw      , Re          , Re          , Re          , Re          , Re          , Re          , Re          , Re          , Re          , Re          , Re          , Re          , Gs^Fdw      , Gs^Fmw      , Gs^Fmw      
Gs^Fmw      , Gs^Fdw      , Gs^Fdw      , Re          , Re          , Re          , Gs^Fdw      , Gs^Fdw      , Ww          , Ww          , Gs^Fds      , Gs^Fp       , Ww          , Ww          , Gs^Fms      , Gs^Fms      , Gs^Fms      , Gs^Fms      , Gs^Fms      , Gs^Fms      , Gs^Fms      , Gs^Fp       , Gs^Fp       , Gs^Fms      , Gs^Fms      , Gs^Fmw      , Gs^Fmw      , Gs^Fmw      , Gs^Fmw      , Gs^Fdw      , Gs^Fdw      , Re          , Re          , Re          , Re          , Re          , Re          , Re          , Re          , Re          , Re          , Re          , Re          , Gs^Fdw      , Gs^Fmw      , Gs^Fmw      
Gs^Fmw      , Gs^Fmw      , Gs^Fdw      , Gs^Fdw      , Gs^Fdw      , Gs^Fdw      , Gs^Fdw      , Gs^Fdw      , Ww          , Ww          , Gs^Fds      , Gs^Fds      , Ww          , Gs^Fms      , Gs^Fms      , Gs^Fms      , Gs^Fms      , Gs^Fms      , Gs^Fms      , Gs^Fms      , Gs^Fms      , Gs^Fms      , Gs^Fms      , Gs^Fms      , Gs^Fms      , Gs^Fmw      , Gs^Fmw      , Gs^Fmw      , Gs^Fmw      , Gs^Fdw      , Gs^Fdw      , Gs^Fdw      , Re          , Re          , Re          , Re          , Re          , Re          , Re          , Re          , Re          , Re          , Gs^Fdw      , Gs^Fdw      , Gs^Fmw      , Gs^Fmw      
