border_size=1
usage=map

Aa^Ftp      , Aa          , Aa          , Gd          , Gd          , Gd          , Gd          , Gd          , Gd          , Gd          , Gd          , Gd          , Gd          , Gd          , Gd          , Gd          , Gd          , Gd          , Gd          , Gd          , Gd          , Gd          , Gd          , Gd          , Gd          , Gd          , Gd          , Gd          , Gd          , Gd          , Gd          , Gd          , Gd          , Gd          , Gd          , Gd          , Gd          , Gd          , Gd          , Gd          , Gd          , Gd          , Gd          , Gd          , Gd          , Aa          
Aa^Ftp      , Aa^Ftp      , Aa          , Gd          , Gd          , Gd          , Gd          , Gd          , Gd          , Gd          , Aa          , Gd^Vht      , Gd          , Gd          , Gd          , Gd          , Aa          , Aa          , Aa          , Gd          , Gd          , Gd          , Cha         , Gd          , Gd          , Gd          , Gd          , Gd          , Gd          , Gd          , Aa          , Gd          , Aa          , Gd          , Aa          , Aa          , Gd          , Gd          , Gd          , Gd          , Aa          , Gd          , Aa          , Aa          , Aa          , Aa          
Aa          , Aa          , Aa          , Gd          , Gd          , Gd          , Gd          , Gd          , Gd          , Aa          , Aa          , Aa          , Gd          , Gd          , Gd          , Gd          , Gd          , Aa^Fda      , Aa          , Aa          , Aa          , Ch          , 2 Kh        , Cha         , Gd          , Gd          , Gd          , Gd          , Gd          , Gd          , Aa          , Aa          , Aa^Fda      , Aa^Fda      , Aa          , Aa          , Gd          , Gd          , Aa          , Gd          , Aa          , Aa          , Aa^Ftp      , Aa          , Gd          , Aa          
Gd          , Aa          , Gd          , Gd          , Aa          , Gd^Vht      , Gd          , Gd          , Gd          , Aa^Fda      , Aa^Fda      , Aa          , Gd          , Gd^Vht      , Gd          , Gd          , Aa^Ftp      , Aa^Fda      , Aa^Fda      , Aa          , Aa          , Ch          , Ch          , Cha         , Gd          , Gd          , Gd          , Gd          , Gd          , Gd          , Gd          , Aa          , Aa          , Aa^Fda      , Gd          , Gd          , Gd          , Gd          , Gd          , Gd          , Aa          , Aa          , Aa          , Aa          , Gd          , Aa          
Gd          , Gd          , Gd          , Gd          , Gd          , Gd          , Gd          , Gd          , Gd          , Aa          , Gd          , Gd          , Gd          , Gd          , Gd          , Aa          , Aa          , Aa          , Aa          , Aa          , Gd          , Ch          , Aa^Fda      , Aa          , Aa          , Gd          , Gd          , Gd          , Gd          , Gd          , Gd          , Gd          , Gd          , Gd          , Aa          , Gd          , Gd          , Aa          , Gd          , Gd          , Gd          , Gd          , Aa          , Aa          , Gd          , Gd          
Gd          , Gd          , Gd          , Gd          , Aa          , Aa          , Aa          , Aa          , Gd          , Gd          , Gd          , Aa          , Aa          , Gd          , Gd          , Gd          , Gd          , Gd          , Gd          , Gd          , Gd          , Aa          , Aa^Fda      , Aa^Fda      , Aa^Fda      , Aa          , Gd          , Gd          , Gd          , Gd          , Aa          , Gd          , Aa^Fda      , Aa          , Gd          , Gd          , Gd          , Gd          , Aa          , Gd          , Gd^Vht      , Gd          , Gd          , Gd          , Gd          , Gd          
Gd          , Aa          , Gd^Vht      , Aa          , Aa^Fda      , Aa^Fda      , Aa^Ftp      , Aa          , Gd          , Gd          , Aa          , Aa          , Aa          , Gd          , Aa          , Aa          , Gd          , Gd          , Gd          , Gd^Vht      , Gd          , Aa^Fda      , Aa          , Aa^Fda      , Aa          , Gd          , Gd          , Aa          , Gd          , Gd          , Aa          , Aa^Fda      , Aa^Ftp      , Aa          , Aa          , Gd^Vht      , Gd          , Gd          , Gd          , Gd          , Gd          , Aa          , Gd          , Gd          , Aa          , Aa          
Gd          , Aa          , Gd          , Aa          , Aa          , Aa^Ftp      , Aa          , Aa          , Gd          , Aa          , Gd          , Gd          , Gd          , Gd^Vht      , Gd          , Gd          , Aa          , Gd          , Gd          , Aa          , Gd          , Aa          , Aa          , Aa          , Cha         , Gd          , Gd          , Gd          , Gd          , Gd          , Aa          , Aa^Fda      , Aa          , Aa          , Cha         , Aa          , Aa          , Gd          , Gd          , Gd          , Aa          , Gd          , Aa          , Gd          , Gd          , Aa          
Gd          , Aa          , Gd          , Aa          , Aa          , Aa^Fda      , Aa          , Gd          , Gd          , Gd          , Aa          , Gd          , Gd          , Aa          , Aa          , Aa          , Aa          , Aa          , Gd          , Gd          , Gd          , Gd          , Cha         , 4 Kha       , Cha         , Gd          , Gd          , Gd^Vht      , Gd          , Gd          , Gd          , Aa          , Gd          , Gd          , Cha         , Cha         , Aa          , Gd          , Gd          , Aa          , Aa^Fda      , Aa          , Gd          , Gd          , Gd          , Gd          
Gd          , Gd          , Gd          , Gd          , Gd          , Aa          , Gd          , Gd^Vht      , Gd          , Aa          , Aa^Fda      , Aa          , Gd          , Aa          , Aa          , Aa^Fda      , Aa          , Gd          , Gd          , Gd          , Gd          , Gd^Vht      , Gd          , Cha         , Aa          , Aa          , Aa          , Aa          , Gd          , Gd          , Gd          , Gd          , Gd          , Gd^Vht      , Cha         , 3 Kha       , Cha         , Gd          , Gd          , Aa          , Aa^Fda      , Aa          , Gd^Vht      , Gd          , Aa          , Gd          
Gd          , Aa          , Aa          , Gd          , Gd          , Aa          , Gd          , Gd          , Gd          , Aa          , Aa          , Gd          , Gd          , Aa          , Gd          , Aa          , Gd          , Gd          , Gd          , Gd          , Aa          , Gd          , Aa          , Gd          , Gd          , Aa^Ftp      , Aa^Fda      , Aa          , Gd          , Gd          , Aa          , Gd          , Gd          , Gd          , Aa          , Cha         , Gd          , Gd          , Gd          , Aa          , Aa          , Aa          , Gd          , Gd          , Gd          , Gd          
Gd          , Gd          , Aa          , Gd          , Gd          , Gd          , Gd          , Gd          , Gd          , Gd          , Gd          , Gd          , Aa          , Gd          , Gd          , Gd          , Gd          , Gd          , Aa          , Aa^Fda      , Aa          , Gd          , Gd          , Gd          , Gd          , Aa          , Aa^Fda      , Aa^Fda      , Gd          , Aa          , Gd          , Gd          , Aa          , Aa          , Aa          , Gd          , Gd          , Gd          , Aa          , Aa          , Gd          , Gd          , Gd          , Gd          , Aa          , Gd          
Gd          , Gd          , Gd          , Gd          , Aa          , Aa          , Aa^Fda      , Aa          , Aa          , Gd          , Gd          , Aa          , Aa^Fda      , Gd          , Gd          , Gd          , Aa          , Aa          , Aa^Fda      , Aa^Fda      , Aa          , Gd          , Aa          , Gd          , Gd          , Aa          , Aa          , Aa          , Gd          , Gd          , Aa          , Gd          , Aa^Fda      , Aa          , Gd          , Gd          , Gd          , Gd          , Gd          , Gd          , Gd          , Gd          , Gd          , Gd          , Aa          , Aa          
Gd          , Gd          , Gd          , Gd          , Aa          , Aa^Ftp      , Aa^Fda      , Aa          , Aa          , Gd          , Aa          , Aa^Ftp      , Aa          , Gd          , Gd          , Gd^Vht      , Aa          , Aa^Fda      , Aa          , Aa^Ftp      , Gd          , Gd          , Aa          , Gd          , Gd          , Gd          , Gd^Vht      , Gd          , Gd          , Gd          , Gd          , Gd          , Aa          , Aa          , Gd          , Gd          , Aa          , Gd          , Gd^Vht      , Gd          , Aa          , Gd          , Gd          , Aa          , Aa^Fda      , Aa          
Gd          , Gd          , Gd          , Aa          , Aa          , Aa^Fda      , Aa          , Aa          , Gd          , Gd          , Gd          , Gd          , Gd          , Gd          , Gd          , Gd          , Aa          , Aa          , Gd          , Gd          , Gd          , Gd          , Gd          , Gd          , Gd          , Gd          , Gd          , Gd          , Gd          , Gd          , Gd          , Gd          , Gd          , Gd          , Gd          , Gd          , Gd          , Gd          , Gd          , Gd          , Gd          , Gd          , Gd          , Aa          , Aa^Fda      , Aa^Fda      
Gd          , Aa          , Gd          , Gd^Vht      , Gd          , Aa          , Gd          , Gd          , Gd^Vht      , Gd          , Gd          , Gd          , Aa          , Gd          , Aa          , Gd          , Gd          , Aa          , Aa          , Gd          , Gd          , Gd          , Aa          , Aa          , Aa          , Gd          , Gd          , Aa          , Aa          , Gd          , Aa          , Gd          , Gd          , Gd          , Aa          , Aa          , Gd          , Gd          , Aa          , Aa          , Aa          , Gd          , Gd          , Aa          , Aa          , Aa          
Gd          , Aa          , Gd          , Gd          , Gd          , Gd          , Gd          , Gd          , Aa          , Gd          , Aa          , Aa^Ftp      , Aa^Fda      , Aa^Fda      , Gd          , Gd          , Gd          , Gd          , Gd          , Gd          , Aa          , Aa          , Aa^Fda      , Aa          , Aa          , Aa          , Gd          , Gd          , Aa^Fda      , Aa^Ftp      , Aa^Fda      , Aa          , Gd          , Gd          , Gd          , Gd          , Aa          , Aa          , Aa^Fda      , Aa^Fda      , Aa          , Gd          , Gd          , Gd          , Gd          , Gd          
Aa          , Gd          , Gd          , Gd          , Gd          , Aa          , Aa          , Aa          , Gd          , Gd          , Aa^Fda      , Aa^Fda      , Aa          , Aa^Fda      , Aa          , Gd          , Gd          , Gd          , Gd          , Aa          , Aa          , Aa^Fda      , Aa^Fda      , Aa^Fda      , Aa          , Aa          , Gd          , Aa^Fda      , Aa          , Aa^Ftp      , Gd          , Gd          , Gd          , Gd          , Gd          , Aa          , Aa          , Aa^Fda      , Aa^Ftp      , Aa^Fda      , Aa          , Gd          , Gd          , Gd^Vht      , Gd          , Aa          
Gd          , Gd          , Gd          , Gd          , Gd^Vht      , Gd          , Gd          , Gd          , Gd          , Gd          , Gd          , Aa          , Gd          , Gd          , Gd          , Aa          , Gd          , Gd          , Aa          , Gd          , Gd          , Aa^Fda      , Aa          , Aa          , Aa          , Gd^Vht      , Gd          , Gd          , Gd          , Aa          , Gd          , Gd          , Aa          , Gd^Vht      , Gd          , Aa          , Gd          , Aa          , Aa          , Aa          , Gd          , Gd          , Aa          , Gd          , Aa          , Gd          
Gd          , Gd          , Aa          , Aa          , Gd          , Gd          , Aa          , Gd          , Gd          , Aa          , Gd          , Gd          , Gd          , Gd          , Gd          , Aa          , Aa          , Gd          , Gd          , Gd          , Gd          , Gd          , Gd          , Gd          , Gd          , Gd          , Gd          , Gd          , Aa          , Gd          , Gd          , Gd          , Gd          , Gd          , Gd          , Gd          , Gd          , Gd          , Gd          , Gd          , Gd          , Gd          , Gd          , Gd          , Aa          , Aa          
Gd          , Gd          , Aa          , Aa          , Aa^Ftp      , Aa          , Aa          , Gd          , Gd          , Aa          , Aa          , Gd          , Gd          , Aa          , Aa          , Aa          , Gd          , Aa          , Gd          , Gd          , Gd          , Gd          , Gd          , Gd          , Aa          , Gd          , Gd          , Gd          , Gd          , Gd          , Gd          , Gd          , Aa          , Gd          , Aa          , Gd          , Gd          , Gd          , Aa          , Gd          , Gd          , Gd          , Gd          , Gd          , Aa          , Aa          
Gd          , Gd          , Aa          , Aa^Fda      , Aa^Fda      , Aa          , Aa          , Gd          , Gd          , Gd          , Gd          , Gd^Vht      , Gd          , Aa          , Aa^Fda      , Aa          , Gd          , Gd          , Gd          , Aa          , Gd          , Gd          , Gd          , Gd          , Aa          , Aa          , Aa          , Gd          , Gd          , Gd          , Aa          , Aa          , Aa^Fda      , Aa          , Aa          , Aa          , Aa          , Gd          , Gd          , Gd          , Gd          , Aa          , Gd          , Aa          , Aa          , Aa          
Aa          , Gd          , Gd^Vht      , Aa          , Aa          , Aa          , Gd          , Gd          , Aa          , Gd          , Aa          , Gd          , Gd          , Aa^Fda      , Aa^Ftp      , Aa^Fda      , Gd          , Gd          , Aa          , Gd          , Gd          , Gd          , Gd          , Aa          , Aa^Fda      , Aa^Fda      , Aa          , Gd          , Gd          , Gd          , Aa          , Aa          , Aa^Fda      , Aa^Ftp      , Aa          , Aa          , Gd          , Gd          , Gd          , Gd^Vht      , Gd          , Gd          , Aa          , Aa          , Aa^Fda      , Aa^Fda      
Gd          , Aa          , Aa          , Gd          , Gd          , Aa          , Gd          , Aa          , Aa^Ftp      , Aa          , Gd          , Gd          , Aa          , Aa          , Aa^Ftp      , Aa          , Gd          , Gd          , Gd          , Gd          , Gd          , Gd          , Aa          , Aa^Fda      , Aa          , Aa          , Aa          , Gd          , Gd          , Gd          , Gd          , Gd          , Aa          , Aa          , Aa          , Aa          , Gd          , Gd          , Aa          , Gd          , Gd          , Aa          , Aa          , Aa^Fda      , Aa^Fda      , Aa          
Gd          , Aa          , Aa          , Aa          , Aa          , Gd          , Gd          , Aa          , Gd          , Gd          , Gd          , Gd          , Gd          , Aa          , Aa          , Aa          , Aa          , Gd^Vht      , Gd          , Gd          , Aa          , Gd          , Gd          , Aa          , Aa          , Aa          , Gd          , Gd          , Aa          , Gd          , Gd          , Gd^Vht      , Gd          , Gd          , Gd          , Gd          , Gd          , Gd          , Gd          , Gd          , Gd          , Aa          , Aa          , Aa^Fda      , Aa          , Aa          
Gd          , Aa          , Aa          , Gd          , Gd          , Gd          , Gd          , Gd          , Gd^Vht      , Gd          , Aa          , Gd          , Gd          , Gd          , Aa          , Aa^Fda      , Gd          , Gd          , Gd          , Gd          , Gd          , Gd          , Gd          , Gd          , Gd^Vht      , Gd          , Gd          , Gd          , Gd          , Gd          , Gd          , Gd          , Aa          , Gd          , Aa          , Gd          , Gd          , Gd          , Gd          , Gd          , Gd          , Aa          , Aa          , Aa          , Ha          , Ha          
Aa^Ftp      , Aa          , Aa^Ftp      , Aa^Ftp      , Aa^Ftp      , Gd          , Aa          , Gd          , Gd          , Gd          , Gd          , Gd          , Aa          , Aa          , Aa^Fda      , Aa          , Gd          , Gd          , Aa          , Gd          , Aa          , Gd          , Gd          , Gd          , Gd          , Gd          , Gd          , Gd          , Gd          , Gd          , Aa          , Gd          , Aa          , Gd          , Gd          , Gd          , Gd          , Aa          , Gd          , Gd          , Aa          , Aa          , Ha          , Ha          , Ha^Ftp      , Ha          
Aa^Ftp      , Aa^Ftp      , Aa^Ftp      , Aa^Ftp      , Aa^Ftp      , Aa^Ftp      , Gd          , Gd          , Gd          , Gd          , Gd          , Gd          , Gd          , Aa          , Gd          , Gd          , Aa          , Gd          , Gd          , Aa          , Aa          , Aa^Fda      , Aa          , Aa          , Aa^Fda      , Aa          , Gd          , Gd          , Aa          , Aa^Fda      , Aa          , Gd          , Gd          , Gd          , Chr         , Gd          , Gd          , Gd          , Gd^Vht      , Aa          , Ha          , Ha          , Ha^Fda      , Ha          , Ha          , Ha^Ftp      
Ha^Fda      , Ha^Fda      , Ha^Ftp      , Ha^Fda      , Aa          , Aa          , Gd          , Gd          , Gd          , Aa          , Aa^Ftp      , Gd          , Gd          , Gd          , Gd          , Gd          , Gd          , Gd          , Gd          , Gd          , Aa          , Aa          , Aa          , Aa          , Gd          , Gd          , Gd          , Gd          , Aa          , Aa^Fda      , Gd          , Gd          , Chr         , Chr         , Chr         , Chr         , Chr         , Gd          , Gd          , Ha          , Ha^Ftp      , Ha          , Ha          , Ha^Fda      , Ha^Fda      , Ha^Fda      
Ms          , Ha^Fda      , Ha^Fda      , Ha^Fda      , Ha^Ftp      , Aa          , Aa          , Aa^Ftp      , Aa^Ftp      , Aa^Ftp      , Aa^Ftp      , Aa          , Aa          , Aa          , Aa          , Gd          , Gd          , Gd          , Gd^Vht      , Gd          , Gd          , Gd          , Gd          , Gd          , Aa          , Gd          , Gd          , Gd          , Aa          , Aa^Fda      , Gd          , Gd          , Chr         , Chr         , Khr         , Chr         , Chr         , Gd          , Gd          , Gd          , Gd          , Ha          , Ha^Ftp      , Ha^Fda      , Ha^Ftp      , Ha^Ftp      
Ms^Xm       , Ms          , Ms          , Ms          , Ms          , Ha^Fda      , Ha          , Aa          , Aa          , Aa          , Ha          , Aa          , Ha^Fda      , Aa          , Aa          , Aa          , Ha^Fda      , Gd          , Aa          , Aa          , Gd          , Gd          , Gd          , Gd          , Gd          , Gd          , Gd^Vht      , Gd          , Gd          , Gd          , Gd          , Gd          , Gd          , 1 Chr       , Chr         , Chr         , Gd          , Gd          , Gd          , Aa          , Gd          , Aa          , Aa          , Aa          , Aa          , Ha^Fda      
Ms^Xm       , Ms          , Ms^Xm       , Ms          , Ms          , Ms          , Ms          , Ha^Fda      , Ha          , Ha          , Ms          , Ha^Ftp      , Ms          , Ha^Ftp      , Ms          , Ha^Fda      , Ha^Fda      , Ha          , Ha^Fda      , Aa          , Aa          , Gd          , Aa          , Gd          , Aa          , Gd          , Gd          , Gd          , Aa          , Gd          , Gd          , Gd          , Gd          , Gd          , Gd          , Gd          , Gd          , Gd          , Gd          , Gd          , Gd          , Gd          , Aa          , Aa          , Aa          , Aa          
Ms^Xm       , Ms^Xm       , Ms^Xm       , Ms^Xm       , Ms^Xm       , Ms          , Ms          , Ms          , Ms          , Ha^Fda      , Ms          , Ms          , Ms^Xm       , Ms          , Ms          , Ms          , Ms          , Ha^Fda      , Ha^Ftp      , Aa          , Ms          , Ha          , Ha^Fda      , Aa          , Ha          , Aa          , Ha^Fda      , Gd          , Gd          , Gd          , Gd          , Gd          , Gd          , Gd          , Ha^Fda      , Gd          , Ha^Fda      , Ha^Fda      , Ha^Ftp      , Aa          , Aa          , Aa          , Ha          , Aa          , Ha          , Aa          
Ms^Xm       , Ms^Xm       , Ms^Xm       , Ms^Xm       , Ms^Xm       , Ms^Xm       , Ms^Xm       , Ms          , Ms          , Ms          , Ms^Xm       , Ms          , Ms^Xm       , Ms^Xm       , Ms^Xm       , Ms^Xm       , Ms^Xm       , Ms          , Ms          , Ms          , Ms          , Ms          , Ms          , Ha^Ftp      , Ha^Fda      , Ha^Ftp      , Ha^Fda      , Aa          , Aa          , Aa          , Aa          , Aa          , Aa          , Aa          , Ha^Fda      , Ha          , Ha          , Ha^Fda      , Ha^Fda      , Ha^Fda      , Ha          , Ha^Ftp      , Ha^Fda      , Ha^Ftp      , Ha^Ftp      , Ha          
Ms^Xm       , Ms^Xm       , Ms^Xm       , Ms^Xm       , Ms^Xm       , Ms^Xm       , Ms^Xm       , Ms^Xm       , Ms^Xm       , Ms^Xm       , Ms^Xm       , Ms^Xm       , Ms^Xm       , Ms^Xm       , Ms^Xm       , Ms^Xm       , Ms^Xm       , Ms^Xm       , Ms^Xm       , Ms^Xm       , Ms^Xm       , Ms^Xm       , Ms^Xm       , Ms          , Ms          , Ms          , Ms          , Ha^Fda      , Ha^Fda      , Ha^Fda      , Ha          , Ha^Fda      , Ha^Fda      , Ha^Ftp      , Ha^Fda      , Ha^Fda      , Ha^Ftp      , Ha^Fda      , Ha^Ftp      , Ha^Fda      , Ha^Ftp      , Ha^Fda      , Ha^Fda      , Ha^Fda      , Ha^Fda      , Ha^Fda      
