border_size=1
usage=map

Qxua, Qxua, Qxua, Qxua, Qxua, Qxua, Qxua, Qxua, Qxua, Qxua, Qxua, Qxua, Qxua, Qxua, Qxua, Qxua, Qxua, Qxua, Qxua, Qxua, Qxua, Qxua, Qxua, Qxua, Qxua, Qxua, Qxua, Qxua, Qxua, Qxua, Qxua, Qxua, Qxua, Qxua, Qxua, Qxua, Qxua, Qxua, Qxua, Qxua, Qxua, Qxua, Qxua, Qxua, Qxua, Qxua, Qxua, Qxua, Qxua, Qxua, Qxua, Qxua
Qxua, Qxua, Qxua, Qxua, Qxua, Qxua, Qxua, Qxua, Qxua, Qxua, Qxua, Qxua, Qxua, Qxua, Qxua, Qxua, Qxua, Qxua, Qxua, Qxua, Qxua, Qxua, Qxua, Qxua, Qxua, Qxua, Qxua, Qxua, Qxua, Qxua, Qxua, Qxua, Qxua, Qxua, Qxua, Qxua, Qxua, Qxua, Qxua, Qxua, Qxua, Qxua, Qxua, Qxua, Qxua, Qxua, Qxua, Qxua, Qxua, Qxua, Qxua, Qxua
Qxua, Qxua, Qxua, Qxua, Qxua, Qxua, Qxua, Qxua, Qxua, Qxua, Qxua, Qxua, Qxua, Qxua, Qxua, Qxua, Qxua, Qxua, Qxua, Qxua, Qxua, Qxua, Qxua, Qxua, Qxua, Qxua, Qxua, Qxua, Qxua, Qxua, Qxua, Qxua, Qxua, Qxua, Qxua, Qxua, Qxua, Qxua, Qxua, Qxua, Zwsl, Qxua, Zwsl, Qxua, Qxua, Qxua, Qxua, Qxua, Qxua, Qxua, Qxua, Qxua
Qxua, Qxua, Qxua, Qxua, Qxua, Qxua, Qxua, Qxua, Qxua, Qxua, Qxua, Qxua, Qxua, Qxua, Qxua, Qxua, Qxua, Qxua, Qxua, Qxua, Qxua, Qxua, Qxua, Qxua, Qxua, Qxua, Qxua, Qxua, Qxua, Qxua, Qxua^Bw\r, Qxua, Qxua, Qxua, Qxua, Qxua, Qxua, Qxua, Zwsl, Zwsl, Uh, Zwsl, Uh, Zwsl, Zwsl, Qxua, Qxua^Bw/r, Qxua^Bw/r, Qxua, Qxua, Qxua, Qxua
Qxua, Qxua, Qxua, Qxua, Qxua, Qxua, Qxua, Qxua, Qxua, Qxua, Qxua, Qxua, Qxua, Qxua, Qxua, Qxua, Qxua, Qxua, Qxua, Qxua, Qxua, Qxua, Qxua, Qxua, Qxua, Qxua, Qxua, Qxua, Qxua, Qxua, Qxua, Qxua^Bw\r, Qxua^Bw\r, Qxua, Zwsl^Vzps, Qxua, Zwsl, Zwsl, Md, Uh, Md, Md, Md, Uh, Uh, Zwsl, Qxua, Qxua, Qxua, Qxua, Qxua, Qxua
Qxua, Qxua, Qxua, Qxua, Qxua, Qxua, Qxua, Qxua, Qxua, Qxua, Qxua, Qxua, Qxua, Qxua, Qxua, Qxua, Qxua, Qxua, Qxua, Qxua, Qxua, Qxua, Qxua, Qxua, Qxua, Qxua, Qxua, Qxua, Qxua, Qxua, Qxua, Qxua, Qxua, Zwsl, Zwsl, Zwsl, Md, Md, Md^Xm, Md^Xm, Md^Xm, Md, Md, Md, Uh, Zwsl, Zwsl, Qxua, Qxua, Qxua, Qxua, Qxua
Qxua, Qxua, Qxua, Qxua, Qxua, Qxua, Qxua, Qxua, Qxua, Qxua, Qxua, Qxua, Qxua, Qxua, Qxua, Qxua, Qxua, Qxua, Qxua, Qxua, Qxua, Qxua, Qxua, Qxua, Qxua, Qxua, Qxua, Qxua, Qxua, Qxua, Qxua, Qxua, Zvw, Zwsl, Md, Md, Md^Xm, Md^Xm, Xu, Md^Xm, Md^Xm, Md^Xm, Md^Xm, Md, Uh, Zwsl, Zwsl^Vzps, Qxua, Qxua, Qxua, Qxua, Qxua
Qxua, Qxua, Qxua, Qxua, Qxua, Qxua, Qxua, Qxua, Qxua, Qxua, Qxua, Qxua, Qxua, Qxua, Qxua, Qxua, Qxua, Qxua, Qxua, Qxua, Qxua, Qxua, Qxua, Qxua, Qxua, Qxua, Qxua, Qxua, Qxua, Qxua, Zvw, Zvw, Uh, Md, Md^Xm, Md^Xm, Xu, Xu, Ur, Xu, Xu, Md^Xm, Md^Xm, Md, Uh, Zwsl, Qxua, Qxua, Qxua, Qxua, Qxua, Qxua
Zwsl, Qxua, Qxua, Qxua, Qxua, Qxua, Qxua, Qxua, Qxua, Qxua, Qxua, Qxua, Qxua, Qxua, Qxua, Qxua, Qxua, Qxua, Qxua, Qxua, Qxua, Qxua, Qxua, Qxua, Qxua, Qxua, Zvw, Zwsl, Zwsl, Zvw, Zvw, Uh, Uh, Md, Md^Xm, Md^Xm, Xu, Ur, Xu, Ur, Xu, Md^Xm, Md^Xm, Md, Uh, Zwsl, Zvw, Qxua, Qxua, Qxua, Qxua, Qxua
Zwsl, Zvw, Zvw, Qxua, Qxua, Qxua, Qxua, Qxua, Qxua, Qxua, Qxua, Qxua, Qxua, Qxua, Qxua, Qxua, Qxua, Qxua, Qxua, Qxua, Qxua, Zwsl, Zwsl, Qxua, Zvw, Zvw, Zwsl, Zwsl^Vzps, Zwsl, Zwsl, Zvw, Uh, Uh, Md, Md, Md^Xm, Xu, Ur, Xu, Ur, Xu, Md^Xm, Md^Xm, Md, Md, Uh, Zvw, Qxua, Qxua, Qxua, Qxua, Qxua
Zwsl, Zwsl, Zvw, Qxua, Zwsl, Zvw, Zvw, Qxua, Qxua, Qxua, Qxua, Qxua, Qxua, Qxua, Qxua, Qxua, Zwsl, Qxua, Zwsl, Qxua, Chr, Chr, Zvw, Zvw, Zvw, Zwsl, Zwsl, Zwsl, Zwsl, Zwsl, Zwsl, Uh, Zwsl, Uh, Zwsl, Md^Xm, Zwsl, Xu, Ur, Ur, Xu, Md^Xm, Md^Xm, Md, Md, Uh, Zvw, Qxua, Qxua, Qxua, Qxua, Qxua
Zwsl, Zvw, Zwsl, Zwsl, Zwsl, Zvw, Zvw, Zvw, Zvw, Qxua, Qxua, Qxua, Qxua, Qxua, Zwsl, Zwsl, Zwsl, Zwsl, Zwsl, Zvw, Chr, Chr, Zwsl, Zvw, Zvw, Zvw, Zvw, Uh, Uh, Zwsl, Zvw, Zwsl, Zwsl, Zwsl, Md, Zwsl, Xu, Zwsl, Xu, Xu, Md^Xm, Md^Xm, Mv, Md, Uh, Uh, Zvw, Qxua, Qxua, Qxua, Qxua, Qxua
Zwsl, Zwsl, Zwsl, Zwsl, Zwsl, Zwsl, Zwsl, Qlf, Qlf, Zvw, Zwsl, Qxua, Zvw, Zwsl, Zwsl, Zwsl, Zwsl, Zwsl, Zwsl, Zvw^Vzps, Chr, Chr, Zwsl, Zwsl, Zvw, Zvw, Zwsl, Uh, Uh, Uh, Zvw, Zvw, Zvw, Zvw, Md, Md^Xm, Md^Xm, Xu, Md^Xm, Md^Xm, Md^Xm, Md^Xm, Md, Qlf, Uh, Zwsl, Zwsl, Zvw^Vzps, Qxua, Qxua, Qxua, Qxua
Zwsl, Zwsl, Zwsl, Zwsl, Zvw, Zwsl, Zwsl, Qlf, Zvw, Zvw, Zvw, Zvw, Zvw, Zvw, Qlf, Qlf, Zwsl, Zwsl, Zwsl, Chr, Chr, Chr, Zwsl, Zvw, Zwsl, Zvw, Zvw, Uh, Zwsl, Zwsl, Zwsl, Zwsl, Zwsl, Zwsl, Uh, Md, Md, Md^Xm, Md, Md^Xm, Md, Md, Md, Qlf, Uh, Zwsl, Zwsl, Zwsl, Qxua^Bw\r, Qxua, Qxua, Qxua
Zvw, Zvw, Zwsl, 1 Zwsl, Zvw, Zwsl, Zwsl, Zvw, Zvw, Zvw, Zvw, Zvw^Vzps, Zvw, Zvw, Zwsl, Qlf, Zvw, Zwsl, Chr, Chr, 2 Khr, Zwsl, Zwsl, Zwsl, Zwsl, Zwsl, Zvw, Zvw, Zvw, Zwsl, Zwsl, Zwsl, Zwsl, Zvw, Uh, Md, Md, Md, Uh, Md, Uh, Md, Uh, Qlf, Qlf^Bs/, Zwsl, Zwsl, Qxua, Qxua, Qxua^Bw\r, Qxua, Qxua
Zvw, Zvw, Zvw, Zvw, Zwsl, Zwsl, Zwsl, Zvw, Zwsl, Zvw, Zvw, Zvw, Zwsl, Zvw, Zwsl, Zvw, Zvw, Zvw, Chr, Chr, Zwsl, Zwsl, Zvw, Zvw, Zwsl, Zwsl, Zwsl, Zvw, Zvw, Zwsl, Zwsl, Zwsl^Vzps, Zwsl, Zvw, Uh, Md, Md, Uh, Uh, Uh, Zwsl, Uh, Uh, Uh, Qlf, Zwsl, Zwsl, Qxua, Qxua, Qxua, Qxua, Qxua
Zvw, Zvw, Zvw, Zwsl, Zvw^Vzps, Zvw, Zwsl, Zwsl, Qlf, Qlf, Qlf, Zwsl, Zvw, Zvw, Zvw, Zvw, Zvw, Zvw, Chr, Chr, Zwsl, Zvw, Zwsl, Zvw^Vzps, Zwsl, Zwsl, Zvw, Zwsl, Uh, Zwsl, Zwsl, Zwsl, Zvw, Zvw, Zvw, Uh, Uh, Uh, Uh, Zvw, Zvw, Zwsl, Zvw, Uh, Qlf, Zwsl, Zwsl^Vzps, Qxua, Qxua, Qxua, Qxua, Qxua
Zwsl, Zvw, Zvw, Zvw, Zwsl, Zwsl, Zwsl, Zvw, Zvw, Qlf, Qlf, Zvw, Zvw, Zvw, Zvw, Zvw, Zvw, Zvw, Chr, Chr, Zwsl, Zvw, Zwsl, Zwsl, Zwsl, Zvw, Zwsl, Uh, Md, Uh, Uh, Zvw, Zwsl, Zwsl, Zvw, Zvw, Zvw, Uh, Zvw, Zvw, Zvw, Uh, Uh, Uh, Qlf, Zvw, Zvw, Zwsl, Qxua, Qxua, Qxua, Qxua
Qxua, Zwsl, Qxua, Zwsl, Zwsl, Zwsl, Zvw, Zvw, Zwsl, Zwsl, Zwsl, Zwsl, Zwsl, Zvw, Zvw, Zvw^Vzps, Zwsl, Zwsl, Chr, Chr, Zvw, Zwsl, Zvw, Zwsl, Zwsl, Zwsl, Qlf, Uh, Uh, Md, Uh, Uh, Zwsl, Zvw, Zwsl, Zvw, Zvw, Zvw^Vzps, Zvw, Zvw, Zvw, Uh, Md, Md, Uh, Qlf, Qlf^Bs/, Zwsl, Zwsl, Qxua, Qxua, Qxua
Qxua, Qxua, Qxua, Qxua, Qxua, Zwsl, Zwsl, Zvw, Zwsl, Zwsl, Zvw, Zvw, Qlf, Zvw, Zvw, Zvw, Zvw, Chr, Chr, Chr, Zwsl, Zwsl, Zwsl, Zvw, Zwsl, Zwsl, Qlf, Qlf, Qlf, Uh, Uh, Uh, Zwsl, Zwsl, Zwsl, Zwsl, Zwsl, Zvw, Zwsl, Zwsl, Zvw, Uh, Uh, Uh, Zwsl, Zvw, Zvw, Qlf, Qlf, Zwsl, Qxua, Qxua
Qxua, Qxua, Qxua, Qxua, Qxua, Zwsl, Zwsl, Zvw, Zvw, Zvw, Zvw, Zvw, Qlf, Qlf, Zwsl, Zwsl, Zwsl, Chr, Chr, Zvw, Zwsl, Zwsl, Zwsl, Zwsl, Zwsl^Vzps, Zwsl, Zwsl, Qlf, Qlf, Qlf, Zwsl, Zwsl, Zwsl, Zwsl, Zwsl, Zwsl, Zvw, Zwsl, Zvw, Zwsl, Zwsl, Zvw, Zwsl^Vzps, Zwsl, Zvw, Zvw, Zvw, Zwsl, Qxua, Zwsl, Qxua, Qxua
Qxua, Qxua, Qxua, Qxua, Qxua, Qxua, Qxua, Qxua, Zvw, Zvw, Zvw, Zvw, Zvw, Zvw, Zwsl, Zwsl, Chr, Chr, 3 Khr, Zwsl, Zwsl, Zwsl, Zwsl, Zwsl, Zwsl, Zwsl, Zwsl, Zwsl, Zwsl, Zwsl, Zwsl, Zwsl, Zwsl^Vzps, Zwsl, Zwsl, Zwsl, Zwsl, Zvw, Zvw, Zwsl, Zwsl, Zwsl, Zwsl, Zwsl, Zwsl, Zvw, Zvw, Qxua, Qxua, Qxua, Qxua, Qxua
Qxua, Qxua, Qxua, Qxua, Qxua, Qxua, Qxua, Qxua, Qxua, Zvw, Zwsl, Zvw, Zwsl, Zvw, Zvw, Zvw, Chr, Chr, Zvw, Zvw, Zwsl, Zwsl, Zwsl, Zwsl, Zwsl, Zwsl, Zwsl, Zwsl, Zwsl, Zwsl, Zwsl, Zwsl, Zwsl, Zwsl, Zwsl, Zwsl, Zvw, Zvw, Chr, Zvw, Zvw, Zvw, Zvw, Zwsl, Zwsl, Zvw, Qxua, Qxua^Bw\r, Qxua^Bw\r, Qxua, Qxua, Qxua
Qxua, Qxua, Qxua, Qxua, Qxua, Qxua, Qxua, Qxua, Qxua, Qxua, Qxua, Zwsl, Zwsl, Zwsl, Zvw, Zvw, Chr, Chr, Zwsl, Zwsl, Zvw, Zwsl, Zwsl, Zwsl, Zwsl, Zwsl, Zwsl, Zwsl, Uh, Uh, Uh, Zwsl, Zwsl, Zwsl, Zvw, Zvw, Zwsl, Chr, Chr, Chr, Chr, Zwsl, Zvw, Zwsl, Zvw, Zwsl, Qxua, Qxua, Qxua, Qxua, Qxua, Qxua
Qxua, Qxua, Qxua, Qxua, Qxua, Qxua, Qxua, Qxua, Qxua, Qxua, Qxua, Qxua, Qxua, Zvw, Chr, Chr, Chr, Chr, Zvw, Zvw, Zvw^Vzps, Zvw, Zwsl, Zwsl, Zwsl, Zwsl, Zvw, Uh, Uh, Md, Md, Uh, Zwsl, Zwsl, Zwsl, Zwsl, Chr, Chr, Chr, 4 Khr, Chr, Chr, Zvw, Zvw, Zvw, Qxua, Qxua, Qxua, Qxua, Qxua, Qxua, Qxua
Qxua, Qxua, Qxua, Qxua, Qxua, Qxua, Qxua, Qxua, Qxua, Qxua, Qxua, Qxua, Qxua, Chr, Chr, Chr, Zwsl, Zvw, Zvw, Zvw, Zvw, Zvw, Zwsl, Zvw, Zvw, Zvw, Zvw, Zvw, Uh, Uh, Uh, Uh, Zwsl, Zwsl, Zwsl, Zvw, Zwsl, Chr, Chr, Chr, Chr, Zvw, Zvw, Zvw, Zvw, Qxua, Qxua, Qxua, Qxua, Qxua, Qxua, Qxua
Qxua, Qxua, Qxua, Qxua, Qxua, Qxua, Qxua, Qxua, Qxua, Qxua, Qxua, Qxua, Qxua, Qxua, Qxua, Zvw, Zvw, Zvw, Zvw, Zvw, Zvw, Zvw, Zvw, Zvw, Zwsl^Vzps, Zvw, Zwsl, Zvw, Zvw, Uh, Zvw, Uh, Zwsl^Vzps, Zwsl, Zwsl, Zvw, Zwsl, Zwsl, Zwsl, Zwsl, Zwsl, Zwsl, Zwsl, Zvw, Qxua, Qxua, Qxua, Qxua, Qxua, Qxua, Qxua, Qxua
Qxua, Qxua, Qxua, Qxua, Qxua, Qxua, Qxua, Qxua, Qxua, Qxua, Qxua, Qxua, Qxua, Qxua, Qxua, Qxua, Qxua, Qxua, Qxua, Zvw, Zvw, Zvw, Zwsl, Zwsl, Zwsl, Zwsl, Zwsl, Zwsl, Zwsl, Zwsl, Zvw, Zwsl, Zvw, Zwsl, Zwsl, Zwsl, Zwsl, Zwsl, Zwsl, Zwsl^Vzps, Zwsl, Zwsl, Zvw, Zvw, Qxua, Qxua, Qxua, Qxua, Qxua, Qxua, Qxua, Qxua
Qxua, Qxua, Qxua, Qxua, Qxua, Qxua, Qxua, Qxua, Qxua, Qxua, Qxua, Qxua, Qxua, Qxua, Qxua, Qxua, Qxua, Qxua, Qxua, Zvw, Qxua, Qxua, Qxua, Zvw, Zvw, Zwsl, Zvw, Zwsl, Zvw, Zwsl, Zvw, Zvw, Zvw, Zwsl, Zvw, Qxua, Qxua, Zwsl, Zvw, Zvw, Zvw, Zvw, Qxua, Qxua^Bw\r, Qxua^Bw\r, Qxua, Qxua, Qxua, Qxua, Qxua, Qxua, Qxua
Qxua, Qxua, Qxua, Qxua, Qxua, Qxua, Qxua, Qxua, Qxua, Qxua, Qxua, Qxua, Qxua, Qxua, Qxua, Qxua, Qxua, Qxua, Qxua, Qxua, Qxua, Qxua, Qxua^Bw/r, Qxua^Bw/r, Qxua, Zwsl, Zwsl, Qxua, Qxua, Zvw, Qxua, Zvw, Zvw, Zvw, Qxua, Qxua, Qxua^Bw/r, Qxua^Bw/r, Qxua, Qxua, Qxua, Qxua, Qxua, Qxua, Qxua, Qxua^Bw\r, Qxua, Qxua, Qxua, Qxua, Qxua, Qxua
Qxua, Qxua, Qxua, Qxua, Qxua, Qxua, Qxua, Qxua, Qxua, Qxua, Qxua, Qxua, Qxua, Qxua, Qxua, Qxua, Qxua, Qxua, Qxua, Qxua, Qxua, Qxua, Qxua, Qxua, Qxua, Qxua, Qxua, Qxua, Qxua, Qxua, Qxua, Qxua, Qxua, Qxua, Qxua, Qxua, Qxua, Qxua, Qxua, Qxua, Qxua, Qxua, Qxua, Qxua, Qxua, Qxua, Qxua, Qxua, Qxua, Qxua, Qxua, Qxua
Qxua, Qxua, Qxua, Qxua, Qxua, Qxua, Qxua, Qxua, Qxua, Qxua, Qxua, Qxua, Qxua, Qxua, Qxua, Qxua, Qxua, Qxua, Qxua, Qxua, Qxua, Qxua, Qxua, Qxua, Qxua, Qxua, Qxua, Qxua, Qxua, Qxua, Qxua, Qxua, Qxua, Qxua, Qxua, Qxua, Qxua, Qxua, Qxua, Qxua, Qxua, Qxua, Qxua, Qxua, Qxua, Qxua, Qxua, Qxua, Qxua, Qxua, Qxua, Qxua
