border_size=1
usage=map

Gg^Ve       , Gs^Fds      , Gs^Fds      , Gs^Fds      , Gs^Fds      , Gs^Fds      , Gs^Fds      , Gs^Fds      , Gs^Fds      , Hh^Fds      , Hh^Fds      , Hh^Fds      , Hh^Fds      , Hh^Fds      , Hh^Fds      , Hh^Fds      , Hh^Fds      , Hh^Fds      , Mm          , Mm          , Mm          , Mm          , Mm          , Mm          , Mm          , Mm          , Mm          , Hh^Fds      , Ww          , Ww          , Rp          , Hh^Fds      , Mm          , Mm          , Mm          , Hh^Fds      , Hh^Fds      , Hh^Fds      , Hh^Fds      , Hh^Fds      , Hh^Fds      , Hh^Fds      , Hh^Fds      , Hh^Fds      , Hh^Fds      , Hh^Fds      
Gs^Fds      , Gs^Fds      , Gs^Fms      , Gs^Fds      , Gs^Fms      , Gg^Ve       , Gs^Fds      , Gs^Fds      , Gs^Fds      , Hh^Fds      , Hh^Fds      , Hh^Fds      , Hh^Fds      , Hh^Fds      , Hh^Fds      , Hh^Fds      , Mm          , Mm          , Mm          , Mm          , Hh^Fds      , Ww          , Mm          , Mm          , Mm          , Mm          , Mm          , Hh^Fds      , Ww          , Hh^Fms      , Ce          , Ce          , Mm          , Mm          , Mm          , Hh^Fds      , Hh^Fds      , Hh^Fds      , Hh^Fds      , Hh^Fds      , Hh^Fds      , Hh^Fds      , Hh^Fds      , Hh^Fds      , Hh^Fds      , Hh^Fds      
Gs^Fds      , Gs^Fms      , Gs^Fms      , Gs^Fms      , Gs^Fms      , Gs^Fds      , Gs^Fds      , Gs^Fds      , Hh^Fds      , Hh^Fds      , Hh^Fds      , Gs^Fds      , Hh^Fds      , Hh^Fds      , Mm          , Mm          , Mm          , Mm          , Hh^Fds      , Hh^Fds      , Ww          , Ww          , Hh^Fds      , Mm          , Mm          , Ww          , Mm          , Hh^Fds      , Ww          , Hh^Fms      , Ce          , Ce          , Ce          , Mm          , Mm          , Hh^Fds      , Hh^Fds      , Hh^Fds      , Hh^Fds      , Hh^Fds      , Gg^Ve       , Hh^Fds      , Hh^Fds      , Hh^Fds      , Hh^Fds      , Hh^Fms      
Gs^Fms      , Gs^Fms      , Gs^Fds      , Gs^Fds      , Gs^Fms      , Gs^Fds      , Gs^Fds      , Gs^Fds      , Hh^Fds      , Gs^Fds      , Hh^Fds      , Hh^Fds      , Mm          , Mm          , Hh^Fms      , Mm          , Hh^Fds      , Hh^Fms      , Ww          , Ww          , Hh^Vhh      , Hh^Fds      , Mm          , Mm          , Ww          , Ww          , Mm          , Hh^Vhh      , Ww          , Ce          , Ce          , 1 Kea       , Ce          , Ce          , Mm          , Mm          , Mm          , Hh^Fms      , Hh^Fds      , Hh^Fds      , Gs^Fds      , Gs^Fds      , Gs^Fds      , Gs^Fds      , Hh^Fds      , Gs^Fds      
Gs^Fms      , Gs^Fds      , Gs^Fms      , Gs^Fms      , Gs^Fds      , Gs^Fds      , Gs^Fds      , Hh^Fds      , Ww          , Gs^Fds      , Hh^Fms      , Hh^Fds      , Hh^Fds      , Hh^Fds      , Ww          , Ww          , Ww          , Ww          , Mm          , Hh^Fds      , Mm          , Mm          , Hh^Fds      , Ww          , Hh^Fds      , Mm          , Mm          , Mm          , Mm          , Ww          , Ww          , Ce          , Hh^Fds      , Hh^Fds      , Hh^Fds      , Mm          , Mm          , Mm          , Mm          , Hh^Fds      , Gs^Fds      , Hh^Fds      , Hh^Fms      , Gs^Fds      , Gs^Fds      , Gs^Fds      
Gs^Fms      , Gs^Fds      , Gg^Ve       , Gs^Fds      , Gs^Fds      , Gs^Fds      , Ww          , Ww          , Hh^Fds      , Ww          , Ww          , Hh^Fds      , Ww          , Ww          , Mm          , Hh^Fms      , Mm          , Mm          , Mm          , Mm          , Hh^Fms      , Hh^Fds      , Ww          , Ww          , Mm          , Mm          , Mm          , Mm          , Mm          , Mm          , Ww          , Rp          , Hh^Fds      , Hh^Fds      , Hh^Fds      , Hh^Fds      , Hh^Fds      , Mm          , Mm          , Hh^Fds      , Hh^Fds      , Gs^Fds      , Gs^Fds      , Hh^Fds      , Gg^Ve       , Gs^Fds      
Gs^Fds      , Gs^Fms      , Gs^Fds      , Gs^Fds      , Gs^Fms      , Gs^Fds      , Ww          , Hh^Fds      , Hh^Fds      , Hh^Fds      , Hh^Fds      , Ww          , Mm          , Mm          , Mm          , Mm          , Mm          , Mm          , Ww          , Hh^Fds      , Ww          , Ww          , Hh^Fds      , Hh^Fds      , Mm          , Mm          , Mm          , Hh^Fds      , Hh^Vhh      , Mm          , Ww^Bw/r     , Rp          , Ww          , Hh^Fds      , Hh^Fds      , Hh^Fds      , Hh^Fds      , Hh^Fds      , Hh^Fms      , Hh^Fds      , Hh^Fds      , Gs^Fds      , Gs^Fds      , Gs^Fds      , Gs^Fds      , Gs^Fds      
Gs^Fds      , Gs^Fms      , Gs^Fms      , Gs^Fds      , Gs^Fds      , Gs^Fds      , Ww          , Gs^Fds      , Hh^Fds      , Hh^Fds      , Hh^Fds      , Hh^Fds      , Mm          , Mm          , Mm          , Mm          , Ww          , Ww          , Hh^Fds      , Ww          , Hh^Fms      , Hh^Fms      , Mm          , Mm          , Mm          , Ww          , Ww          , Hh^Fds      , Hh^Fds      , Rp          , Mm          , Ww          , Mm          , Ww          , Ww          , Ww          , Ww          , Hh^Vhh      , Hh^Fds      , Hh^Fds      , Hh^Fms      , Gs^Fds      , Hh^Fds      , Gs^Fds      , Gs^Fds      , Gs^Fds      
Gs^Fds      , Gs^Fds      , Gs^Fds      , Gs^Fds      , Gs^Fds      , Gs^Fds      , Ww          , Hh^Fds      , Hh^Fms      , Hh^Fds      , Hh^Vhh      , Mm          , Mm          , Mm          , Hh^Fds      , Hh^Fds      , Ww          , Hh^Fms      , Hh^Vhh      , Hh^Fms      , Hh^Fds      , Mm          , Mm          , Mm          , Mm          , Mm          , Mm          , Ww          , Ww          , Rp          , Hh^Fds      , Mm          , Mm          , Mm          , Mm          , Mm          , Mm          , Ww          , Ww          , Hh^Fds      , Hh^Fds      , Hh^Fms      , Hh^Fds      , Gs^Fds      , Gs^Fds      , Gs^Fms      
Gs^Fds      , Gs^Fms      , Gs^Fds      , Gg^Ve       , Gs^Fds      , Ww          , Gs^Fds      , Hh^Fms      , Hh^Fds      , Hh^Fds      , Mm          , Mm          , Mm          , Mm          , Ww          , Ww          , Hh^Fds      , Hh^Fds      , Mm          , Mm          , Mm          , Mm          , Mm          , Mm          , Mm          , Mm          , Mm          , Mm          , Ww          , Rp          , Rp          , Hh^Fds      , Mm          , Mm          , Mm          , Mm          , Mm          , Mm          , Hh^Fds      , Ww          , Ww          , Gs^Fds      , Hh^Fds      , Hh^Fds      , Gs^Fds      , Gs^Fds      
Gs^Fms      , Gs^Fds      , Gs^Fds      , Gs^Fds      , Gs^Fds      , Ww          , Hh^Fds      , Hh^Fds      , Mm          , Mm          , Mm          , Mm          , Hh^Fds      , Ww          , Hh^Fds      , Hh^Fds      , Hh^Fds      , Mm          , Mm          , Mm          , Mm          , Mm          , Mm          , Ww          , Ww          , Mm          , Hh^Fds      , Mm          , Mm          , Ww          , Ww^Bw/r     , Rp          , Rp          , Mm          , Mm          , Mm          , Mm          , Mm          , Mm          , Mm          , Hh^Fds      , Ww          , Ww          , Hh^Fds      , Gs^Fds      , Gs^Fds      
Gs^Fms      , Gs^Fds      , Gs^Fds      , Gs^Fms      , Gs^Fds      , Ww          , Gs^Fds      , Hh^Fds      , Mm          , Mm          , Hh^Fds      , Hh^Fds      , Ww          , Ww          , Mm          , Hh^Fds      , Mm          , Mm          , Ww          , Mm          , Rp          , Rp          , Rp          , Mm          , Ww          , Hh^Fds      , Hh^Vhh      , Mm          , Mm          , Rp          , Mm          , Ww          , Hh^Fds      , Rp          , Rp          , Mm          , Hh^Fds      , Mm          , Hh^Fds      , Mm          , Hh^Fds      , Hh^Fds      , Ww          , Gs^Fms      , Gs^Fms      , Gs^Fds      
Gs^Fds      , Gs^Fds      , Gs^Fds      , Gs^Fds      , Gs^Fds      , Ww          , Hh^Fds      , Hh^Fds      , Mm          , Mm          , Ww          , Ww          , Mm          , Mm          , Mm          , Mm          , Mm          , Hh^Fms      , Ww          , Rp          , Hh^Fds      , Mm          , Rp          , Mm          , Mm          , Ww          , Ww          , Hh^Fds      , Rp          , Rp          , Mm          , Ww          , Ww          , Hh^Fds      , Ww          , Rp          , Rp          , Hh^Fds      , Hh^Fds      , Hh^Fds      , Gs^Fds      , Hh^Fds      , Hh^Fds      , Ww          , Gs^Fds      , Gs^Fds      
Gs^Fds      , Gg^Ve       , Gs^Fds      , Gs^Fds      , Ww          , Ww          , Hh^Fms      , Mm          , Ww          , Ww          , Mm          , Mm          , Rp          , Mm          , Rp          , Rp          , Ww^Bw\r     , Ww          , Rp          , Rp          , Mm          , Mm          , Mm          , Rp          , Rp          , Mm          , Ww          , Hh^Fds      , Rp          , Mm          , Mm          , Hh^Fds      , Hh^Fds      , Ww          , Hh^Fms      , Ww          , Ww          , Rp          , Ww^Bw\r     , Ww          , Ww          , Gs^Fds      , Hh^Fds      , Ww          , Ww          , Gs^Fds      
Gs^Fds      , Gs^Fds      , Gs^Fms      , Gs^Fds      , Ww          , Hh^Fds      , Rp          , Hh^Fms      , Ww^Bw/r     , Rp          , Rp          , Rp          , Hh^Fds      , Rp          , Chr         , Chr         , Ww          , Rp          , Mm          , Mm          , Mm          , Mm          , Ww          , Hh^Fds      , Rp          , Mm          , Rp          , Ww^Bw/r     , Ww          , Hh^Fds      , Hh^Fms      , Mm          , Mm          , Mm          , Mm          , Hh^Vhh      , Hh^Fds      , Ww          , Hh^Fds      , Rp          , Rp          , Ww          , Ww          , Gg^Ve       , Ww          , Gs^Fds      
Gs^Fds      , Gs^Fds      , Gs^Fds      , Ww          , Rp          , Rp          , Ww          , Ww^Bw\r     , Hh^Fds      , Mm          , Mm          , Mm          , Hh^Fds      , Chr         , 3 Khr       , Chr         , Ww          , Mm          , Mm          , Mm          , Mm          , Hh^Fds      , Hh^Fds      , Ww          , Hh^Fds      , Rp          , Hh^Fds      , Hh^Fds      , Hh^Fds      , Ww          , Ww          , Mm          , Mm          , Mm          , Mm          , Mm          , Mm          , Mm          , Mm          , Hh^Fds      , Hh^Fds      , Rp          , Ww          , Gs^Fms      , Ww          , Gs^Fds      
Gs^Fds      , Gs^Fds      , Rp          , Ww^Bw/r     , Ww          , Ww          , Hh^Fds      , Gs^Fds      , Mm          , Mm          , Ww          , Ww          , Ww          , Ww          , Ww          , Ww          , Mm          , Mm          , Mm          , Mm          , Hh^Fds      , Hh^Vhh      , Hh^Fms      , Ww          , Hh^Fms      , Rp          , Hh^Fds      , Mm          , Mm          , Hh^Fds      , Ww          , Mm          , Mm          , Mm          , Mm          , Mm          , Mm          , Mm          , Mm          , Mm          , Hh^Fds      , Rp          , Rp          , Ww          , Gs^Fds      , Gs^Fds      
Rp          , Rp          , Gs^Fds      , Ww          , Hh^Fds      , Gs^Fds      , Hh^Fds      , Mm          , Mm          , Mm          , Ww          , Hh^Fms      , Hh^Fds      , Hh^Fds      , Mm          , Mm          , Mm          , Mm          , Mm          , Mm          , Hh^Fms      , Hh^Fms      , Ww          , Ww          , Rp          , Rp          , Rp          , Hh^Fds      , Mm          , Hh^Fds      , Ww          , Hh^Fds      , Hh^Fds      , Mm          , Mm          , Mm          , Mm          , Mm          , Mm          , Mm          , Mm          , Hh^Fds      , Gs^Fds      , Ww^Bw\r     , Rp          , Gs^Fds      
Gs^Fds      , Gs^Fds      , Gs^Fds      , Ww          , Hh^Fds      , Gs^Fds      , Hh^Fds      , Mm          , Hh^Fds      , Hh^Fds      , Ww          , Hh^Fds      , Hh^Fds      , Mm          , Mm          , Mm          , Mm          , Mm          , Mm          , Hh^Fms      , Ww          , Ww          , Hh^Fds      , Rp          , Mm          , Mm          , Rp          , Hh^Fms      , Mm          , Mm          , Hh^Fds      , Ww          , Ww          , Hh^Fds      , Hh^Fms      , Hh^Fms      , Hh^Fds      , Mm          , Hh^Fds      , Mm          , Mm          , Hh^Fds      , Gs^Fds      , Ww          , Gs^Fds      , Rp          
Gs^Fds      , Gs^Fms      , Gs^Fds      , Ww          , Ww          , Hh^Fms      , Hh^Fms      , Hh^Fds      , Ww          , Ww          , Hh^Fds      , Hh^Fds      , Hh^Fds      , Mm          , Mm          , Mm          , Mm          , Mm          , Ww          , Ww          , Hh^Fms      , Hh^Fds      , Rp          , Rp          , Mm          , Mm          , Mm          , Rp          , Mm          , Mm          , Mm          , Hh^Fds      , Ww          , Hh^Fds      , Ww          , Hh^Fds      , Hh^Fds      , Hh^Fds      , Hh^Vhh      , Hh^Fms      , Hh^Fds      , Mm          , Ww          , Ww          , Gs^Fds      , Gs^Fds      
Gs^Fds      , Gg^Ve       , Gs^Fds      , Gs^Fds      , Gs^Fds      , Ww          , Ww          , Ww          , Hh^Fds      , Hh^Fds      , Hh^Fds      , Hh^Fds      , Mm          , Mm          , Mm          , Mm          , Hh^Fds      , Hh^Fds      , Ww          , Hh^Fds      , Rp          , Rp          , Mm          , Mm          , Mm          , Mm          , Mm          , Rp          , Rp          , Mm          , Mm          , Hh^Fds      , Mm          , Ww          , Hh^Fds      , Ww          , Ww          , Hh^Fds      , Hh^Fds      , Hh^Fds      , Ww          , Ww          , Gs^Fds      , Gs^Fds      , Gs^Fds      , Gs^Fds      
Gs^Fds      , Gs^Fms      , Gs^Fds      , Gs^Fds      , Hh^Fds      , Ww          , Gs^Fds      , Hh^Fds      , Mm          , Hh^Fds      , Mm          , Mm          , Mm          , Mm          , Hh^Fds      , Hh^Fms      , Ww          , Ww          , Rp          , Hh^Vhh      , Rp          , Mm          , Mm          , Mm          , Mm          , Mm          , Mm          , Ww          , Ww          , Rp          , Hh^Fds      , Mm          , Mm          , Mm          , Mm          , Hh^Fds      , Hh^Fds      , Ww          , Ww          , Ww          , Hh^Fds      , Ww          , Ww          , Gs^Fms      , Gg^Ve       , Gs^Fds      
Gs^Fds      , Gs^Fds      , Gs^Fds      , Hh^Fds      , Ww          , Ww          , Hh^Fds      , Mm          , Mm          , Mm          , Mm          , Mm          , Hh^Fms      , Hh^Fms      , Ww          , Ww          , Rp          , Rp          , Mm          , Rp          , Mm          , Mm          , Mm          , Mm          , Mm          , Mm          , Hh^Fds      , Hh^Fds      , Ww          , Rp          , Hh^Fms      , Mm          , Mm          , Mm          , Mm          , Hh^Fds      , Hh^Fds      , Hh^Fds      , Hh^Fds      , Hh^Fds      , Chr         , Chr         , Ww          , Gs^Fds      , Gs^Fds      , Gs^Fds      
Gs^Fds      , Gs^Fds      , Ww          , Ww          , Hh^Fds      , Gs^Fds      , Hh^Fds      , Mm          , Mm          , Mm          , Mm          , Hh^Fds      , Hh^Vhh      , Ww          , Hh^Fms      , Rp          , Mm          , Mm          , Mm          , Mm          , Mm          , Mm          , Mm          , Mm          , Mm          , Mm          , Hh^Fds      , Hh^Fds      , Ww          , Rp          , Mm          , Mm          , Mm          , Mm          , Mm          , Mm          , Hh^Fds      , Hh^Fds      , Hh^Fms      , Chr         , Khr         , Chr         , Ww          , Gs^Fds      , Gs^Fds      , Gs^Fds      
Gs^Fms      , Gs^Fms      , Ww          , Hh^Fds      , Hh^Fms      , Gs^Fds      , Mm          , Mm          , Mm          , Mm          , Hh^Fds      , Hh^Fms      , Ww          , Ww          , Mm          , Rp          , Rp          , Mm          , Mm          , Mm          , Mm          , Mm          , Mm          , Mm          , Mm          , Mm          , Hh^Fms      , Hh^Fms      , Ww          , Rp          , Mm          , Mm          , Hh^Fds      , Mm          , Mm          , Mm          , Mm          , Hh^Fds      , Hh^Fds      , Chr         , Chr         , Chr         , Ww          , Gs^Fds      , Gs^Fds      , Gs^Fds      
Gs^Fds      , Gs^Fds      , Ww          , Hh^Fms      , Hh^Fms      , Hh^Fds      , Mm          , Mm          , Hh^Fds      , Hh^Fds      , Ww          , Ww          , Hh^Fms      , Hh^Fms      , Mm          , Ww          , Rp          , Hh^Fds      , Mm          , Mm          , Mm          , Mm          , Mm          , Mm          , Mm          , Hh^Fds      , Ww          , Ww          , Rp          , Rp          , Mm          , Mm          , Hh^Fms      , Hh^Fms      , Mm          , Mm          , Hh^Vhh      , Hh^Fds      , Hh^Fds      , Hh^Fms      , Hh^Fds      , Hh^Fms      , Gs^Fds      , Ww          , Ww          , Gs^Fds      
Gs^Fds      , Ww          , Hh^Fds      , Hh^Fms      , Mm          , Mm          , Mm          , Hh^Fds      , Ww          , Ww          , Hh^Fms      , Hh^Fms      , Hh^Fms      , Hh^Fms      , Ww          , Ww          , Rp          , Mm          , Mm          , Mm          , Mm          , Mm          , Mm          , Mm          , Hh^Fds      , Ww          , Rp          , Rp          , Mm          , Rp          , Rp          , Ww          , Ww          , Hh^Fms      , Hh^Fms      , Mm          , Mm          , Hh^Fds      , Hh^Fds      , Hh^Fds      , Hh^Fds      , Gs^Fds      , Gs^Fds      , Gs^Fds      , Ww          , Gs^Fds      
Ww          , Ww          , Hh^Fds      , Gs^Fds      , Mm          , Mm          , Hh^Fds      , Hh^Fds      , Ww          , Hh^Fms      , Hh^Fms      , Hh^Fms      , Mm          , Mm          , Ww          , Rp          , Mm          , Mm          , Hh^Fds      , Mm          , Mm          , Mm          , Mm          , Hh^Fds      , Hh^Fds      , Ww          , Rp          , Mm          , Mm          , Mm          , Mm          , Rp          , Hh^Fds      , Ww          , Hh^Fds      , Hh^Fds      , Hh^Fds      , Hh^Fds      , Mm          , Hh^Fds      , Hh^Fms      , Gs^Fds      , Hh^Fms      , Gs^Fds      , Gs^Fds      , Ww          
Ww          , Hh^Fds      , Hh^Fds      , Gs^Fds      , Mm          , Gs^Fds      , Hh^Fds      , Hh^Vhh      , Ww          , Hh^Fms      , Mm          , Mm          , Ww          , Ww          , Rp          , Rp          , Mm          , Mm          , Hh^Fds      , Mm          , Mm          , Mm          , Mm          , Hh^Fds      , Rp          , Ww^Bw/r     , Hh^Vhh      , Mm          , Mm          , Mm          , Hh^Fms      , Rp          , Hh^Fds      , Ww          , Hh^Fds      , Hh^Fds      , Hh^Fds      , Mm          , Mm          , Mm          , Mm          , Hh^Fms      , Hh^Fds      , Gs^Fds      , Gs^Fds      , Gs^Fds      
Ww          , Hh^Fds      , Hh^Fds      , Hh^Fds      , Hh^Fds      , Gs^Fds      , Ww          , Ww          , Mm          , Mm          , Ww          , Ww          , Rp          , Rp          , Mm          , Mm          , Hh^Fds      , Hh^Fds      , Ww          , Mm          , Mm          , Mm          , Mm          , Hh^Fds      , Rp          , Ww          , Hh^Fds      , Mm          , Mm          , Mm          , Mm          , Rp          , Rp          , Ww          , Hh^Fds      , Hh^Fds      , Hh^Fds      , Hh^Fds      , Mm          , Mm          , Mm          , Mm          , Gs^Fds      , Gs^Fds      , Gg^Ve       , Gs^Fds      
Ww          , Hh^Fds      , Hh^Fds      , Hh^Fms      , Ww          , Ww          , Hh^Fds      , Mm          , Mm          , Mm          , Ww          , Hh^Fds      , Rp          , Mm          , Mm          , Mm          , Hh^Fds      , Hh^Fms      , Ww          , Mm          , Mm          , Mm          , Rp          , Rp          , Hh^Fds      , Ww          , Hh^Fds      , Mm          , Mm          , Mm          , Mm          , Hh^Fms      , Hh^Fms      , Ww^Bw\r     , Rp          , Hh^Fms      , Hh^Fms      , Hh^Fds      , Hh^Fds      , Mm          , Mm          , Mm          , Gs^Fds      , Gs^Fds      , Gs^Fms      , Gs^Fds      
Gs^Fds      , Ww          , Ww          , Ww          , Chr         , Hh^Fds      , Mm          , Mm          , Hh^Fms      , Ww          , Rp          , Rp          , Mm          , Mm          , Mm          , Mm          , Hh^Fms      , Ww          , Hh^Fms      , Mm          , Mm          , Mm          , Rp          , Hh^Fds      , Hh^Fms      , Ww          , Hh^Fds      , Hh^Fds      , Hh^Fds      , Mm          , Mm          , Mm          , Mm          , Ww          , Ww          , Rp          , Rp          , Hh^Fds      , Hh^Fms      , Gs^Fds      , Mm          , Gs^Fds      , Gs^Fds      , Gs^Fms      , Gs^Fms      , Gs^Fds      
Hh^Fds      , Hh^Fds      , Ww          , Chr         , Khr         , Mm          , Mm          , Mm          , Ww^Bw|r     , Ww^Bw/r     , Mm          , Mm          , Mm          , Mm          , Hh^Fds      , Hh^Fms      , Ww          , Ww          , Hh^Vhh      , Hh^Fms      , Mm          , Mm          , Rp          , Hh^Fms      , Hh^Fms      , Ww          , Hh^Fds      , Hh^Fds      , Hh^Fds      , Mm          , Mm          , Mm          , Mm          , Hh^Fds      , Hh^Fds      , Ww          , Hh^Fms      , Rp          , Rp          , Rp          , Rp          , Hh^Fds      , Gs^Fds      , Gs^Fms      , Gs^Fds      , Gs^Fds      
Gs^Fds      , Hh^Fds      , Ww          , Chr         , Ww          , Chr         , Ww^Bw\r     , Ww          , Rp          , Mm          , Mm          , Mm          , Hh^Fds      , Hh^Fds      , Ww          , Ww          , Hh^Fms      , Hh^Fds      , Hh^Fms      , Mm          , Mm          , Mm          , Rp          , Hh^Fds      , Hh^Fds      , Ww          , Hh^Fms      , Hh^Fms      , Hh^Fds      , Hh^Fds      , Hh^Fms      , Mm          , Mm          , Mm          , Hh^Fds      , Ww          , Ww          , Hh^Fms      , Hh^Fms      , Hh^Fms      , Hh^Fds      , Rp          , Rp          , Gs^Fms      , Gs^Fds      , Gs^Fds      
Rp          , Gs^Fds      , Ww          , Ww          , Hh^Fds      , Ww          , Hh^Fds      , Hh^Fds      , Rp          , Hh^Fds      , Mm          , Hh^Fds      , Ww          , Ww          , Hh^Fds      , Hh^Fds      , Hh^Fds      , Hh^Fms      , Hh^Fms      , Mm          , Mm          , Mm          , Hh^Fds      , Rp          , Hh^Fds      , Ww          , Ww          , Hh^Fms      , Chr         , Hh^Fds      , Hh^Fms      , Hh^Fms      , Mm          , Mm          , Hh^Fds      , Hh^Fds      , Hh^Fds      , Ww          , Ww          , Gs^Fds      , Gs^Fds      , Gs^Fds      , Gs^Fms      , Rp          , Rp          , Gs^Fds      
Hh^Fds      , Rp          , Ww^Bw\r     , Hh^Fds      , Hh^Fds      , Hh^Fds      , Rp          , Rp          , Rp          , Hh^Fds      , Mm          , Hh^Fds      , Ww          , Hh^Fds      , Mm          , Mm          , Mm          , Hh^Fds      , Mm          , Mm          , Mm          , Mm          , Hh^Fds      , Rp          , Rp          , Hh^Fms      , Ww          , Chr         , Chr         , Khr         , Hh^Fds      , Hh^Fds      , Mm          , Mm          , Mm          , Hh^Fds      , Hh^Fds      , Hh^Fds      , Gs^Fds      , Ww          , Hh^Fds      , Gs^Fds      , Gs^Fms      , Gs^Fms      , Gs^Fds      , Rp          
Ww          , Ww          , Gs^Fds      , Rp          , Rp          , Rp          , Hh^Fds      , Hh^Fds      , Mm          , Rp          , Rp          , Hh^Fds      , Ww          , Hh^Vhh      , Mm          , Mm          , Mm          , Mm          , Mm          , Mm          , Mm          , Hh^Fds      , Hh^Vhh      , Hh^Fms      , Rp          , Hh^Fms      , Chr         , Ww          , Ww^Bsb/     , Chr         , Hh^Fds      , Hh^Fds      , Hh^Fds      , Mm          , Hh^Fds      , Hh^Fds      , Hh^Fds      , Hh^Fms      , Hh^Fds      , Ww          , Gs^Fds      , Gs^Fms      , Gs^Fds      , Gs^Fds      , Gs^Fds      , Gs^Fds      
Ww          , Hh^Fms      , Hh^Fms      , Hh^Fds      , Hh^Fds      , Hh^Fds      , Hh^Fds      , Mm          , Mm          , Mm          , Rp          , Hh^Fms      , Ww          , Hh^Fds      , Mm          , Mm          , Mm          , Mm          , Ww          , Mm          , Mm          , Mm          , Hh^Fms      , Hh^Fds      , Hh^Fds      , Rp          , Rp          , Chr         , Chr         , Ww          , Ww          , Hh^Fds      , Hh^Fds      , Mm          , Hh^Fds      , Hh^Fds      , Hh^Fms      , Hh^Fds      , Hh^Fds      , Ww          , Gs^Fds      , Gs^Fds      , Gs^Fds      , Gs^Fds      , Gs^Fds      , Gs^Fds      
Hh^Fms      , Hh^Fds      , Hh^Fms      , Hh^Fds      , Hh^Fds      , Hh^Vhh      , Mm          , Mm          , Mm          , Hh^Fds      , Hh^Fds      , Rp          , Ww^Bw\r     , Hh^Fms      , Mm          , Mm          , Hh^Fds      , Ww          , Hh^Fds      , Mm          , Mm          , Mm          , Mm          , Hh^Fds      , Hh^Fds      , Hh^Fds      , Hh^Fds      , Rp          , Rp          , Hh^Fds      , Hh^Fds      , Ww          , Ww          , Gs^Fds      , Ww          , Hh^Fms      , Hh^Fds      , Gs^Fds      , Gs^Fds      , Ww          , Gs^Fds      , Gs^Fms      , Gs^Fms      , Gg^Ve       , Gs^Fds      , Gs^Fds      
Mm          , Mm          , Mm          , Mm          , Mm          , Mm          , Mm          , Mm          , Hh^Fms      , Hh^Fds      , Hh^Fds      , Ww          , Hh^Fds      , Rp          , Mm          , Mm          , Hh^Fds      , Ww          , Ww          , Mm          , Mm          , Mm          , Mm          , Mm          , Hh^Fds      , Hh^Fds      , Hh^Fds      , Hh^Fds      , Rp          , Hh^Fds      , Hh^Fms      , Hh^Fms      , Hh^Fds      , Ww          , Hh^Fds      , Ww          , Ww          , Hh^Fms      , Ww          , Ww          , Gs^Fds      , Gs^Fms      , Gs^Fds      , Gs^Fds      , Gs^Fds      , Gs^Fds      
Mm          , Mm          , Mm          , Mm          , Mm          , Mm          , Mm          , Mm          , Hh^Fds      , Hh^Fms      , Ww          , Ww          , Hh^Fms      , Rp          , Mm          , Mm          , Hh^Fds      , Hh^Vhh      , Ww          , Hh^Fms      , Hh^Fms      , Mm          , Mm          , Mm          , Mm          , Hh^Fds      , Hh^Fds      , Hh^Fms      , Rp          , Hh^Fms      , Hh^Fms      , Hh^Fms      , Hh^Fds      , Hh^Fds      , Gs^Fds      , Gs^Fds      , Gs^Fds      , Ww          , Gs^Fms      , Ww          , Gs^Fds      , Gs^Fds      , Gs^Fds      , Gs^Fds      , Gs^Fds      , Gs^Fds      
Mm          , Mm          , Mm          , Mm          , Mm          , Mm          , Hh^Fms      , Hh^Fds      , Hh^Fds      , Hh^Fms      , Ww          , Hh^Fms      , Rp          , Rp          , Mm          , Mm          , Mm          , Hh^Fds      , Ww          , Hh^Fds      , Hh^Fms      , Hh^Fds      , Hh^Fds      , Mm          , Hh^Fds      , Hh^Fds      , Hh^Fds      , Hh^Fms      , Hh^Fms      , Rp          , Rp          , Hh^Fds      , Hh^Fds      , Gs^Fds      , Gs^Fds      , Gs^Fds      , Gs^Fds      , Gs^Fds      , Gs^Fds      , Ww          , Ww          , Gs^Fds      , Gs^Fds      , Gs^Fds      , Gs^Fds      , Gs^Fds      
Mm          , Mm          , Mm          , Mm          , Hh^Fds      , Hh^Fds      , Hh^Fms      , Hh^Fds      , Hh^Fms      , Hh^Fms      , Ww          , Hh^Fds      , Rp          , Hh^Fms      , Mm          , Mm          , Mm          , Hh^Fms      , Hh^Fds      , Ww          , Ww          , Hh^Fds      , Hh^Fds      , Hh^Fds      , Hh^Vhh      , Hh^Fds      , Hh^Fms      , Hh^Fms      , Gg^Ve       , Gs^Fds      , Gs^Fds      , Rp          , Rp          , Rp          , Rp          , Gs^Fds      , Gs^Fds      , Gs^Fds      , Gg^Ve       , Gs^Fds      , Ww          , Gs^Fds      , Gs^Fms      , Gs^Fds      , Gs^Fds      , Gs^Fds      
Hh^Fds      , Mm          , Hh^Fds      , Hh^Fds      , Hh^Fms      , Hh^Vhh      , Hh^Fds      , Hh^Fms      , Ww          , Ww          , Hh^Fds      , Hh^Fds      , Chr         , Chr         , 2 Khr       , Mm          , Mm          , Mm          , Hh^Fds      , Hh^Fds      , Hh^Fms      , Ww          , Ww          , Hh^Fds      , Hh^Fds      , Hh^Fds      , Hh^Fds      , Hh^Fds      , Hh^Fds      , Gs^Fds      , Hh^Fms      , Gs^Fds      , Hh^Fds      , Hh^Fds      , Gs^Fds      , Rp          , Rp          , Gs^Fds      , Gs^Fds      , Gs^Fds      , Ww          , Gs^Fds      , Gs^Fds      , Gs^Fds      , Gg^Ve       , Gs^Fds      
Hh^Fds      , Hh^Fms      , Hh^Fds      , Hh^Fds      , Hh^Fms      , Hh^Fds      , Ww          , Ww          , Hh^Fds      , Hh^Fds      , Hh^Fds      , Chr         , Chr         , Chr         , Chr         , Mm          , Mm          , Mm          , Mm          , Hh^Fds      , Hh^Fds      , Hh^Fms      , Hh^Fms      , Ww          , Ww          , Hh^Fds      , Hh^Fds      , Hh^Fds      , Hh^Fds      , Hh^Fds      , Hh^Fms      , Hh^Fms      , Hh^Fds      , Hh^Fds      , Gs^Fds      , Gs^Fds      , Rp          , Gs^Fms      , Gs^Fds      , Gs^Fds      , Gs^Fds      , Ww          , Ww          , Gs^Fds      , Gs^Fds      , Gs^Fds      
Gs^Fds      , Hh^Fms      , Hh^Fds      , Hh^Fds      , Hh^Fds      , Ww          , Hh^Fds      , Hh^Fds      , Hh^Fds      , Hh^Fds      , Hh^Fds      , Hh^Fds      , Hh^Fds      , Rp          , Hh^Fds      , Chr         , Mm          , Mm          , Mm          , Mm          , Hh^Fds      , Hh^Fds      , Hh^Fds      , Hh^Fms      , Ww          , Hh^Fds      , Hh^Fms      , Gs^Fds      , Hh^Fds      , Hh^Fds      , Hh^Fds      , Hh^Fds      , Hh^Fds      , Hh^Fds      , Gs^Fds      , Gg^Ve       , Gs^Fds      , Rp          , Rp          , Gs^Fds      , Gs^Fds      , Gs^Fds      , Gs^Fds      , Ww          , Ww          , Gs^Fds      
