border_size=1
usage=map

Ms^Xm       , Ms^Xm       , Ms^Xm       , Ms^Xm       , Ms          , Ms          , Ms          , Ms          , Ms          , Ms          , Ms          , Ms          , Ms          , Ms          , Ms          , Ms          , Ms          , Ms          , Ms          , Ms          , Ms          , Ms^Xm       , Ms          , Ha^Fpa      , Aa^Fpa      , Aa^Fpa      , Aa^Fpa      , Aa^Fpa      , Ha^Fpa      , Ha^Fpa      , Ms          , Ms          , Ms          , Ms          , Ms          , Ms^Xm       , Ms^Xm       , Ms^Xm       
Ms^Xm       , Ms^Xm       , Ms          , Ms          , Ms^Xm       , Ms          , Ms          , Ms          , Ai          , Ms          , Ha^Fpa      , Ms          , Ha^Fpa      , Ha^Fpa      , Ha^Fpa      , Ha^Fpa      , Aa^Fpa      , Ha^Fpa      , Ha^Fpa      , Ha^Fpa      , Ha^Fpa      , Ms          , Ha^Fpa      , Ha^Fpa      , Cv          , Cv          , Kv          , Cv          , Cv          , Ha^Fpa      , Ha^Fpa      , Ms          , Ai          , Ai          , Ms          , Ms^Xm       , Ms^Xm       , Ms^Xm       
Ms^Xm       , Ms^Xm       , Ms          , Ms          , Ms          , Ms          , Ms          , Ms          , Ms          , Ai          , Ai          , Ha^Fpa      , Ha^Fpa      , Ha^Fpa      , Aa^Fpa      , Aa^Fpa      , Aa^Fpa      , Aa^Fpa      , Aa^Fpa      , Aa^Fpa      , Aa^Fpa      , Ha^Fpa      , Ha^Fpa      , Aa^Fpa      , Aa^Fpa      , Cv          , Cv          , Cv          , Aa^Fpa      , Ha^Fpa      , Ha^Fpa      , Ai          , Ms          , Ms          , Ms          , Ms          , Ms          , Ms^Xm       
Ms^Xm       , Ms          , Ms^Xm       , Ms          , Ms          , Ms^Xm       , Ms          , Ms          , Ha^Fpa      , Ha^Fpa      , Ha^Fpa      , Ai          , Ai          , Ha^Fpa      , Aa^Fma      , Aa^Fpa      , Aa^Fma      , Aa^Fpa      , Aa^Fpa      , Aa^Fpa      , Aa^Fpa      , Ha^Fpa      , Ha^Fpa      , Aa^Vea      , Aa^Fpa      , Aa^Fpa      , Aa^Fpa      , Aa^Fpa      , Ha^Fpa      , Ha^Fpa      , Ha^Fpa      , Ai          , Ha^Fpa      , Ms          , Ms          , Ms          , Ms          , Ms^Xm       
Ms^Xm       , Ms          , Ms          , Ms          , Ms^Xm       , Ms          , Ms          , Ms          , Ha^Fpa      , Ha^Fpa      , Cv          , Aa^Fpa      , Ai          , Aa^Fma      , Aa^Fma      , Aa^Vea      , Aa^Fma      , Aa^Fpa      , Aa^Fma      , Aa^Vea      , Aa^Fma      , Aa^Fpa      , Aa^Fpa      , Aa^Fpa      , Aa^Fpa      , Aa^Fpa      , Ha^Fpa      , Ha^Fpa      , Ha^Fpa      , Ha^Fpa      , Ai          , Ai          , Ha^Fpa      , Ms          , Ms          , Ms          , Ms          , Ms          
Ms^Xm       , Ms          , Ms          , Ms          , Ms          , Ms          , Ms          , Ha^Fpa      , Cv          , Kv          , Aa^Fpa      , Aa^Fpa      , Ai          , Aa^Fpa      , Aa^Fpa      , Aa^Fpa      , Aa^Fpa      , Aa^Fma      , Aa^Fma      , Aa^Fma      , Gll^Fp      , Aa^Fma      , Gll^Fp      , Gd^Fmw      , Gd^Fmw      , Gll^Fp      , Gll^Fp      , Aa^Fpa      , Aa^Fpa      , Ai          , Aa          , Ha^Fpa      , Ha^Fpa      , Ha^Fpa      , Ms          , Ms          , Ms          , Ms          
Ms^Xm       , Ms          , Ms          , Ms^Xm       , Ms          , Ms          , Ms          , Ha^Fpa      , Aa^Fpa      , Cv          , Aa^Fma      , Aa^Fma      , Aa^Fpa      , Ai          , Ai          , Aa^Fma      , Aa^Fpa      , Aa^Fma      , Gll^Fp      , Gll^Fp      , Gg^Ve       , Gll^Fp      , Gd^Fmw      , Gd^Fmw      , Gd^Fmw      , Gll^Fp      , Gg^Ve       , Gd^Fmw      , Aa          , Ai          , Aa^Fpa      , Aa^Vea      , Ha^Fpa      , Ha^Fpa      , Ha^Fpa      , Ha^Fpa      , Ms          , Ms          
Ms^Xm       , Ms          , Ms          , Ms          , Ms          , Ms          , Ha^Fpa      , Aa^Fpa      , Aa^Fpa      , Aa^Fma      , Aa^Fma      , Aa^Fma      , Aa^Fma      , Aa^Fma      , Aa^Fpa      , Ai          , Ai          , Aa^Fma      , Gd^Fmw      , Gd^Fmw      , Gll         , Gll         , Gll         , Gll         , Gll         , Gd^Fmw      , Gll         , Aa          , Ai          , Ai          , Aa          , Ha^Fpa      , Ha^Fpa      , Ha^Fpa      , Aa^Vea      , Ha^Fpa      , Ms          , Ms          
Ms^Xm       , Ms          , Ms          , Ms          , Ms          , Ha^Fpa      , Ha^Fpa      , Ha^Fpa      , Aa^Fpa      , Aa^Fpa      , Aa^Fma      , Aa^Fma      , Aa^Fma      , Aa^Fma      , Aa^Fma      , Aa^Fpa      , Wwg         , Gd^Fmw      , Gll         , Gll         , Aa^Fpa      , Gll         , Ai          , Ai          , Ai          , Gll         , Ai          , Gll         , Ai^Bw\      , Gd^Fmw      , Aa^Fma      , Aa^Fpa      , Aa^Fpa      , Ha^Fpa      , Ha^Fpa      , Ha^Fpa      , Ms          , Ms          
Ms^Xm       , Ms          , Ms          , Ms          , Ha^Fpa      , Ha^Fpa      , Ha^Fpa      , Ha^Fpa      , Aa^Fma      , Aa^Fma      , Aa^Fma      , Aa^Fma      , Aa^Fpa      , Aa^Fma      , Aa^Fpa      , Aa          , Wwg^Bw/     , Gll         , Aa          , Gd^Fmw      , Ai          , Ai          , Aa^Fma      , Aa^Fma      , Aa^Fma      , Ai          , Aa^Fma      , Ai          , Ai          , Gll         , Aa^Fma      , Aa^Fpa      , Aa^Fpa      , Aa^Fpa      , Ha^Fpa      , Ha^Fpa      , Ms          , Ms          
Ms^Xm       , Ms          , Ms          , Ms          , Ha^Fpa      , Ha^Fpa      , Aa^Fpa      , Aa^Fpa      , Aa^Fma      , Aa^Fma      , Aa^Fma      , Aa^Fma      , Aa^Fpa      , Aa^Fpa      , Aa^Fma      , Gll         , Gll         , Wwg         , Wwg         , Ai          , Aa^Fma      , Aa^Fma      , Aa^Fma      , Aa^Fma      , Aa^Fma      , Aa^Fpa      , Aa^Fpa      , Aa^Fpa      , Gll^Fp      , Ai          , Gg^Ve       , Aa          , Aa          , Aa^Fpa      , Ha^Fpa      , Ha^Fpa      , Ms          , Ms          
Ms^Xm       , Ms          , Ms          , Ha^Fpa      , Ha^Fpa      , Aa^Fpa      , Aa^Fpa      , Aa^Fma      , Aa^Vea      , Aa^Fma      , Aa^Fma      , Aa^Fpa      , Aa^Fma      , Aa^Fma      , Aa^Fpa      , Gll         , Gll         , Wwg         , Aa^Fpa      , Aa^Fpa      , Aa^Fpa      , Aa^Fma      , Aa^Fma      , Aa^Fma      , Aa^Fpa      , Aa^Fpa      , Aa^Fpa      , Aa^Fma      , Aa^Fma      , Ai          , Ai^Bw/      , Gll         , Aa          , Aa^Fpa      , Ha^Fpa      , Ha^Fpa      , Ms          , Ms          
Ms          , Ms          , Ms          , Ha^Fpa      , Ha^Fpa      , Ha^Fpa      , Aa^Fpa      , Aa^Fma      , Aa^Fma      , Aa^Fma      , Aa^Fma      , Aa^Fpa      , Aa^Fpa      , Aa^Fma      , Gll^Fp      , Gg^Ve       , Gll         , Wwg         , Gll^Fp      , Aa^Fma      , Aa^Fpa      , Aa^Fpa      , Aa^Fpa      , Aa^Fpa      , Aa^Fma      , Aa^Fpa      , Aa^Fma      , Aa^Fma      , Aa^Fma      , Aa          , Aa          , Ai          , Ai          , Aa^Fpa      , Aa^Fpa      , Ms          , Ms          , Ms          
Ms          , Ms^Xm       , Ms          , Ha^Fpa      , Ha^Fpa      , Ha^Fpa      , Aa^Fma      , Aa^Fma      , Aa^Fpa      , Aa^Fma      , Aa^Fma      , Aa^Fpa      , Aa^Fma      , Aa^Fma      , Gd^Fmw      , Gll         , Gd^Fmw      , Wwg         , Gll^Fp      , Aa^Fma      , Aa^Fpa      , Aa^Fpa      , Aa^Fma      , Aa^Fma      , Aa^Fma      , Aa^Vea      , Aa^Fma      , Aa^Fma      , Aa^Fpa      , Aa          , Ha^Fpa      , Aa          , Aa          , Ai          , Ai          , Ms          , Ai          , Ai          
Ms          , Ms          , Ha^Fpa      , Ha^Fpa      , Ha^Fpa      , Aa^Fma      , Aa^Fma      , Aa^Fma      , Aa^Fpa      , Aa^Fma      , Aa^Fpa      , Aa^Fpa      , Gd^Fmw      , Aa^Fma      , Gd^Fmw      , Gll         , Wwg         , Wwg         , Gd^Fmw      , Aa^Fma      , Aa^Fpa      , Aa^Fma      , Aa^Fma      , Cv          , Cv          , Aa^Fma      , Aa^Fma      , Aa^Fpa      , Ha^Fpa      , Ha^Fpa      , Ha^Fpa      , Ha^Fpa      , Ha^Fpa      , Ha^Fpa      , Ms^Xm       , Ai          , Ms^Xm       , Ms^Xm       
Ms          , Ms          , Ha^Fpa      , Ha^Fpa      , Ha^Fpa      , Aa^Fpa      , Aa^Fma      , Aa^Fma      , Aa^Vea      , Aa^Fpa      , Aa^Fpa      , Gll^Fp      , Gll         , Gll         , Gll         , Gll         , Wwg         , Gll         , Aa          , Aa^Fpa      , Aa^Fpa      , Aa^Fma      , Aa^Fma      , Cv          , Kv          , Cv          , Ha^Fpa      , Aa^Fpa      , Ha^Fpa      , Ha^Fpa      , Ms^Xm       , Ms^Xm       , Ms^Xm       , Ms^Xm       , Ms          , Ms^Xm       , Ms          , Ms^Xm       
Ms          , Ms          , Ha^Fpa      , Ha^Fpa      , Aa^Fpa      , Aa^Fpa      , Aa^Fma      , Aa^Fma      , Aa^Fma      , Aa^Fma      , Aa^Fpa      , Gd^Fmw      , Gll         , Gll         , Wwg^Bw\     , Wwg         , Gll         , Gll         , Aa^Fpa      , Aa^Fma      , Aa^Fma      , Aa^Fma      , Aa^Fma      , Cv          , Cv          , Cv          , Ha^Fpa      , Aa^Fpa      , Ms^Xm       , Ms^Xm       , Ai          , Ms          , Ha^Fpa      , Ms          , Ha^Fpa      , Ms          , Ms          , Ms          
Ms          , Ms          , Ha^Fpa      , Ha^Fpa      , Aa^Fpa      , Aa^Fma      , Aa^Fma      , Aa^Fma      , Aa^Fma      , Aa^Fma      , Aa^Fma      , Aa^Fma      , Gll         , Gll         , Wwg         , Gll         , Aa          , Aa          , Aa^Fma      , Aa^Fma      , Aa^Fma      , Aa^Fma      , Aa^Fma      , Cv          , Aa^Fpa      , Cv          , Ha^Fpa      , Ms          , Ms^Xm       , Ms          , Ha^Fpa      , Ai          , Cv          , Ha^Fpa      , Kv          , Ha^Fpa      , Ms          , Ms          
Ms          , Ms          , Ha^Fpa      , Ha^Fpa      , Aa^Fpa      , Aa^Fma      , Aa^Fma      , Aa^Fma      , Aa^Fma      , Aa^Fma      , Aa^Fpa      , Gd^Fmw      , Gll         , Gll^Fp      , Wwg         , Gll         , Gd^Fmw      , Aa          , Aa^Fma      , Aa^Fma      , Aa^Fma      , Aa^Fma      , Aa^Vea      , Aa^Fpa      , Ha^Fpa      , Ha^Fpa      , Ms^Xm       , Ms^Xm       , Ms          , Ms          , Aa^Fpa      , Ai          , Cv          , Cv          , Cv          , Aa^Vea      , Ms          , Ms          
Ms          , Ms          , Ha^Fpa      , Ha^Fpa      , Ha^Fpa      , Aa^Vea      , Aa^Fma      , Aa^Fma      , Aa^Fpa      , Aa^Fma      , Aa^Fpa      , Gll^Fp      , Gll         , Gll         , Wwg         , Gd^Fmw      , Gg^Ve       , Gll^Fp      , Aa^Fpa      , Aa^Fma      , Aa^Fpa      , Ha^Fpa      , Ha^Fpa      , Ha^Fpa      , Ha^Fpa      , Ms          , Ms^Xm       , Ms          , Ha^Fpa      , Aa^Fpa      , Aa          , Ai          , Aa          , Cv          , Ha^Fpa      , Ha^Fpa      , Ha^Fpa      , Ms          
Ms          , Ha^Fpa      , Ha^Fpa      , Ha^Fpa      , Ha^Fpa      , Aa^Fpa      , Aa^Fma      , Aa^Fpa      , Aa^Fpa      , Aa^Fpa      , Cv          , Cv          , Gll         , Gd^Fmw      , Wwg         , Gd^Fmw      , Gd^Fmw      , Gd^Fmw      , Gll^Fp      , Aa^Fpa      , Aa^Fpa      , Aa^Fpa      , Ha^Fpa      , Ha^Fpa      , Ms          , Ms^Xm       , Ms          , Ha^Fpa      , Aa^Fpa      , Aa^Fpa      , Aa          , Ai          , Aa^Fma      , Aa^Fpa      , Aa^Fpa      , Ha^Fpa      , Ha^Fpa      , Ms          
Ha^Fpa      , Ha^Fpa      , Ha^Fpa      , Ha^Fpa      , Ha^Fpa      , Aa^Fma      , Aa^Fma      , Aa^Fma      , Aa^Fma      , Aa^Fma      , Aa^Fpa      , Kv          , Gll         , Gll^Fp      , Wwg         , Gd^Fmw      , Gd^Fmw      , Gll^Fp      , Gll^Fp      , Aa^Fma      , Aa^Fpa      , Ha^Fpa      , Ms          , Ms          , Ms^Xm       , Ms^Xm       , Ha^Fpa      , Aa^Fpa      , Aa^Fma      , Aa^Fma      , Aa          , Ai^Bw\      , Aa          , Aa^Fpa      , Aa^Fpa      , Ha^Fpa      , Ha^Fpa      , Ha^Fpa      
Cv          , Cv          , Cv          , Ha^Fpa      , Ha^Fpa      , Aa^Fma      , Aa^Fma      , Aa^Fma      , Aa^Fma      , Aa^Fma      , Aa^Fma      , Cv          , Gll         , Gll^Fp      , Wwg         , Gd^Fmw      , Gd^Fmw      , Gll^Fp      , Gll^Fp      , Aa^Fma      , Aa^Fpa      , Aa^Fpa      , Ms          , Ms^Xm       , Ms          , Ha^Fpa      , Aa^Fpa      , Aa^Vea      , Aa^Fpa      , Aa^Fpa      , Aa          , Ai          , Gll         , Aa^Fma      , Aa^Fpa      , Aa^Fpa      , Ha^Fpa      , Ha^Fpa      
Cv          , Kv          , Cv          , Ha^Fpa      , Ha^Fpa      , Aa^Fpa      , Aa^Fma      , Aa^Fma      , Aa^Vea      , Aa^Fpa      , Aa^Fma      , Gd^Fmw      , Gll         , Gll^Fp      , Wwg         , Gd^Fmw      , Gd^Fmw      , Gll^Fp      , Aa^Fma      , Aa^Fma      , Aa^Vea      , Aa^Fpa      , Ms          , Ms          , Ha^Fpa      , Ha^Fpa      , Aa^Fpa      , Aa^Fpa      , Aa^Fma      , Aa^Fma      , Aa^Fma      , Wwg         , Gll^Fp      , Aa^Fma      , Aa^Fpa      , Aa^Fpa      , Ha^Fpa      , Ha^Fpa      
Ha^Fpa      , Cv          , Cv          , Ha^Fpa      , Aa^Fpa      , Aa^Fpa      , Aa^Fpa      , Aa^Fpa      , Aa^Fpa      , Aa^Fma      , Aa^Fma      , Gd^Fmw      , Gll         , Gll         , Wwg         , Gd^Fmw      , Gd^Fmw      , Gd^Fmw      , Aa^Fpa      , Aa^Fpa      , Aa^Fma      , Aa^Fpa      , Aa^Fpa      , Ha^Fpa      , Aa^Fpa      , Aa^Fpa      , Aa^Fpa      , Aa^Fma      , Aa^Fpa      , Aa^Fpa      , Aa          , Wwg         , Gll         , Aa^Fma      , Aa^Fpa      , Aa^Fpa      , Ha^Fpa      , Ha^Fpa      
Ms          , Ha^Fpa      , Ha^Fpa      , Ha^Fpa      , Aa^Fpa      , Aa^Fpa      , Aa^Fpa      , Aa^Fma      , Aa^Fma      , Aa^Fpa      , Gll^Fp      , Gll^Fp      , Gll         , Gll         , Wwg         , Gg^Ve       , Gd^Fmw      , Aa^Fma      , Aa^Fma      , Aa^Fpa      , Aa^Fma      , Aa^Fpa      , Ha^Fpa      , Ha^Fpa      , Aa^Fpa      , Aa^Fpa      , Aa^Fma      , Aa^Fma      , Aa^Fpa      , Aa          , Wwg         , Wwg         , Gd^Fmw      , Aa          , Aa^Fma      , Aa^Vea      , Ha^Fpa      , Ha^Fpa      
Ms          , Ms          , Ha^Fpa      , Ha^Fpa      , Aa^Fpa      , Aa^Fpa      , Aa^Fma      , Aa^Fpa      , Aa^Fma      , Aa^Fpa      , Aa^Fma      , Gd^Fmw      , Gg^Ve       , Gll         , Wwg^Bw/     , Gd^Fmw      , Gd^Fmw      , Gll^Fp      , Aa^Fpa      , Aa^Fma      , Aa^Fma      , Aa^Fpa      , Aa^Fpa      , Aa^Vea      , Ha^Fpa      , Aa^Fma      , Aa^Fma      , Aa^Fpa      , Aa          , Aa          , Wwg         , Gll         , Gd^Fmw      , Aa^Fma      , Aa^Fpa      , Aa^Fpa      , Ha^Fpa      , Ha^Fpa      
Ms          , Ha^Fpa      , Ha^Fpa      , Ha^Fpa      , Ha^Fpa      , Aa^Fpa      , Aa^Fpa      , Aa^Fma      , Aa^Fma      , Aa^Fpa      , Aa^Fma      , Gd^Fmw      , Gd^Fmw      , Gll         , Gll         , Wwg         , Wwg         , Gd^Fmw      , Gd^Fmw      , Aa^Fpa      , Aa^Fpa      , Aa^Fma      , Aa^Fma      , Aa^Fma      , Aa^Fma      , Aa^Fma      , Aa^Fpa      , Aa^Fma      , Gll         , Wwg         , Gg^Ve       , Gll^Fp      , Aa^Fma      , Aa^Fpa      , Aa^Fpa      , Aa^Fpa      , Ha^Fpa      , Ha^Fpa      
Ms          , Ms          , Ha^Fpa      , Ha^Fpa      , Ha^Fpa      , Aa^Fma      , Aa^Fma      , Aa^Fma      , Aa^Fpa      , Aa^Fma      , Aa^Fma      , Aa^Fma      , Gd^Fmw      , Gll^Fp      , Gll^Fp      , Gll         , Gll         , Wwg         , Wwg         , Gd^Fmw      , Aa^Fpa      , Aa^Fma      , Aa^Fma      , Aa^Fma      , Aa^Fma      , Aa^Fma      , Gd^Fmw      , Gll         , Wwg         , Wwg         , Aa          , Aa^Fma      , Aa^Fpa      , Aa^Fpa      , Aa^Fpa      , Aa^Fpa      , Ha^Fpa      , Ha^Fpa      
Ms          , Ms          , Ha^Fpa      , Ha^Fpa      , Ha^Fpa      , Aa^Fpa      , Aa^Fma      , Aa^Fma      , Aa^Fpa      , Aa^Fpa      , Aa^Fpa      , Aa^Fma      , Aa^Fma      , Gd^Fmw      , Gd^Fmw      , Gg^Ve       , Gll         , Gll         , Wwg         , Gd^Fmw      , Gd^Fmw      , Aa^Fma      , Aa^Fma      , Aa^Fma      , Aa^Fpa      , Aa^Fpa      , Wwg         , Wwg^Bw\     , Gll         , Gll         , Aa^Fpa      , Aa^Fpa      , Aa^Fma      , Aa^Fpa      , Ha^Fpa      , Aa^Fpa      , Ha^Fpa      , Ha^Fpa      
Ms^Xm       , Ms          , Ms          , Ha^Fpa      , Ha^Fpa      , Aa^Vea      , Aa^Fma      , Aa^Fma      , Aa^Fpa      , Aa^Fpa      , Aa^Fpa      , Aa^Fpa      , Aa^Fma      , Aa^Fma      , Aa^Fpa      , Gd^Fmw      , Gll         , Gll         , Wwg         , Cv          , 3 Kv        , Gd^Fmw      , Gd^Fmw      , Gd^Fmw      , Wwg         , Wwg         , Gll         , Gll         , Aa          , Aa^Fpa      , Aa^Fpa      , Aa^Fma      , Aa^Fpa      , Aa^Fpa      , Ha^Fpa      , Ha^Fpa      , Ms          , Ha^Fpa      
Ms^Xm       , Ms          , Ms          , Ha^Fpa      , Ha^Fpa      , Aa^Fpa      , Aa^Fpa      , Aa^Fpa      , Aa^Fpa      , Aa^Fpa      , Aa^Fma      , Aa^Fpa      , Aa^Fpa      , Aa^Fpa      , Aa^Fma      , Gd^Fmw      , Aa          , Gll         , Wwg         , Cv          , Cv          , Cv          , Wwg         , Wwg         , Gll         , Gll         , Gll^Fp      , Gd^Fmw      , Aa^Fma      , Aa^Fpa      , Aa^Fpa      , Aa^Fpa      , Aa^Fpa      , Ha^Fpa      , Ha^Fpa      , Ha^Fpa      , Ms          , Ms          
Ms          , Ms          , Ha^Fpa      , Ha^Fpa      , Ha^Fpa      , Aa^Fpa      , Aa^Fpa      , Aa^Fpa      , Aa^Fma      , Aa^Fpa      , Aa^Fpa      , Aa^Fma      , Aa^Fma      , Aa^Fma      , Aa^Fma      , Gll^Fp      , Gll         , Gll         , Wwg^Bw/     , Cv          , Wwg         , Wwg         , Gll         , Gll         , Gd^Fmw      , Gll^Fp      , Aa^Fma      , Aa^Fma      , Aa^Fma      , Aa^Fpa      , Aa^Fpa      , Aa^Fpa      , Aa^Vea      , Ha^Fpa      , Ha^Fpa      , Ha^Fpa      , Ms          , Ms          
Ms          , Ms          , Ha^Fpa      , Ha^Fpa      , Ha^Fpa      , Ha^Fpa      , Aa^Fpa      , Aa^Fma      , Aa^Fma      , Aa^Fma      , Aa^Vea      , Aa^Fma      , Aa^Fma      , Aa^Fma      , Aa^Fpa      , Gd^Fmw      , Gll         , Gll         , Wwg         , Wwg         , Gll         , Gll         , Gd^Fmw      , Gd^Fmw      , Gg^Ve       , Aa^Fma      , Aa^Fma      , Aa^Fma      , Aa^Fma      , Aa^Fpa      , Aa^Fpa      , Aa^Fpa      , Ha^Fpa      , Ha^Fpa      , Ha^Fpa      , Ha^Fpa      , Ms          , Ms          
Ms          , Ms          , Ha^Fpa      , Ha^Fpa      , Ha^Fpa      , Aa^Fpa      , Aa^Fma      , Aa^Fma      , Aa^Fpa      , Aa^Fpa      , Aa^Fpa      , Aa^Fpa      , Aa^Fpa      , Aa^Fpa      , Gd^Fmw      , Gll         , Gll         , Wwg         , Gll         , Gll         , Gll         , Gll         , Gd^Fmw      , Aa^Fma      , Aa^Fma      , Aa^Fma      , Aa^Fma      , Aa^Fpa      , Aa^Fpa      , Aa^Fpa      , Aa^Fpa      , Ha^Fpa      , Ha^Fpa      , Ha^Fpa      , Ha^Fpa      , Ha^Fpa      , Ms          , Ms          
Ms          , Ms          , Ha^Fpa      , Ha^Fpa      , Ha^Fpa      , Ha^Fpa      , Aa^Fma      , Aa^Fma      , Aa^Fma      , Aa^Fma      , Aa^Fma      , Aa^Fpa      , Aa^Fma      , Aa^Fpa      , Gd^Fmw      , Gll         , Gll         , Wwg         , Gll         , Aa          , Gd^Fmw      , Gd^Fmw      , Aa^Fma      , Aa^Fma      , Aa^Fma      , Aa^Fma      , Aa^Fpa      , Aa^Fma      , Aa^Fma      , Aa^Fpa      , Aa^Fpa      , Ha^Fpa      , Ha^Fpa      , Ha^Fpa      , Ha^Fpa      , Ha^Fpa      , Ms          , Ms          
Ms          , Ms          , Ms          , Ha^Fpa      , Ha^Fpa      , Ha^Fpa      , Ha^Fpa      , Aa^Fma      , Aa^Fma      , Aa^Fma      , Aa^Fma      , Aa^Fma      , Aa^Fma      , Aa^Fma      , Gd^Fmw      , Gll         , Gll         , Wwg         , Gll         , Gd^Fmw      , Gd^Fmw      , Aa^Fpa      , Aa^Fma      , Aa^Fma      , Aa^Fma      , Aa^Fma      , Aa^Fma      , Aa^Fpa      , Aa^Fpa      , Aa^Fpa      , Aa^Fpa      , Ha^Fpa      , Ha^Fpa      , Ha^Fpa      , Ha^Fpa      , Ms          , Ms          , Ms          
Ms^Xm       , Ms          , Ms          , Ha^Fpa      , Ha^Fpa      , Ha^Fpa      , Ha^Fpa      , Aa^Vea      , Aa^Fma      , Aa^Fma      , Aa^Fma      , Aa^Fma      , Gd^Fmw      , Gd^Fmw      , Gg^Ve       , Gll         , Gll         , Wwg         , Gd^Fmw      , Gd^Fmw      , Aa^Fma      , Aa^Fma      , Aa^Fma      , Aa^Fma      , Aa^Fma      , Aa^Fma      , Aa^Fma      , Aa^Fma      , Aa^Fma      , Aa^Fpa      , Aa^Fpa      , Ha^Fpa      , Ha^Fpa      , Aa^Vea      , Ha^Fpa      , Ms          , Ms          , Ms          
Ms^Xm       , Ms^Xm       , Ms          , Ha^Fpa      , Ha^Fpa      , Ha^Fpa      , Ha^Fpa      , Aa^Fpa      , Aa^Fpa      , Aa^Fma      , Aa^Fma      , Aa^Fma      , Aa^Fma      , Gll^Fp      , Gd^Fmw      , Gll         , Gll         , Wwg         , Gd^Fmw      , Aa^Fma      , Aa^Fpa      , Aa^Fpa      , Aa^Fpa      , Aa^Vea      , Aa^Fma      , Aa^Fma      , Aa^Fma      , Aa^Fma      , Aa^Fma      , Aa^Fpa      , Aa^Fpa      , Ha^Fpa      , Ha^Fpa      , Ha^Fpa      , Ms          , Ms          , Ms          , Ms          
Ms^Xm       , Ms^Xm       , Ms          , Ms          , Ha^Fpa      , Ha^Fpa      , Ha^Fpa      , Ha^Fpa      , Aa^Fpa      , Aa^Fma      , Aa^Fpa      , Aa^Fma      , Aa^Fma      , Gd^Fmw      , Gd^Fmw      , Gll         , Wwg         , Wwg         , Gd^Fmw      , Aa^Fma      , Aa^Fma      , Aa^Fma      , Aa^Fma      , Aa^Fma      , Aa^Fpa      , Aa^Fma      , Aa^Fma      , Aa^Fma      , Aa^Fma      , Aa^Fpa      , Aa^Fpa      , Ha^Fpa      , Ha^Fpa      , Ha^Fpa      , Ms          , Ms          , Ms          , Ms          
Ms          , Ms          , Ms          , Ms          , Ha^Fpa      , Ha^Fpa      , Ha^Fpa      , Ha^Fpa      , Aa^Fpa      , Aa^Fpa      , Aa^Fpa      , Aa^Fma      , Aa^Fma      , Gd^Fmw      , Gll         , Gll         , Wwg         , Gll         , Gd^Fmw      , Aa^Fma      , Aa^Fma      , Aa^Fma      , Aa^Fma      , Aa^Fma      , Aa^Fma      , Aa^Fma      , Aa^Fpa      , Aa^Vea      , Aa^Fpa      , Aa^Fpa      , Aa^Fpa      , Ha^Fpa      , Ha^Fpa      , Ha^Fpa      , Ms          , Ms          , Ms          , Ms          
Ms^Xm       , Ms          , Ms          , Ms          , Ha^Fpa      , Ha^Fpa      , Aa^Vea      , Ha^Fpa      , Ha^Fpa      , Aa^Fpa      , Aa^Fpa      , Aa^Fma      , Aa^Fma      , Gd^Fmw      , Cv          , Cv          , Wwg         , Gll         , Gll^Fp      , Gll^Fp      , Gg^Ve       , Aa^Fma      , Aa^Fma      , Aa^Fma      , Aa^Fma      , Aa^Fma      , Aa^Fma      , Aa^Fpa      , Aa^Fpa      , Aa^Fpa      , Aa^Fpa      , Ha^Fpa      , Ha^Fpa      , Ha^Fpa      , Ms          , Ms          , Ms          , Ms          
Ms^Xm       , Ms          , Ms          , Ms          , Ha^Fpa      , Ha^Fpa      , Ha^Fpa      , Ha^Fpa      , Aa^Fpa      , Aa^Fpa      , Aa^Fma      , Gg^Ve       , Gd^Fmw      , Cv          , 1 Kv        , Cv          , Wwg         , Gll         , Gll         , Gll^Fp      , Aa^Fma      , Aa^Fma      , Aa^Fma      , Aa^Fma      , Aa^Fma      , Aa^Fma      , Aa^Fma      , Aa^Fpa      , Aa^Fpa      , Aa^Fpa      , Ha^Fpa      , Ha^Fpa      , Ha^Fpa      , Ha^Fpa      , Ms          , Ms          , Ms          , Ms          
Ms^Xm       , Ms^Xm       , Ms          , Ms          , Ha^Fpa      , Ha^Fpa      , Ha^Fpa      , Ha^Fpa      , Ha^Fpa      , Aa^Fpa      , Aa^Fma      , Gd^Fmw      , Gd^Fmw      , Cv          , Cv          , Cv          , Wwg         , Gll         , Gll         , Gd^Fmw      , Aa^Fma      , Aa^Fma      , Aa^Fma      , Aa^Fma      , Aa^Fma      , Aa^Fpa      , Aa^Fma      , Aa^Fpa      , Aa^Fpa      , Ha^Fpa      , Ha^Fpa      , Ha^Fpa      , Ha^Fpa      , Ms          , Ms          , Ms          , Ms          , Ms          
Ms^Xm       , Ms^Xm       , Ms          , Ms          , Ha^Fpa      , Ha^Fpa      , Ha^Fpa      , Ha^Fpa      , Ha^Fpa      , Aa^Fpa      , Aa^Fpa      , Gd^Fmw      , Gd^Fmw      , Gd^Fmw      , Gll         , Cv          , Wwg         , Gll         , Gll         , Gd^Fmw      , Gd^Fmw      , Aa^Fpa      , Aa^Fma      , Aa^Fma      , Aa^Fma      , Aa^Fpa      , Ha^Fpa      , Aa^Fpa      , Ha^Fpa      , Ha^Fpa      , Ha^Fpa      , Ha^Fpa      , Ms          , Ms          , Ms          , Ms          , Ms          , Ms          
Ms          , Ms          , Ms          , Ha^Fpa      , Ha^Fpa      , Ha^Fpa      , Ha^Fpa      , Ha^Fpa      , Ha^Fpa      , Aa^Fpa      , Ha^Fpa      , Aa^Fma      , Gd^Fmw      , Gd^Fmw      , Gll         , Gll         , Wwg         , Gll         , Gll         , Gd^Fmw      , Aa^Fma      , Gd^Fmw      , Aa^Fma      , Aa^Fma      , Aa^Fma      , Aa^Fpa      , Ha^Fpa      , Ha^Fpa      , Ha^Fpa      , Ha^Fpa      , Ha^Fpa      , Ha^Fpa      , Ms          , Ms          , Ms          , Ms          , Ms          , Ms          
