border_size=1
usage=map

Rd          , Rd          , Rd          , Rd          , Rd          , Rd          , Rd          , Gd          , Gd          , Gd          , Gd          , Gd          , Gd          , Rd          , Rd          , Rd          , Rd          , Rd          , Dd          , Dd          , Dd          , Dd          , Dd          , Rd          , Rd          , Rd          , Rd          , Rd          , Rd          , Rd          , Rd          , Rd          , Ss          , Rd          , Rd          , Rd          , Dd          , Rd          , Dd          , Dd          , Gd          , Gd          , Gd          , Gd          , Gd          , Gd          
Rd          , Rd          , Rd          , Rd          , Dd          , Rd          , Gd          , Gd          , Gd          , Gd          , Gd          , Gd          , Rd          , Rd          , Rd          , Rd          , Dd          , Dd          , Dd          , Dd          , Dd          , Dd          , Dd          , Rd          , Rd          , Rd          , Rd^Gvs      , Rd          , Re^Vct      , Rd          , Rd          , Rd          , Ss          , Rd          , Gd          , Rd          , Dd          , Dd          , Hd          , Dd          , Dd          , Re^Vct      , Gd          , Gd          , Gd          , Gd          
Rd          , Rd          , Rd          , Rd          , Dd          , Dd          , Hd          , Gd          , Gd          , Gd          , Gd          , Gd          , Rd          , Rd          , Rd          , Rd          , Dd          , Dd          , Hd          , Dd          , Hd          , Dd          , Hd          , Dd          , Hd          , Gd^Gvs      , Gd^Gvs      , Rd^Gvs      , Gd^Gvs      , Gd^Gvs      , Gd^Gvs      , Gd^Gvs      , Ss          , Gd          , Gd^Gvs      , Gd          , Gd^Gvs      , Hd          , Hd          , Dd          , Dd          , Dd          , Dd          , Gd          , Dd          , Gd          
Rd          , Rd          , Rd          , Dd          , Hd          , Hd          , Hd          , Hd          , Hd          , Gd          , Gd          , Rd          , Rd          , Rd          , Rd          , Rd          , Dd          , Hd          , Hd          , Hd          , Hd          , Hd          , Dd          , Hd          , Hd          , Gd^Gvs      , Gd^Gvs      , Gd^Gvs      , Gd^Gvs      , Gd^Gvs      , Gd^Gvs      , Gd^Gvs      , Ss          , Gd^Gvs      , Gd^Gvs      , Gd^Gvs      , Gd^Gvs      , Hd          , Hd          , Hd          , Hd          , Dd          , Dd          , Dd          , Dd          , Dd          
Gd          , Gd          , Gd          , Dd          , Hd          , Hd          , Hd          , Hd          , Hd          , Gd          , Re^Vct      , Rd          , Rd          , Rd          , Rd          , Rd          , Rd          , Hd          , Hd          , Hd          , Hd          , Hd          , Hd          , Hd          , Gd^Gvs      , Gd^Gvs      , Gd^Gvs      , Gd^Gvs      , Gd^Gvs      , Gd^Gvs      , Gd^Gvs      , Gd^Gvs      , Ss          , Gd^Gvs      , Gd^Gvs      , Gd^Gvs      , Gd^Gvs      , Hd          , Gd^Gvs      , Hd          , Gd^Gvs      , Hd          , Dd          , Dd          , Rd          , Dd          
Gd          , Gd          , Gd          , Gd          , Gd          , Hd          , Dd          , Hd          , Hd          , Dd          , Rd          , Rd          , Rd          , Rd          , Rd          , Rd          , Rd          , Hd          , Hd          , Hd          , Hd          , Hd          , Gd^Gvs      , Gd^Gvs      , Gd^Gvs      , Gd^Gvs      , Gd^Gvs      , Gd^Gvs      , Gd^Gvs      , Gd^Gvs      , Gd^Gvs      , Gd^Gvs      , Gd^Gvs      , Ss          , Gd^Gvs      , Gd^Gvs      , Gd^Gvs      , Gd^Gvs      , Gd^Gvs      , Gd^Gvs      , Gd^Gvs      , Dd^Gvs      , Dd^Gvs      , Rd          , Rd          , Rd          
Gd          , Gd          , Gd          , Gd          , Gd          , Dd          , Dd          , Dd          , Dd          , Dd          , Rd          , Rd          , Rd          , Rd          , Rd          , Rd          , Rd          , Rd          , Gd          , Gd^Gvs      , Gd^Gvs      , Gd^Gvs      , Gd^Gvs      , Gd^Gvs      , Gd^Gvs      , Gd^Gvs      , Gd^Gvs      , Gd^Gvs      , Gd^Gvs      , Gd^Gvs      , Gd^Gvs      , Gd^Gvs      , Ss          , Ss          , Gd^Gvs      , Gd^Gvs      , Gd^Gvs      , Gd^Gvs      , Gd^Gvs      , Gd^Gvs      , Gd^Gvs      , Gd^Gvs      , Gd^Gvs      , Rd^Gvs      , Re^Vct      , Rd          
Rd          , Gd          , Rd          , Rd          , Rd          , Rd          , Rd          , Dd          , Rd          , Dd          , Rd          , Rd          , Rd          , Rd          , Rd          , Rd          , Gd          , Gd          , Gd          , Gd^Gvs      , Gd^Gvs      , Gd^Gvs      , Gd^Gvs      , Gd^Gvs      , Gd^Gvs      , Gd^Gvs      , Ss          , Ss          , Ss          , Ss          , Ss          , Ss          , Gd^Gvs      , Gd^Gvs      , Gd^Gvs      , Gd^Gvs      , Gd^Gvs      , Gd^Gvs      , Gd^Gvs      , Gd^Gvs      , Gd^Gvs      , Gd^Gvs      , Rrc         , Rd^Gvs      , Rd          , Rd          
Rd          , Rd          , Rd          , Rd          , Rd          , Rd          , Rd          , Rd          , Rd          , Rd          , Rd          , Rd          , Dd          , Dd          , Gd          , Gd          , Gd          , Gd          , Re^Vct      , Gd^Gvs      , Gd^Gvs      , Gd^Gvs      , Gd^Gvs      , Gd^Gvs      , Ss          , Ss          , Rrc         , Ch          , Ch          , Rrc         , Rrc         , Ch          , Rrc         , Gd^Gvs      , Ch          , Gd^Gvs      , Gd^Gvs      , Gd^Gvs      , Gd^Gvs      , Gd^Gvs      , Rrc         , Rrc         , Gd^Gvs      , Rrc         , Rrc         , Rrc         
Rd          , Rd          , Rd          , Rd          , Rd          , Rd          , Gd          , Rd          , Gd          , Rd          , Rd          , Rd          , Dd          , Hd          , Hd          , Gd          , Gd          , Gd          , Gd^Gvs      , Gd^Gvs      , Gd^Gvs      , Gd^Gvs      , Gd^Gvs      , Gd^Gvs      , Ss          , Rrc         , Rrc         , Rrc         , Rrc         , Rrc         , Rrc         , Rr^Vhc      , Ch          , Rrc         , Rrc         , Ch          , Rr^Vhc      , Gd^Gvs      , Rrc         , Rrc         , Gd^Gvs      , Gd^Gvs      , Gd^Gvs      , Rd^Gvs      , Rd          , Rd          
Rd          , Rd          , Rd          , Rd          , Gd          , Gd          , Gd          , Gd          , Gd          , Rd          , Dd          , Dd          , Hd          , Hd          , Hd          , Hd          , Rd          , Gd          , Rd^Gvs      , Gd^Gvs      , Gd^Gvs      , Gd^Gvs      , Gd^Gvs      , Ss          , Ch          , Ch          , Rrc         , Rr^Vhc      , Rrc         , Rr^Vhc      , Rrc         , Rrc         , Ch          , Ch          , Ch          , Rrc         , Rrc         , Rrc         , Ch          , Gd^Gvs      , Gd^Gvs      , Gd^Gvs      , Gd^Gvs      , Rd^Gvs      , Rd          , Rd          
Rd          , Rd          , Rd          , Rd          , Rd          , Gd          , Dd          , Gd          , Gd          , Rd          , Dd          , Dd          , Dd          , Hd          , Hd          , Rd          , Rd          , Rd^Gvs      , Rd^Gvs      , Gd^Gvs      , Gd^Gvs      , Gd^Gvs      , Gd^Gvs      , Ss          , Rrc         , Rrc         , Rrc         , Rrc         , Rrc         , Rrc         , Rrc         , Ch          , Ch          , Kh          , Ch          , Ch          , Rrc         , Rrc         , Ch          , Gd^Gvs      , Gd^Gvs      , Gd^Gvs      , Gd^Gvs      , Rd^Gvs      , Rd          , Rd          
Rd          , Rd          , Rd          , Rd          , Dd          , Dd          , Hd          , Gd          , Hd          , Dd          , Dd          , Rd          , Rd          , Dd          , Rd          , Rd          , Rd^Gvs      , Rd^Gvs      , Gd^Gvs      , Gd^Gvs      , Gd^Gvs      , Gd^Gvs      , Ss          , Ss          , Rrc         , Rr^Vhc      , Rrc         , Rr^Vhc      , Rrc         , Rr^Vhc      , Rrc         , Rrc         , Rrc         , Ch          , Rrc         , Rrc         , Rr^Vhc      , Rrc         , Gd^Gvs      , Gd^Gvs      , Gd^Gvs      , Gd^Gvs      , Rd^Gvs      , Rd^Gvs      , Rd          , Rd          
Rd          , Rd          , Rd          , Rd          , Dd          , Hd          , Hd          , Hd          , Hd          , Dd          , Dd          , Rd          , Rd          , Rd          , Rd          , Rd          , Rd^Gvs      , Rd^Gvs      , Gd^Gvs      , Gd^Gvs      , Gd^Gvs      , Gd^Gvs      , Ss          , Ch          , Rrc         , Rrc         , 1 Rr^Vhc    , Rrc         , Rrc         , Rrc         , Rrc         , Rr^Vhc      , Rrc         , Rrc         , Rrc         , Rrc         , Ch          , Gd^Gvs      , Gd^Gvs      , Gd^Gvs      , Gd^Gvs      , Dd^Gvs      , Rd^Gvs      , Rd^Gvs      , Rd          , Rd          
Rd          , Rd          , Rd          , Dd          , Dd          , Hd          , Dd          , Hd          , Dd          , Dd          , Rd          , Rd          , Gd          , Rd          , Gd          , Re^Vct      , Gd^Gvs      , Rd^Gvs      , Gd^Gvs      , Gd^Gvs      , Gd^Gvs      , Gd^Gvs      , Ss^Bw/      , Rrc         , Rrc         , Rrc         , Rrc         , Rrc         , Rr^Vhc      , Rrc         , Rrc         , Rrc         , Rrc         , Rr^Vhc      , Rrc         , Ch          , Gd^Gvs      , Gd^Gvs      , Gd^Gvs      , Gd^Gvs      , Gd^Gvs      , Dd^Gvs      , Dd^Gvs      , Rd          , Rd          , Rd          
Rd          , Rd          , Rd          , Rd          , Rd          , Dd          , Dd          , Dd          , Dd          , Rd          , Rd          , Rd          , Gd          , Gd          , Gd          , Gd          , Gd^Gvs      , Gd^Gvs      , Gd^Gvs      , Gd^Gvs      , Rrc         , Rrc         , Gd^Gvs      , Ss          , Gd^Gvs      , Ch          , Ch          , Rrc         , Rrc         , Rrc         , Rrc         , Rr^Vhc      , Rrc         , Rrc         , Rrc         , Ch          , Gd^Gvs      , Gd^Gvs      , Gd^Gvs      , Gd^Gvs      , Gd^Gvs      , Dd^Gvs      , Dd^Gvs      , Dd          , Rd          , Rd          
Rd          , Rd          , Rd          , Rd          , Rd          , Rd          , Rd          , Re^Vct      , Rd          , Gd          , Gd          , Gd          , Gd          , Gd          , Gd          , Gd          , Gd^Gvs      , Gd^Gvs      , Rrc         , Rrc         , Gd^Gvs      , Gd^Gvs      , Gd^Gvs      , Ss          , Ss          , Gd^Gvs      , Gd^Gvs      , Rrc         , Rrc         , Rrc         , Ch          , Rrc         , Rrc         , Ch          , Gd^Gvs      , Gd^Gvs      , Gd^Gvs      , Gd^Gvs      , Gd^Gvs      , Gd^Gvs      , Dd^Gvs      , Dd^Gvs      , Dd          , Dd          , Rd          , Rd          
Rd          , Rd          , Rd          , Rd          , Rd          , Dd          , Dd          , Dd          , Rd          , Rd          , Rd          , Gd          , Rd          , Gd          , Gd          , Gd          , Rrc         , Rrc         , Gd^Gvs      , Gd^Gvs      , Gd^Gvs      , Gd^Gvs      , Gd^Gvs      , Gd^Gvs      , Ss          , Gd^Gvs      , Gd^Gvs      , Gd^Gvs      , Gd^Gvs      , Ch          , Gd^Gvs      , Gd^Gvs      , Gd^Gvs      , Gd^Gvs      , Gd^Gvs      , Gd^Gvs      , Gd^Gvs      , Gd^Gvs      , Gd^Gvs      , Hd          , Hd          , Hd          , Dd          , Dd          , Rd          , Rd          
Rd          , Rd          , Gd          , Gd          , Dd          , Dd          , Hd          , Dd          , Dd          , Rd          , Rd          , Rd          , Rd          , Rd          , Rrc         , Rrc         , Gd          , Gd^Gvs      , Gd^Gvs      , Rd^Gvs      , Rd^Gvs      , Gd^Gvs      , Gd^Gvs      , Gd^Gvs      , Ss          , Gd^Gvs      , Gd^Gvs      , Gd^Gvs      , Gd^Gvs      , Gd^Gvs      , Gd^Gvs      , Gd^Gvs      , Gd^Gvs      , Gd^Gvs      , Gd^Gvs      , Gd^Gvs      , Gd^Gvs      , Gd^Gvs      , Gd^Gvs      , Hd          , Dd          , Hd          , Dd          , Dd          , Rd          , Rd          
Rd          , Gd          , Gd          , Gd          , Gd          , Dd          , Hd          , Dd          , Dd          , Rd          , Rd          , Rd          , Rd          , Rd          , Rrc         , Gd          , Gd          , Gd          , Rd          , Rd          , Rd          , Rd^Gvs      , Gd^Gvs      , Gd^Gvs      , Ss          , Gd^Gvs      , Gd^Gvs      , Gd^Gvs      , Gd^Gvs      , Gd^Gvs      , Gd^Gvs      , Gd^Gvs      , Gd^Gvs      , Gd^Gvs      , Gd^Gvs      , Gd^Gvs      , Gd^Gvs      , Gd^Gvs      , Gd^Gvs      , Gd^Gvs      , Gd^Gvs      , Dd          , Gd          , Dd          , Rd          , Rd          
Gd          , Gd          , Gd          , Gd          , Rd          , Gd          , Gd          , Hd          , Hd          , Dd          , Dd          , Rd          , Rd          , Rrc         , Rd          , Rd          , Rd          , Rd          , Rd          , Rd          , Rd          , Rd          , Rd          , Gd          , Ss          , Gd^Gvs      , Gd^Gvs      , Gd^Gvs      , Gd^Gvs      , Gd^Gvs      , Gd^Gvs      , Gd^Gvs      , Gd^Gvs      , Gd^Gvs      , Gd^Gvs      , Gd^Gvs      , Dd^Gvs      , Gd^Gvs      , Gd^Gvs      , Gd^Gvs      , Gd^Gvs      , Gd          , Gd          , Rd          , Rd          , Rd          
Rd          , Rd          , Rd          , Rd          , Hd          , Rd          , Hd          , Gd          , Hd          , Hd          , Dd          , Rd          , Rd          , Rrc         , Rd          , Rd          , Rd          , Rd          , Rd          , Rd          , Rd          , Rd          , Re^Vct      , Rd          , Ss          , Gd^Gvs      , Gd^Gvs      , Gd^Gvs      , Gd^Gvs      , Gd^Gvs      , Gd^Gvs      , Gd^Gvs      , Rd^Gvs      , Gd^Gvs      , Rd^Gvs      , Dd          , Hd          , Hd          , Hd          , Gd^Gvs      , Gd          , Gd          , Rd          , Rd          , Rd          , Rd          
Rd          , Rd          , Rd          , Rd          , Dd          , Hd          , Hd          , Hd          , Hd          , Dd          , Rd          , Rd          , Rrc         , Rrc         , Rd          , Rd          , Rd          , Rd          , Rd          , Rd          , Rd          , Rd          , Gd          , Gd          , Ss          , Gd^Gvs      , Gd^Gvs      , Gd^Gvs      , Gd^Gvs      , Gd^Gvs      , Rd^Gvs      , Rd^Gvs      , Rd^Gvs      , Rd^Gvs      , Rd^Gvs      , Dd          , Dd          , Dd          , Dd          , Hd          , Rd          , Rd          , Rd          , Re^Vct      , Rd          , Rd          
Rrc         , Rd          , Rd          , Gd          , Gd          , Dd          , Gd          , Dd          , Gd          , Gd          , Rd          , Rd          , Rrc         , Rd          , Re^Vct      , Rd          , Gd          , Gd          , Gd          , Gd          , Gd          , Gd          , Gd          , Gd          , Ss          , Gd^Gvs      , Hd          , Gd^Gvs      , Gd^Gvs      , Gd^Gvs      , Rd^Gvs      , Rd^Gvs      , Rd^Gvs      , Rd^Gvs      , Rd^Gvs      , Dd          , Dd          , Dd          , Dd          , Dd          , Dd          , Rd          , Rd          , Rd          , Rd          , Rd          
Rd          , Rrc         , Rrc         , Rd          , Gd          , Gd          , Gd          , Gd          , Gd          , Gd          , Rd          , Rd          , Rrc         , Rd          , Rd          , Rd          , Gd          , Gd          , Gd          , Gd          , Gd          , Gd          , Gd          , Ss          , Gd          , Gd^Gvs      , Hd          , Hd          , Rd^Gvs      , Rd^Gvs      , Rd^Gvs      , Rd^Gvs      , Rd^Gvs      , Rd^Gvs      , Rd          , Rd          , Rd          , Rd          , Hd          , Hd          , Dd          , Dd          , Rd          , Rd          , Rd          , Rd          
Rd          , Re^Vct      , Rd          , Rrc         , Rrc         , Gd          , Gd          , Gd          , Rd          , Rd          , Rrc         , Rrc         , Rd          , Rd          , Rd          , Rd          , Gd          , Gd          , Gd          , Gd          , Gd          , Gd          , Gd          , Ss          , Rd          , Gd          , Hd          , Hd          , Rd          , Rd^Gvs      , Rd          , Rd          , Rd          , Rd          , Rd          , Rd          , Gd          , Gd          , Gd          , Hd          , Hd          , Dd          , Rd          , Rd          , Rd          , Rd          
Rd          , Rd          , Rd          , Rd          , Rd          , Rrc         , Rrc         , Ce          , Ke          , Ce          , Dd          , Dd          , Dd          , Rd          , Dd          , Rd          , Rd          , Rd          , Rd          , Rd          , Rd          , Rd          , Rd          , Ss          , Rd          , Hd          , Rd          , Rd          , Rd          , Rd          , Rd          , Re^Vct      , Rd          , Rd          , Rd          , Rd          , Gd          , Gd          , Gd          , Gd          , Rd          , Rd          , Rd          , Rd          , Rd          , Rd          
Rd          , Rd          , Dd          , Rd          , Dd          , Rd          , Ce          , Ce          , Ce          , Ce          , Hd          , Hd          , Dd          , Dd          , Hd          , Dd          , Rd          , Rd          , Rd          , Rd          , Rd          , Rd          , Rd          , Ss          , Rd          , Rd          , Rd          , Rd          , Rd          , Rd          , Rd          , Rd          , Rd          , Rd          , Hd          , Rd          , Gd          , Rd          , Rd          , Rd          , Rd          , Rd          , Rd          , Rd          , Rd          , Rd          
Dd          , Dd          , Dd          , Dd          , Dd          , Dd          , Rd          , Ce          , Rd          , Hd          , Hd          , Hd          , Hd          , Hd          , Hd          , Dd          , Dd          , Dd          , Rd          , Rd          , Rd          , Rd          , Rd          , Ss          , Rd          , Rd          , Rd          , Rd          , Gd          , Gd          , Gd          , Gd          , Gd          , Hd          , Hd          , Dd          , Rd          , Rd          , Rd          , Rd          , Rd          , Re^Vct      , Rd          , Rd          , Rd          , Rd          
Rd          , Gd          , Dd          , Dd          , Dd          , Dd          , Rd          , Rd          , Rd          , Rd          , Gd          , Hd          , Gd          , Hd          , Dd          , Dd          , Hd          , Dd          , Rd          , Re^Vct      , Rd          , Rd          , Ss          , Ss          , Rd          , Rd          , Rd          , Gd          , Gd          , Gd          , Gd          , Gd          , Gd          , Hd          , Hd          , Dd          , Rd          , Rd          , Rd          , Rd          , Gd          , Rd          , Gd          , Gd          , Gd          , Rd          
Gd          , Gd          , Gd          , Dd          , Rd          , Rd          , Re^Vct      , Rd          , Rd          , Gd          , Gd          , Gd          , Gd          , Gd          , Gd          , Hd          , Hd          , Dd          , Rd          , Rd          , Rd          , Rd          , Ss          , Rd          , Rd          , Rd          , Gd          , Gd          , Rd          , Gd          , Gd          , Gd          , Rd          , Dd          , Dd          , Dd          , Rd          , Rd          , Rd          , Gd          , Gd          , Gd          , Gd          , Gd          , Rd          , Rd          
Gd          , Gd          , Gd          , Gd          , Gd          , Rd          , Rd          , Rd          , Gd          , Gd          , Gd          , Gd          , Gd          , Gd          , Hd          , Hd          , Rd          , Rd          , Rd          , Rd          , Rd          , Rd          , Ss          , Rd          , Dd          , Rd          , Dd          , Dd          , Dd          , Dd          , Dd          , Rd          , Rd          , Rd          , Rd          , Dd          , Rd          , Rd          , Gd          , Gd          , Gd          , Gd          , Gd          , Gd          , Rd          , Rd          
Gd          , Gd          , Gd          , Gd          , Gd          , Rd          , Rd          , Rd          , Rd          , Rd          , Rd          , Gd          , Rd          , Rd          , Rd          , Rd          , Rd          , Rd          , Gd          , Rd          , Gd          , Ss          , Rd          , Dd          , Hd          , Dd          , Dd          , Hd          , Hd          , Hd          , Dd          , Rd          , Rd          , Rd          , Rd          , Rd          , Rd          , Rd          , Rd          , Gd          , Gd          , Gd          , Hd          , Dd          , Dd          , Rd          
Gd          , Gd          , Gd          , Gd          , Rd          , Rd          , Rd          , Rd          , Rd          , Rd          , Rd          , Rd          , Rd          , Rd          , Rd          , Rd          , Rd          , Gd          , Gd          , Gd          , Gd          , Ss          , Gd          , Rd          , Hd          , Dd          , Hd          , Hd          , Hd          , Hd          , Rd          , Rd          , Rd          , Rd          , Re^Vct      , Rd          , Rd          , Rd          , Rd          , Rd          , Hd          , Hd          , Dd          , Dd          , Dd          , Dd          
Gd          , Gd          , Gd          , Gd          , Rd          , Rd          , Rd          , Rd          , Rd          , Rd          , Rd          , Rd          , Rd          , Rd          , Rd          , Rd          , Gd          , Gd          , Gd          , Gd          , Ss          , Ss          , Gd          , Gd          , Hd          , Hd          , Hd          , Hd          , Hd          , Gd          , Gd          , Gd          , Gd          , Rd          , Rd          , Rd          , Rd          , Rd          , Rd          , Dd          , Dd          , Dd          , Dd          , Dd          , Dd          , Dd          
