border_size=1
usage=map

Xos         , Xos         , Gg          , Rr          , Gs          , Xos         , Xos         , Xos         , Xos         , Gg^Ii       , Rrc^Ii      , Xos         , Xos         , Xos         , Xos         , Xos         , Rrc^Ii      , Gg^Ii       , Xol         , Xos         , Xos         , Xos         , Gg^Fet      , Gg          , Rr^Ii       , Xos         , Xos         , Xos         , Gg^Ii       , Rrc^Ii      , Gg^Ii       , Xos         , Xos         , Rr          , Xos         , Xos         , Xos         , Xos         , Xos         , Gg^Ii       , Gg^Ii       , Gg^Ii       , Gg^Ii       , Rrc^Ii      , Gs^Fds      , Gs^Fds      
Xos         , Xos         , Gs^Fds      , Rr          , Rr          , Gg          , Xos         , Xos         , Xos         , Gg^Ii       , Rrc^Ii      , Xos         , 2 Iwr^Ii    , Xol         , Xol         , Xol         , Xol         , Rrc^Ii      , Rrc^Ii      , Xol         , Gg^Ii       , Xos         , Rr^Ii       , Rr^Ii       , Xos         , Xos         , Xos         , Xos         , Gg^Fet      , Rrc^Ii      , Xol         , Xos         , Xos         , Rr^Ii       , Xos         , Xos         , Xos         , Xos         , Xos         , Gg          , Gg^Fet      , Gg^Ii       , Rrc^Ii      , Rrc^Ii      , Gs^Fds      , Gs^Fds      
Xos         , Xos         , Xos         , Gs^Fds      , Rr^Ii       , Gg^Fet      , Xos         , Xos         , Xol         , Gg^Fet      , Rrc^Ii      , Xos         , Iwr^Ii      , Iwr^Ii      , Iwr^Ii      , Iwr^Ii      , Iwr^Ii      , Xol         , Xos         , Rrc^Ii      , Rrc^Ii      , Rr^Ii       , Xos         , Xos         , Xos         , Xos         , Xol         , Gg^Ii       , Rrc^Ii      , Rrc^Ii      , Rrc^Ii      , Xol         , Gg^Ii       , Rr^Ii       , Gg^Ii       , Xol         , Xol         , Xos         , Gg^Ii       , Gg^Ii       , Rrc^Ii      , Rrc^Ii      , Gs^Fds      , Gs^Fds      , Xos         , Xos         
Xos         , Xos         , Xos         , Gs^Fds      , Rr^Ii       , Gg^Ii       , Gg^Ii       , Xol         , Gg^Ii       , Gg^Ii       , Rrc^Ii      , Xos         , Iwr^Ii      , Iwr^Ii      , Iwr^Ii      , Iwr^Ii      , Iwr^Ii      , Xol         , Xol         , Gg^Ii       , Rrc^Ii      , Gg^Ii       , Xos         , Xos         , Xos         , Xol         , Rrc^Ii      , Rrc^Ii      , Xos         , Xos         , Xos         , Rrc^Ii      , Rrc^Ii      , Rrc^Ii      , Rrc^Ii      , Gg^Ii       , Gg^Ii       , Gg^Ii       , Rrc^Ii      , Rrc^Ii      , Gs^Fds      , Gs^Fds      , Xos         , Xos         , Xos         , Xos         
Xos         , Xos         , Xol         , Xol         , Gs^Fds      , Rr^Ii       , Rr^Ii       , Gg^Ii       , Rrc^Ii      , Rrc^Ii      , Xol         , Xol         , Iwr^Ii      , Iwr^Ii      , Iwr^Ii      , Iwr^Ii      , Iwr^Ii      , Iwr^Ii      , Xos         , Gg^Ii       , Rrc^Ii      , Gg^Ii       , Gg^Ii       , Gg^Fet      , Rrc^Ii      , Rrc^Ii      , Rrc^Ii      , Gg^Ii       , Xol         , Xos         , Xos         , Xos         , Gg^Ii       , Gg^Ii       , Rr^Ii       , Rrc^Ii      , Rrc^Ii      , Rrc^Ii      , Gg^Ii       , Gs^Fds      , Xos         , Xos         , Xos         , Xos         , Xos         , Xos         
Gg^Ii       , Xos         , Xos         , Gg^Ii       , Gs^Fds      , Gs^Fds      , Rrc^Ii      , Rrc^Ii      , Xos         , Xos         , Iwr^Ii      , Iwr^Ii      , Iwr^Ii      , Iwr^Ii      , Iwr^Ii      , Iwr^Ii      , Xol         , Xos         , Gs^Fds      , Gs^Ii       , Rrc^Ii      , Gg^Ii       , Rrc^Ii      , Rrc^Ii      , Xol         , Xos         , Xos         , Rrc^Ii      , Rrc^Ii      , Xol         , Xos         , Xos         , Rr^Ii       , Rr^Ii       , Gs^Fds      , Gs^Fds      , Xos         , Rrc^Ii      , Rrc^Ii      , Gg^Ii       , Gg^Ii       , Xol         , Xol         , Xos         , Xos         , Xos         
Rrc^Ii      , Gg^Ii       , Gg^Ii       , Gg^Ii       , Rrc^Ii      , Rrc^Ii      , Gg^Ii       , Gg^Ii       , Xos         , Xos         , Xos         , Iwr^Ii      , Iwr^Ii      , Iwr^Ii      , Iwr^Ii      , Xol         , Xol         , Xol         , Rrc^Ii      , Rrc^Ii      , Xos         , Rrc^Ii      , Rrc^Ii      , Gg^Ii       , Gg^Ii       , Xol         , Xos         , Xos         , Xos         , Rrc^Ii      , Rrc^Ii      , Rr^Ii       , Gg^Ii       , Gg^Ii       , Xol         , Xos         , Xos         , Xos         , Xos         , Rrc^Ii      , Rrc^Ii      , Gg^Ii       , Gg^Ii       , Xos         , Gg^Fet      , Gg^Ii       
Xos         , Rrc^Ii      , Rrc^Ii      , Rrc^Ii      , Gg^Ii       , Gg^Ii       , Gg^Ii       , Gs^Ii       , Gs^Ii       , Xos         , Xos         , Xos         , Xos         , Iwr^Ii      , Rr^Ii       , Xos         , Rrc^Ii      , Rrc^Ii      , Xos         , Xos         , Xos         , Xos         , Xos         , Rrc^Ii      , Rrc^Ii      , Gg^Ii       , Xos         , Xos         , Xos         , Xos         , Rr^Ii       , Rrc^Ii      , Rrc^Ii      , Gg^Ii       , Gg^Ii       , Xol         , Xos         , Xos         , Xos         , Gg^Ii       , Gg^Ii       , Rrc^Ii      , Rrc^Ii      , Gg^Ii       , Rrc^Ii      , Rrc^Ii      
Xos         , Xos         , Xos         , Rrc^Ii      , Rrc^Ii      , Gg^Ii       , Gg^Ii       , Gg^Ii       , Gg^Ii       , Gs^Ii       , Gs^Ii       , Xos         , Xol         , Xol         , Rrc^Ii      , Rrc^Ii      , Rr^Ii       , Gg^Ii       , Xos         , Xos         , Xos         , Xos         , Gg^Ii       , Gg^Ii       , Rrc^Ii      , Gg^Ii       , Rr^Ii       , Xos         , Rr^Ii       , Rr^Ii       , Xos         , Xos         , Xos         , Rrc^Ii      , Rrc^Ii      , Gg^Ii       , Gg^Ii       , Xos         , Gs^Fds      , Gs^Fds      , Gg^Ii       , Gg^Fet      , Rrc^Ii      , Rrc^Ii      , Rrc^Ii      , Rrc^Ii      
Xos         , Xos         , Xos         , Xos         , Xos         , Rrc^Ii      , Rrc^Ii      , Gg^Ii       , Gg^Ii       , Gg^Ii       , Gg^Ii       , Gg^Ii       , Rrc^Ii      , Rrc^Ii      , Gg^Ii       , Gg^Ii       , Gg^Ii       , Rr^Ii       , Rr^Ii       , Gs          , Rr^Ii       , Gg^Ii       , Rr^Ii       , Rr^Ii       , Rrc^Ii      , Rr^Ii       , Gg^Ii       , Rr^Ii       , Rr          , Gs          , Gs          , Xos         , Rr^Ii       , Gg^Ii       , Rr^Ii       , Rrc^Ii      , Rrc^Ii      , Gg^Ii       , Gg^Ii       , Gs^Fds      , Gg^Fet      , Rrc^Ii      , Rrc^Ii      , Rrc^Ii      , Rrc^Ii      , Rrc^Ii      
Xos         , Xos         , Xos         , Xos         , Xol         , Gs^Ii       , Gs^Ii       , Rrc^Ii      , Rrc^Ii      , Gg^Ii       , Rrc^Ii      , Rrc^Ii      , Rr^Ii       , Gg^Ii       , Gg^Ii       , Gg^Ii       , Xos         , Gg^Ii       , Xos         , Rr^Ii       , Xos         , Rr^Ii       , Xos         , Gg^Ii       , Rrc^Ii      , Xos         , Xos         , Gg^Ii       , Gs          , Rr          , Rr^Ii       , Rr^Ii       , Xos         , Rr^Ii       , Gg^Ii       , Gg^Ii       , Gs^Fds      , Rrc^Ii      , Rrc^Ii      , Gg^Ii       , Rrc^Ii      , Rrc^Ii      , Rrc^Ii      , Rrc^Ii      , Rrc^Ii      , Rrc^Ii      
Gg          , Xos         , Xos         , Xol         , Gg^Ii       , Gg^Ii       , Gg^Ii       , Gg^Ii       , Rrc^Ii      , Rrc^Ii      , Gg^Ii       , Gg^Ii       , Rr^Ii       , Gg^Ii       , Xol         , Xos         , Xos         , Xos         , Xos         , Xos         , Xos         , Xos         , Xos         , Gg^Ii       , Rrc^Ii      , Xos         , Xos         , Xos         , Rr          , Rr          , Gg          , Xos         , Xos         , Rr^Ii       , Gs          , Xos         , Xos         , Gs^Fds      , Gg^Fet      , Rrc^Ii      , Rrc^Ii      , Rrc^Ii      , Rrc^Ii      , Rrc^Ii      , Rrc^Ii      , Rrc^Ii      
Rrc^Ii      , Gs^Fds      , Gs^Fds      , Xos         , Gg^Ii       , Gg^Ii       , Rrc^Ii      , Rrc^Ii      , Xos         , Gg^Ii       , Gg^Ii       , Gg^Ii       , Rr^Ii       , Gg^Ii       , Gg^Ii       , Xol         , Xos         , Xos         , Xos         , Xos         , Xos         , Xos         , Xos         , Gg^Ii       , Rrc^Ii      , Xos         , Xos         , Xos         , Rr          , Gg          , Xos         , Xos         , Xos         , Rr          , Gs^Fds      , Xos         , Xos         , Xos         , Gg^Ii       , Rrc^Ii      , Rrc^Ii      , Rrc^Ii      , Rrc^Ii      , Rrc^Ii      , Rrc^Ii      , Rrc^Ii      
Gg^Ii       , Rrc^Ii      , Rrc^Ii      , Gg^Ii       , Rrc^Ii      , Rrc^Ii      , Xos         , Xos         , Xos         , Gg^Ii       , Gg^Fet      , Gg^Ii       , Rr^Ii       , Gg^Ii       , Gg^Ii       , Xol         , Xol         , Xos         , Xos         , Xos         , Xol         , Xol         , Gg^Ii       , Gg^Ii       , Rrc^Ii      , Xol         , Xol         , Xos         , Rr^Ii       , Xos         , Xos         , Xos         , Xos         , Rr          , Gs^Fds      , Xos         , Xos         , Xos         , Gg^Ii       , Rrc^Ii      , Rrc^Ii      , Rrc^Ii      , Rrc^Ii      , Rrc^Ii      , Rrc^Ii      , Rrc^Ii      
Xos         , Xos         , Xos         , Rrc^Ii      , Gg^Ii       , Xos         , Xos         , Xos         , Xos         , Gg^Ii       , Gs^Fds      , Gs^Fds      , Gg          , Rr^Ii       , Gg          , Gg^Ii       , Xos         , Xos         , Xol         , Xos         , Gs^Fds      , Gg^Ii       , Rrc^Ii      , Rrc^Ii      , Xos         , Rrc^Ii      , Rrc^Ii      , Xos         , Rr^Ii       , Xos         , Xol         , Xos         , Xos         , Rr          , Gg^Ii       , Xos         , Xol         , Xol         , Gg^Fet      , Rrc^Ii      , Rrc^Ii      , Rrc^Ii      , Rrc^Ii      , Rrc^Ii      , Rrc^Ii      , Rrc^Ii      
Xos         , Xos         , Xos         , Rrc^Ii      , Gg^Fet      , Xos         , Xos         , Xol         , Xos         , Xos         , Gs^Fds      , Gs^Fds      , Gg          , Rr          , Gg          , Gg          , Xos         , Xol         , Gg^Ii       , Gs^Fds      , Rrc^Ii      , Rrc^Ii      , Xos         , Xos         , Xos         , Xos         , Xos         , Rrc^Ii      , Rrc^Ii      , Gg^Ii       , Gg^Ii       , Xol         , Xos         , Rr^Ii       , Gg^Ii       , Xos         , Gg^Ii       , Gg^Ii       , Rrc^Ii      , Rrc^Ii      , Rrc^Ii      , Rrc^Ii      , Rrc^Ii      , Rrc^Ii      , Rrc^Ii      , Rrc^Ii      
Xos         , Xos         , Xos         , Rrc^Ii      , Rrc^Ii      , Gg          , Gg          , Xol         , Xol         , Xos         , Gs^Fds      , Gs^Fds      , Gg          , Rr          , Rr^Ii       , Xos         , Gg^Ii       , Gg^Ii       , Rrc^Ii      , Rrc^Ii      , Rr^Ii       , Xos         , Xos         , Xos         , Xos         , Xos         , Gg^Ii       , Gg^Ii       , Rr^Ii       , Rrc^Ii      , Rrc^Ii      , Gg^Ii       , Gg^Ii       , Rr^Ii       , Gg^Ii       , Gg^Ii       , Rrc^Ii      , Rrc^Ii      , Rrc^Ii      , Rrc^Ii      , Xos         , Rrc^Ii      , Rrc^Ii      , Rrc^Ii      , Rrc^Ii      , Rrc^Ii      
Gg          , Xos         , Xos         , Rrc^Ii      , Gg^Ii       , Rrc^Ii      , Rrc^Ii      , Gg^Fet      , Gg^Ii       , Xos         , Xos         , Xos         , Xos         , Gg^Ii       , Gg^Ii       , Rr^Ii       , Rrc^Ii      , Rrc^Ii      , Xos         , Xos         , Xos         , Rr^Ii       , Rr^Ii       , Xos         , Xos         , Xos         , Gg^Ii       , Rr^Ii       , Gg^Ii       , Gs^Ii       , Gs^Ii       , Rrc^Ii      , Rrc^Ii      , Rr^Ii       , Rrc^Ii      , Rrc^Ii      , Rrc^Ii      , Rrc^Ii      , Xos         , Xos         , Xos         , Gg^Fet      , Rr^Ii       , Gg^Ii       , Gg^Fet      , Rrc^Ii      
Rr          , Gs^Fds      , Gs^Fds      , Rrc^Ii      , Gg^Ii       , Gg^Ii       , Gg^Ii       , Rrc^Ii      , Rrc^Ii      , Gg^Ii       , Xol         , Xos         , Xol         , Xos         , Rrc^Ii      , Rrc^Ii      , Xos         , Xos         , Gg          , Xos         , Rr          , Rr          , Gs          , Rr          , Gs          , Gs^Ii       , Rr^Ii       , Rr^Ii       , Xos         , Gg^Ii       , Gg^Ii       , Gg^Ii       , Rrc^Ii      , Rrc^Ii      , Rrc^Ii      , Rrc^Ii      , Gg^Fet      , Xos         , Xos         , Xos         , Xos         , Gg^Ii       , Rr^Ii       , Xos         , Xos         , Gg^Ii       
Xos         , Rr          , Rr^Ii       , Rr^Ii       , Gg^Fet      , Xos         , Xos         , Gg^Fet      , Gg^Ii       , Rrc^Ii      , Rrc^Ii      , Xol         , Rrc^Ii      , Rrc^Ii      , Xos         , Xos         , Rr^Ii       , Rr          , Rr          , Rr          , Xos         , Gg          , Gg          , Rr          , Rr          , Rr^Ii       , Xos         , Xos         , Xol         , Xos         , Rrc^Ii      , Rrc^Ii      , Rrc^Ii      , Rrc^Ii      , Xos         , Rrc^Ii      , Rrc^Ii      , Gg          , Xol         , Xos         , Xos         , Gs^Fds      , Rr^Ii       , Xos         , Xos         , Xos         
Xos         , Xos         , Gg^Ii       , Rr^Ii       , Gs^Fds      , Xos         , Xos         , Xos         , Xos         , Gg^Ii       , Gg^Fet      , Rrc^Ii      , Rrc^Ii      , Xos         , Xol         , Xos         , Rr^Ii       , Xos         , Xos         , Gg          , Xos         , Xos         , Gg^Ii       , Rr          , Gg^Ii       , Xos         , Xos         , Xol         , Rrc^Ii      , Rrc^Ii      , Rrc^Ii      , Rrc^Ii      , Rr^Ii       , Gg^Fet      , Xos         , Xos         , Xos         , Rrc^Ii      , Rrc^Ii      , Xol         , Gg^Ii       , Gg^Ii       , Rr^Ii       , Xos         , Xos         , Xos         
Xos         , Xos         , Xos         , Rr^Ii       , Gs^Fds      , Xos         , Xos         , Xos         , Xos         , Xos         , Xos         , Gg^Ii       , Gg^Ii       , Rrc^Ii      , Rrc^Ii      , Xol         , Rr^Ii       , Xos         , Xol         , Xos         , Xos         , Xos         , Xol         , Rr^Ii       , Rr^Ii       , Gg^Fet      , Rrc^Ii      , Rrc^Ii      , Rrc^Ii      , Rrc^Ii      , Xos         , Xos         , Xos         , Rr^Ii       , Rr^Ii       , Gs^Fds      , Xos         , Xos         , Xos         , Rrc^Ii      , Rrc^Ii      , Gg^Fet      , Rr          , Gg^Ii       , Xol         , Xos         
Xos         , Xos         , Gg          , Rr          , Xos         , Xos         , Xos         , Xos         , Xos         , Xos         , Xos         , Xos         , Xos         , Gg^Ii       , Gg^Fet      , Rrc^Ii      , Rrc^Ii      , Gg^Ii       , Gg^Ii       , Xol         , Xos         , Xol         , Gg^Ii       , Gg^Fet      , Rrc^Ii      , Rrc^Ii      , Rrc^Ii      , Rrc^Ii      , Xos         , Xos         , Rr^Ii       , Rr^Ii       , Rr^Ii       , Gg^Ii       , Rr^Ii       , Gs^Fds      , Xos         , Xos         , Xos         , Xos         , Gg^Ii       , Rrc^Ii      , Rrc^Ii      , Gg^Ii       , Gg^Ii       , Xol         
Xos         , Xos         , Gg          , Rr          , Xos         , Xos         , Xos         , Xos         , Xos         , Xos         , Xos         , Xos         , Xos         , Xos         , Xos         , Gg^Ii       , Gs^Fds      , Rrc^Ii      , Rrc^Ii      , Gg^Fet      , Gg^Ii       , Xol         , Rrc^Ii      , Rrc^Ii      , Rrc^Ii      , Rrc^Ii      , Xol         , Xos         , Xos         , Rr          , Xos         , Gg^Ii       , Xos         , Rr^Ii       , Gg^Ii       , Rr^Ii       , Gg^Ii       , Xos         , Xos         , Xos         , Rrc^Ii      , Rrc^Ii      , Xos         , Rrc^Ii      , Rrc^Ii      , Gg^Ii       
Gs^Fds      , Xos         , Gg^Fet      , Rr          , Xos         , Xos         , Xos         , Xos         , Xos         , Xos         , Xos         , Xos         , Xos         , Xos         , Xos         , Xos         , Xos         , Gs^Fds      , Gg^Ii       , Rrc^Ii      , Rrc^Ii      , Rrc^Ii      , Rrc^Ii      , Rrc^Ii      , Xos         , Rrc^Ii      , Rrc^Ii      , Xol         , Gs          , Xos         , Xos         , Xos         , Xos         , Xos         , Gs^Fds      , Rr^Ii       , Gg^Fet      , Gg^Ii       , Rrc^Ii      , Rrc^Ii      , Xos         , Xos         , Xos         , Xos         , Rr^Ii       , Rrc^Ii      
Xos         , Gs^Fds      , Gg          , Rr          , Xos         , Xos         , Xos         , Xos         , Xos         , Xos         , Xos         , Xos         , Xos         , Xos         , Xos         , Xos         , Xol         , Xos         , Rrc^Ii      , Rrc^Ii      , Rrc^Ii      , Rrc^Ii      , Xos         , Xos         , Xos         , Xos         , Xos         , Rrc^Ii      , Rrc^Ii      , Xol         , Xol         , Xos         , Xos         , Xos         , Gs^Fds      , Rr^Ii       , Rrc^Ii      , Rrc^Ii      , Xos         , Xos         , Xos         , Xos         , Xos         , Gg^Ii       , Rr^Ii       , Gg^Ii       
Xos         , Gs^Fds      , Gg          , Rr          , Xos         , Xos         , Xos         , Xos         , Xos         , Xos         , Xos         , Xos         , Xos         , Xos         , Xos         , Xol         , Rrc^Ii      , Rrc^Ii      , Rrc^Ii      , Rrc^Ii      , Xos         , Rr^Ii       , Rr^Ii       , Xos         , Gg^Fet      , Xos         , Rr^Ii       , Rr^Ii       , Xos         , Rrc^Ii      , Rrc^Ii      , Xos         , Gg^Ii       , Gg^Ii       , Rrc^Ii      , Rrc^Ii      , Xos         , Rr^Ii       , Rr^Ii       , Xos         , Gg          , Xos         , Rr          , Rr          , Gg          , Gs^Fds      
Xos         , Gg          , Gg          , Rr          , Xos         , Xos         , Xos         , Xos         , Xos         , Xos         , Xos         , Xos         , Xol         , Xos         , Rrc^Ii      , Rrc^Ii      , Rrc^Ii      , Rrc^Ii      , Xol         , Xos         , Xos         , Xos         , Rr          , Rr          , Rr          , Rr          , Xos         , Xos         , Xos         , Xos         , Xol         , Rrc^Ii      , Rrc^Ii      , Rrc^Ii      , Xol         , Xos         , Xos         , Xos         , Xos         , Rr^Ii       , Rr          , Rr          , Gs^Fds      , Gg          , Gs^Fds      , Gs^Fds      
Xos         , Gg          , Gg^Fet      , Rr          , Rr^Ii       , Xos         , Gg^Ii       , Xos         , Xos         , Xos         , Xos         , Xol         , Rrc^Ii      , Rrc^Ii      , Rrc^Ii      , Rrc^Ii      , Xos         , Rrc^Ii      , Rrc^Ii      , Xol         , Xos         , Xos         , Rr^Ii       , Xos         , Xos         , Rr          , Rr^Ii       , Xos         , Gg^Ii       , Xol         , Rrc^Ii      , Rrc^Ii      , Rrc^Ii      , Gg^Ii       , Gg^Ii       , Xol         , Xos         , Xos         , Gg          , Gg          , Rr          , Rr          , Rr          , Gg          , Xos         , Xos         
Xos         , Xos         , Xos         , Gg          , Gg^Ii       , Rr^Ii       , Rr^Ii       , Gg^Ii       , Gg^Ii       , Xos         , Rrc^Ii      , Rrc^Ii      , Rrc^Ii      , Rrc^Ii      , Xos         , Xos         , Xos         , Xos         , Xos         , Rrc^Ii      , Rrc^Ii      , Gg^Ii       , Rr^Ii       , Xos         , Xos         , Xos         , Xol         , Rr^Ii       , Rrc^Ii      , Rrc^Ii      , Xos         , Gs^Ii       , Gs^Ii       , Rrc^Ii      , Rrc^Ii      , Gg^Fet      , Xos         , Xos         , Rr^Ii       , Rr          , Xos         , Gg          , Rr          , Xos         , Xos         , Xos         
Gg^Ii       , Xos         , Xos         , Xos         , Xol         , Gg^Ii       , Gg^Fet      , Rr          , Rrc^Ii      , Rrc^Ii      , Rrc^Ii      , Rrc^Ii      , Xos         , Xos         , Xos         , Xos         , Xos         , Xos         , Xos         , Xos         , Xos         , Rrc^Ii      , Rrc^Ii      , Xos         , Xos         , Xol         , Rrc^Ii      , Rrc^Ii      , Xos         , Xos         , Xos         , Xos         , Xos         , Gg^Ii       , Rrc^Ii      , Gg^Ii       , Rr^Ii       , Rr^Ii       , Xos         , Xos         , Xos         , Gg          , Rr          , Xos         , Xos         , Xos         
Gg^Ii       , Gg^Ii       , Gg^Ii       , Xol         , Gg^Ii       , Gg^Ii       , Rrc^Ii      , Rrc^Ii      , Rrc^Ii      , Rrc^Ii      , Rr^Ii       , Xos         , Rr          , Xos         , Xos         , Xos         , Xos         , Xos         , Xos         , Xos         , Xos         , Xos         , Rrc^Ii      , Gg^Ii       , Rrc^Ii      , Rrc^Ii      , Xos         , Xos         , Xos         , Xos         , Xos         , Xos         , Xos         , Gg^Ii       , Gg^Fet      , Rrc^Ii      , Rrc^Ii      , Xos         , Xos         , Xos         , Rr          , Rr          , Gs^Fds      , Rr          , Rr          , Xos         
Gg^Ii       , Gg^Ii       , Gg^Ii       , Gg^Ii       , 1 Rrc^Ii    , Rrc^Ii      , Rrc^Ii      , Rrc^Ii      , Gg^Ii       , Gg^Fet      , Gg^Ii       , Rr^Ii       , Gs^Fds      , Rr          , Rr          , Xos         , Gg          , Xos         , Xos         , Xos         , Xos         , Gs^Ii       , Gs^Ii       , Rrc^Ii      , Rrc^Ii      , Gg^Fet      , Gg          , Xol         , Xol         , Xos         , Xos         , Xos         , Gg^Ii       , Gg^Ii       , Rr^Ii       , Rr^Ii       , Rrc^Ii      , Xos         , Rr^Ii       , Rr^Ii       , Gg^Ii       , Gg          , Xos         , Gs^Fds      , Gs^Fds      , Rr          
Gg^Ii       , Gg^Ii       , Rrc^Ii      , Rrc^Ii      , Rrc^Ii      , Rrc^Ii      , Gg^Ii       , Gg^Ii       , Xol         , Xol         , Xos         , Gg^Ii       , Gg          , Gs^Fds      , Gg          , Rr          , Rr          , Gs          , Gg          , Gs          , Gg^Ii       , Gs^Ii       , Gs^Ii       , Gs^Ii       , Rr^Ii       , Rrc^Ii      , Rrc^Ii      , Gg          , Gg^Ii       , Xos         , Gg^Ii       , Gg^Ii       , Rr^Ii       , Rr^Ii       , Gg^Ii       , Gg^Ii       , Xos         , Rrc^Ii      , Rrc^Ii      , Gs^Fds      , Gs^Fds      , Xos         , Xos         , Xos         , Xos         , Gs^Fds      
Rrc^Ii      , Rrc^Ii      , Rrc^Ii      , Rrc^Ii      , Gg^Ii       , Gg^Ii       , Gg^Ii       , Gg^Ii       , Gg^Ii       , Xos         , Xos         , Xos         , Xos         , Xos         , Xos         , Xos         , Xos         , Rr          , Rr          , Gs          , Gg          , Gg^Ii       , Rr^Ii       , Rr^Ii       , Gg^Ii       , Gg^Ii       , Rrc^Ii      , Gg^Ii       , Gg^Ii       , Gg^Ii       , Rr          , Rr^Ii       , Gs^Fds      , Gs^Fds      , Xos         , Xos         , Xos         , Xos         , Xos         , Rrc^Ii      , Gg^Ii       , Xos         , Xos         , Xos         , Xos         , Xos         
