border_size=1
usage=map

Xu, Xu, Xu, Xu, Xu, Xu, Xu, Xu, Xu, Xu, Xu, Xu, Xu, Xu, Xu, Xu, Xu, Xu, Xu, Xu, Xu, Xu, Xu, Xu, Xu, Xu, Xu, Xu, Xu, Xu, Xu, Xu, Xu, Xu, Xu, Xu, Ur, Ur^Br|, Uu, Xu, Xu, Xu, Xu, Xu, Xu, Xu
Xu, Xu, Xu, Xu, Xu, Xu, Xu, Xu, Xu, Xu, Xu, Xu, Xu, Xu, Xu, Xu, Xu, Xu, Xu, Xu, Xu, Xu, Xu, Xu, Xu, Xu, Xu, Xu, Xu, Xu, Xu, Xu, Xu, Xu, Xu, Xu, Xu, Ur^Br|, Ur^Es, Ur^Es, Uu^Uf, Xu, Xu, Xu, Xu, Xu
Xu, Xu, Xu, Xu, Xu, Xu, Xu, Xu, Xu, Xu, Xu, Xu, Xu, Xu, Xu, Xu, Xu, Xu, Xu, Xu, Xu, Xu, Xu, Xu, Xu, Xu, Xu, Xu, Xu, Xu, Wwg, Xu, Wwg, Xu, Xu, Uu^Emf, Uu^Emf, Ur^Br|, Uu, Uu, Cud, Cud, 2 Kud, Xu, Xu, Xu
Xu, Xu, Xu, Xu, Xu, Xu, Xu, Xu, Xu, Xu, Xu, Xu, Xu, Xu, Xu, Xu, Xu, Xu, Xu, Xu, Xu, Xu, Xu, Xu, Xu, Xu, Xu, Xu, Wwg, Wwg, Wwg, Wwg, Wwg, Wwg, Uu^Emf, Ur^Emf, Ur, Ur^Br|, Ur^Dr, Ur^Dr, Cud, Cud, Cud, Xu, Xu, Xu
Xu, Xu, Xu, Xu, Xu, Xu, Xu, Xu, Xu, Xu, Xu, Xu, Xu, Xu, Xu, Xu, Xu, Xu, Xu, Xu, Xu, Xu, Xu, Xu, Xu, Xu, Xu, Wwg, Wwg, Wwg, Wwg, Wwg, Wwg, Wwg, Uu^Em, Urb^Dr, Ur, Ur^Br|, Ur, Uu^Dr, Cud, Cud, Cud, Cud, Xu, Xu
Xu, Xu, Xu, Xu, Xu, Xu, Xu, Xu, Xu, Xu, Xu, Xu, Xu, Xu, Xu, Xu, Xu, Xu, Xu, Xu, Xu, Xu, Xu, Xu, Xu, Xu, Xu, Wwg, Wwg, Wwg, Wwg, Wwg, Wwg, Wwg, Urb^Em, Uu, Ur^Br/, Ur^Br/, Urb^Dr, Urb, Uu^Vu, Cud, Cud, Xu, Xu, Xu
Xu, Xu, Xu, Xu, Xu, Xu, Xu, Xu, Xu, Xu, Xu, Xu, Xu, Xu, Xu, Xu, Xu, Xu, Xu, Xu, Xu, Xu, Xu, Xu, Xu, Xu, Xu, Uu^Uf, Uu^Uf, Wwg, Wwg, Wwg, Uu^Vu, Ur, Uu^Br/, Ur^Br/, Ur^Em, Ur, Urb^Dr, Uu^Dr, Xu, Xu, Xu, Xu, Xu, Xu
Xu, Xu, Xu, Xu, Xu, Xu, Xu, Xu, Xu, Xu, Xu, Xu, Xu, Xu, Cud, Cud, Cud, 6 Kud, Xu, Xu, Xu, Xu, Xu, Xu, Xu, Xu, Xu, Uu^Uf, Ur, Uu^Em, Wwg^Bw/r, Urb^Dr, Uu^Br/, Uu^Br/, Xu, Uu, Urb^Es, Ur^Dr, Xu, Ur^Emf, Xu, Xu, Xu, Xu, Xu, Xu
Xu, Xu, Xu, Xu, Xu, Xu, Xu, Xu, Xu, Xu, Xu, Uu^Emf, Uh, Uh, Uu, Cud, Uu, Cud, Xu, Xu, Uh, Xu, Uu^Emf, Xu, Xu, Xu, Uh, Uh, Uu^Br/, Ur^Br\, Wwg^Br/, Uu^Br/, Uu, Xu, Uu, Uu^Uf, Xu, Ur, Uh, Xu, Xu, Xu, Xu, Xu, Xu, Xu
Xu, Xu, Xu, Xu, Xu, Xu, Xu, Xu, Uh, Xu, Uh, Uh, Uu^Em, Uu^Em, Urb^Dr, Urb, Uu^Es, Xu, Uu^Vu, Xu, Urb^Dr, Uh^Em, Urb, Urb^Dr, Uu^Br/, Urb^Br\, Urb^Br/, Urb^Br/, Uu^Es, Urb^Es, Wwg, Wwg, Xu, Uu^Es, Urb^Dr, Xu, Xu, Ur, Uu^Emf, Xu, Xu, Xu, Xu, Xu, Xu, Xu
Xu, Xu, Xu, Xu, Xu, Uh, Uu^Emf, Xu, Uh^Es, Uh^Es, Ur^Em, Uu^Em, Ur^Em, Urb^Es, Uu, Ur, Urb, Urb, Uu^Em, Ur^Em, Urb^Em, Urb^Em, Uu^Br/, Urb^Br/, Xu, Uu^Dr, Xu, Xu, Xu, Xu, Wwg, Xu, Xu, Xu, Urb, Uu^Dr, Uu, Uu^Vu, Xu, Xu, Xu, Xu, Xu, Xu, Xu, Xu
Qxu, Xu, Xu, Xu, Xu, Uh, Uu, Ur^Dr, Ur^Es, Uu^Vu, Ur, Ur, Ur, Urb, Uh, Uh, Urb, Urb^Dr, Uu^Uf, Urb, Ur, Urb^Br|, Uu, Xu, Cud, Xu, Xu, Xu, Xu, Xu, Wwg, Xu, Xu, Xu, Uh, Urb^Em, Urb^Em, Urb, Uh, Uh^Em, Cud, Cud, 8 Kud, Xu, Xu, Xu
Qxu, Qxu, Qxu, Xu, Xu, Urb, Xu, Ur, Urb, Urb, Xu, Uu^Uf, Xu, Xu, Xu, Uh, Xu, Xu, Xu, Xu, Uu, Urb^Br|, Uh, Cud, 7 Kud, Xu, Xu, Xu, Wwg, Wwg, Xu, Xu, Xu, Xu, Xu, Uh, Urb, Urb^Es, Uu, Uu, Ur, Cud, Cud, Xu, Xu, Xu
Qxu, Qxu, Qxu, Qxu, Urb, Uu^Emf, Qxu, Urb, Urb^Dr, Xu, Xu, Xu, Xu, Xu, Xu, Xu, Mm^Xm, Xu, Xu, Xu, Uu, Urb^Br|, Uh, Cud, Cud, Cud, Xu, Xu, Wwg, Wwg, Xu, Xu, Xu, Xu, Xu, Uh^Es, Urb, Ur^Dr, Uu^Dr, Xu, Uu, Cud, Xu, Xu, Xu, Xu
Qxu, Qxu, Qxu, Uh, Qxu^Bw\r, Qxu, Qxu^Bw/r, Ur^Es, Xu, Xu, Xu, Xu, Xu, Xu, Xu, Mm^Xm, Mm^Xm, Mm^Xm, Mm^Xm, Uu^Vu, Ur^Es, Urb^Br|, Urb^Dr, Uu, Mm^Xm, Xu, Mm^Xm, Mm^Xm, Wwg, Xu, Mm^Xm, Mm^Xm, Mm^Xm, Mm^Xm, Mm^Xm, Uh, Ur^Dr, Uh, Xu, Uu, Uh, Xu, Xu, Xu, Xu, Xu
Qxu, Qxu, Qxu, Qxu, Qxu, Urb, Xu, Xu, Xu, Xu, Xu, Xu, Xu, Xu, Mm^Xm, Mm^Xm, Mm, Mm, Mm, Mm^Xm, Mm, Urb^Br|, Mm^Xm, Mm^Xm, Mm, Mm^Xm, Wwg^Ii, Wwg, Hh^Fds, Mm, Mm, Mm^Xm, Mm, Mm, Mm, Mm, Gg^Fds, Mm, Mm^Xm, Xu, Xu, Xu, Xu, Xu, Xu, Xu
Qxu, Qxu, Xu, Qxu, Urb^Es, Uu^Vu, Uu, Xu, Cud, Xu, Xu, Xu, Mm^Xm, Mm^Xm, Xu, Mm^Xm, Mm, Hh^Fds, Hh^Fds, Mm, Hh^Br/, Hh^Br/, Mm, Mm^Ii, Wwg, Wwg^Ii, Gg^Fds, Wwg, Wwg, Hh^Fds, Wwg^Ii, Hh^Fds, Hh^Fds, Hh^Fds, Hh^Fds, Hh^Fds, Gg^Fds, Mm, Mm, Mm^Xm, Mm^Xm, Mm^Xm, Mm^Xm, Xu, Mm^Xm, Xu
Xu, Xu, Uh, Uh, Uu, Ur^Em, Ur^Em, Cud, Cud, 4 Kud, Xu, Xu, Mm^Xm, Xu, Ur^Br\, Mm^Xm, Hh^Fds, Hh^Fds, Hh^Br/, Hh^Br/, Gg^Fds, Gg^Fds, Wwg^Bw\r, Wwg, Gg^Fds, Gg^Fds, Gg^Fds, Gg^Fds, Gg^Fds, Wwg, Gg^Fds, Wwg^Bw/r, Wwg^Ii, Wwg, Wwg^Ii, Hh^Fds, Hh^Fds, Gg^Fds, Hh^Fds, Mm, Hh^Fds, Mm, Mm, Mm^Xm, Mm^Xm, Xu
Xu, Xu, Uh, Uu^Uf, Uh, Uu^Em, Ur^Em, Urb, Xu, Cud, Xu, Mm^Xm, Ur^Br/, Ur^Br/, Mm^Xm, Hh^Br\, Hh^Br\, Hh^Br/, Gg^Fds, Gg^Vu, Mm, Wwg^Ii, Mm, Gg^Fds, Mm, Mm, Mm, Gg^Vu, Gg^Fds, Gg^Fds, Gg^Fds, Gg^Fds, Gg^Fds, Gg^Vu, Gg^Fds, Wwg, Gg^Fds, Gg^Fds, Gg^Fds, Gg^Fds, Hh^Fds, Hh^Fds, Hh^Fds, Mm, Mm^Xm, Xu
Xu, Xu, Xu, Uh, Xu, Uh, Ur^Em, Xu, Mm^Xm, Xu, Mm^Xm, Mm^Xm, Hh^Br|, Xu, Mm^Xm, Mm, Gg^Fds, Gg^Fds, Wwg, Mm, Mm, Mm, Mm^Xm, Mm^Xm, Mm^Xm, Mm, Mm, Mm, Mm, Gg^Fds, Hh^Fds, Gg^Fds, Gg^Fds, Gg^Fds, Gg^Fds, Wwg^Bw/r, Wwg, Gg^Fds, Gg^Fds, Gg^Fds, Gg^Vu, Hh^Fds, Hh^Fds, Mm, Mm^Xm, Xu
Xu, Xu, Xu, Xu, Mm^Xm, Mm, Hh^Fds, Mm^Xm, Mm^Xm, Mm^Xm, Hh^Br/, Hh^Br/, Wwg, Mm^Xm, Wwg, Wwg, Wwg^Bw|r, Wwg, Gg^Fds, Mm, Mm^Xm, Mm^Xm, Xu, Mm^Xm, Mm^Xm, Mm^Xm, Mm^Xm, Mm^Xm, Mm, Hh^Fds, Hh^Fds, Hh^Fds, Hh^Fds, Gg^Fds, Hh^Fds, Hh^Fds, Wwg^Ii, Gg^Fds, Hh^Fds, Gg^Fds, Gg^Fds, Hh^Fds, Hh^Fds, Mm, Mm^Xm, Mm^Xm
Xu, Xu, Mm^Xm, Mm^Xm, Mm, Mm, Hh^Fds, Hh^Fds, Hh^Br/, Hh^Br/, Gg^Fds, Gg^Fds, Wwg^Ii, Wwg^Ii, Gg^Vu, Hh, Gg, Gg^Fds, Hh^Fds, Mm, Mm^Xm, Xu, Uh^Dr, Xu, Xu, Mm^Xm, Mm^Xm, Mm^Xm, Mm, Mm, Mm, Hh^Fds, Mm, Hh^Fds, Mm, Mm, Mm, Wwg, Hh^Fds, Hh^Fds, Gg^Fds, Mm, Mm, Mm, Mm^Xm, Xu
Xu, Xu, Mm^Xm, Mm, Mm, Hh^Fds, Hh^Fds, Hh^Br/, Hh^Fds, Gg^Fds, Wwg, Wwg^Ii, Hh^Fds, Gg^Fds, Gg^Fds, Gg^Ii, Gg^Ii, Gg, Hh^Fds, Mm, Uh, Xu, Uh, Xu, Xu, Xu, Xu, Mm^Xm, Mm^Xm, Mm^Xm, Mm^Xm, Mm, Mm^Xm, Mm^Xm, Mm^Xm, Mm, Mm^Xm, Wwg, Wwg, Mm, Gg^Fds, Mm, Mm, Mm^Xm, Mm^Xm, Xu
Xu, Xu, Xu, Mm^Xm, Mm^Xm, Mm, Mm, Hh^Br|, Hh^Fds, Gg^Fds, Wwg^Ii, Hh^Fds, Hh^Fds, Hh^Fds, Gg^Fds, Gg, Gg^Fds, Gg^Fds, Ur, Mm, Uh, Uh, Cud, Xu, Xu, Xu, Xu, Xu, Xu, Xu, Xu, Mm^Xm, Xu, Xu, Xu, Mm^Xm, Xu, Mm^Xm, Ur^Dr, Wwg^Bw/r, Mm^Xm, Mm^Xm, Mm^Xm, Mm^Xm, Xu, Xu
Xu, Xu, Xu, Mm^Xm, Mm^Xm, Mm^Xm, Mm^Xm, Hh^Br|, Mm, Wwg^Ii, Wwg^Ii, Wwg^Ii, Hh^Fds, Gg^Fds, Hh^Fds, Hh^Fds, Hh^Fds, Hh^Fds, Mm, Ur, Ur, Cud, Cud, 3 Kud, Xu, Xu, Xu, Xu, Xu, Xu, Xu, Xu, Xu, Xu, Ur, Xu, Ur, Xu, Ur^Dr, Wwg, Wwg, Xu, Xu, Xu, Xu, Xu
Xu, Xu, Xu, Xu, Xu, Mm^Xm, Uu^Br/, Hh^Br/, Mm, Wwg, Wwg^Bw/r, Wwg^Bw/r, Mm, Hh^Fds, Mm, Hh^Fds, Mm, Mm, Mm, Mm^Xm, Xu, Ur^Dr, Ur, Cud, Xu, Xu, Xu, Xu, Xu, Xu, Xu, Xu, Xu, Xu, Urb, Xu, Xu, Urb, Uu^Es, Uu, Wwg, Xu, Uh, Uh, Xu, Xu
Xu, Xu, Xu, Xu, Xu, Uh^Br/, Uu^Dr, Mm^Xm, Mm^Xm, Wwg^Bw/r, Wwg, Mm^Xm, Mm^Xm, Mm, Mm^Xm, Mm, Mm, Mm, Mm, Mm^Xm, Xu, Uu^Dr, Ur, Uh, Uh, Xu, Uh, Xu, Xu, Xu, Uu^Uf, Uu^Uf, Uh, Xu, Uu, Xu, Xu, Xu, Uu, Uu^Dr, Wwg, Uu^Uf, Uu^Uf, Ur^Emf, Xu, Xu
Xu, Xu, Xu, Xu, Xu, Uu^Br|, Xu, Mm^Xm, Mm^Xm, Wwg, Mm^Xm, Mm^Xm, Xu, Mm^Xm, Mm^Xm, Mm^Xm, Mm^Xm, Mm^Xm, Mm^Xm, Mm^Xm, Xu, Urb^Emf, Urb^Emf, Ur, Ur, Xu, Ur^Es, Uu^Vu, Uu, Uu^Emf, Uu^Dr, Uu^Dr, Ur^Em, Uu^Dr, Urb^Dr, Urb, Urb^Es, Uu^Es, Urb^Es, Ur, Wwg, Urb^Emf, Xu, Xu, Xu, Xu
Xu, Xu, Ur^Emf, Uu^Uf, Urb^Br/, Urb^Br|, Urb^Dr, Ur, Wwg, Wwg, Xu, Xu, Xu, Xu, Xu, Xu, Xu, Xu, Xu, Xu, Xu, Xu, Xu, Urb, Ur^Dr, Uu^Em, Ur^Es, Urb, Urb, Urb, Urb, Ur, Xu, Ur, Xu, Ur, Urb, Uu, Uu^Vu, Uh, Xu, Wwg, Wwg, Xu, Xu, Xu
Xu, Xu, Urb, Urb^Br/, Urb, Urb, Urb, Urb^Dr, Wwg, Uu, Xu, Xu, Uu^Uf, Xu, Uu, Uu, Uu^Uf, Xu, Urb^Emf, Uu, Ur^Dr, Urb^Emf, Urb^Es, Urb^Es, Uu^Dr, Uu, Uu^Uf, Xu, Ur, Ur^Es, Urb^Em, Ur^Dr, Uu^Es, Ur, Ur, Ur, Uh^Dr, Xu, Cud, Xu, Xu, Xu, Xu, Wwg, Xu, Xu
Uu, Uh, Ur, Uu^Br|, Ur, Uu^Em, Uu, Ur, Wwg, Urb, Ur^Emf, Uu^Uf, Urb, Uu, Urb^Emf, Urb^Es, Uu, Urb^Es, Uu^Vu, Uu, Urb, Urb^Es, Uu^Uf, Ur^Emf, Uu, Xu, Xu, Uh, Xu, Uh, Xu, Uu, Uu^Emf, Uu, Uu^Uf, Uu^Es, Uu, Cud, Cud, Cud, Xu, Xu, Xu, Xu, Xu, Xu
Urb, Urb^Em, Uu, Ur^Br|, Urb, Uu^Vu, 1 Wwg, Wwg, Urb^Es, Ur, Urb, Urb, Uu^Vu, Urb, Ur^Emf, Urb, Ur^Dr, Urb, Uu^Uf, Uu^Uf, Uu, Uu, Xu, Xu, Xu, Xu, Xu, Xu, Xu, Uh, Uh, Uu^Emf, Xu, Xu, Xu, Uu^Emf, Uh, Cud, Xu, 5 Kud, Xu, Xu, Xu, Xu, Xu, Xu
Uh, Urb, Uu^Em, Uu^Br|, Urb^Dr, Wwg^Bw\r, Ur, Ur, Urb^Em, Urb, Ur^Emf, Uu^Uf, Uu, Uu, Uu, Urb, Uu, Ur^Dr, Xu, Xu, Xu, Xu, Xu, Xu, Xu, Xu, Xu, Xu, Xu, Xu, Xu, Xu, Xu, Xu, Xu, Xu, Xu, Xu, Xu, Xu, Xu, Xu, Xu, Xu, Xu, Xu
Uu^Uf, Uu, Urb, Urb^Br|, Urb^Dr, Wwg, Ur, Ur^Em, Uu, Uu, Xu, Xu, Xu, Xu, Xu, Ur^Emf, Xu, Xu, Xu, Xu, Xu, Xu, Xu, Xu, Xu, Xu, Xu, Xu, Xu, Xu, Xu, Xu, Xu, Xu, Xu, Xu, Xu, Xu, Xu, Xu, Xu, Xu, Xu, Xu, Xu, Xu
Uu^Uf, Uu^Uf, Ur, Uu^Br|, Uu, Wwg, Uh, Uu, Uu, Xu, Xu, Xu, Xu, Xu, Xu, Xu, Xu, Xu, Xu, Xu, Xu, Xu, Xu, Xu, Xu, Xu, Xu, Xu, Xu, Xu, Xu, Xu, Xu, Xu, Xu, Xu, Xu, Xu, Xu, Xu, Xu, Xu, Xu, Xu, Xu, Xu
