Dd^Fztd, Dd^Fztd, Dd^Fztd, Dd^Fztd, Rd, Rd, Dd^Fztd, Dd^Fztd, Dd^Fztd, Dd^Fztd, Dd^Fztd, Dd^Vda, Rd, Dd^Fztd, Xos, Xos, Xos, Xos, Xos, Xos, Xos, Xos, Xos, Xos, Xol, Xos, Xos, Xos, Xos, Xos, Xos, Xos, Xos, Xos, Xos, Xos, Dd^Fztd, Dd^Fztd, Rd, Dd^Fztd, Dd^Fztd, Dd^Fts, Dd^Fts, Dd^Fztd, Rd, Dd^Fztd
Dd^Fztd, Dd^Fztd, Dd^Fztd, Dd^Vda, Dd^Fts, Rd, Rd, Dd^Fts, Dd^Fts, Dd^Fztd, Dd^Vda, Dd^Fztd, Rd, Dd^Vda, Xos, Xos, Xos, Xos, Xos, Xos, Xos, Xos, Xol, Xol, Urb, Xol, Urb, Xol, Xol, Xos, Xos, Xos, Xos, Xos, Xos, Xos, Dd^Fztd, Dd^Fztd, Rd, Dd^Fztd, Dd^Vda, Dd^Fts, Rd, Rd, Dd^Fztd, Dd^Fts
Rd, Dd^Vda, Dd^Fztd, Dd^Fztd, Rd, Dd^Fztd, Rd, Rd, Rd, Dd^Fts, Rd, Rd, Dd^Fts, Rd, Xos, Xos, Xos, Xos, Xol, Xol, Urb, Xol, Urb, Urb, Urb, Urb, Urb, Urb, Urb, Xol, Xol, Xos, Xos, Xos, Xos, Dd^Fztd, Dd^Fztd, Dd^Fztd, Dd^Vda, Rd, Rd, Rd, Rd, Dd^Fts, Dd^Fts, Dd^Fts
Dd^Fts, Rd, Rd, Rd, Rd, Rd, Dd^Fztd, Dd^Fts, Rd, Dd^Fztd, Rd, Dd^Fts, Dd^Fztd, Dd^Fztd, Dd^Fztd, Xos, Xos, Xol, Xol, Urb, Urb, Urb, Urb, Urb, Urb, Urb, Urb, Urb, Urb, Urb, Xol, Xos, Xos, Xos, Dd^Fztd, Dd^Fztd, Dd^Vda, Dd^Fts, Rd, Rd, Rd, Rd, Dd^Vda, Dd^Fts, Dd^Fts, Dd^Fts
Dd^Fztd, Dd^Vda, Rd, Rd, Rd, Dd^Fts, Dd^Fztd, Dd^Vda, Rd, Rd, Rd, Rd, Rd, Dd^Vda, Rd, Xos, Xos, Xol, Urb, Urb, Urb, Urb, Urb, Urb, Urb, Urb, Urb, Urb, Urb, Urb, Urb, Xol, Dd^Fztd, Dd^Fztd, Dd^Vda, Dd^Fztd, Rd, Rd, Dd^Fztd, Dd^Fztd, Rd, Rd, Dd^Fts, Dd^Fztd, Dd^Fztd, Dd^Fztd
Dd^Fts, Dd^Fts, Rd, Rd, Dd^Fts, Rd, Rd, Rd, Dd^Vda, Dd^Fztd, Rd, Dd^Fts, Dd^Vda, Rd, Rd, Dd^Vda, Dd^Fztd, Xos, Xos, Urb, Urb, Urb, Urb, Urb, Urb, Urb, Urb, Urb, Urb, Urb, Xos, Xos, Dd^Fztd, Dd^Fztd, Dd^Fts, Rd, Rd, Dd^Vda, Dd^Fztd, Dd^Fztd, Rd, Dd^Vda, Dd^Fts, Dd^Fztd, Dd^Fts, Dd^Fts
Dd^Vda, Rd, Dd^Vda, Dd^Fts, Dd^Fztd, Rd, Rd, Dd^Fztd, Dd^Fts, Dd^Fztd, Rd, Rd, Dd^Fztd, Dd^Fztd, Rd, Dd^Fztd, Dd^Vda, Xos, Xos, Xol, Urb, Urb, Urb, Urb, Urb, Urb, Urb, Urb, Urb, Urb, Xos, Dd^Fztd, Dd^Fztd, Dd^Fts, Rd, Dd^Fts, Rd, Dd^Fztd, Dd^Fts, Dd^Fztd, Rd, Dd^Fztd, Dd^Fts, Dd^Fztd, Dd^Fts, Dd^Fts
Rd, Rd, Rd, Rd, Rd, Rd, Rd, Rd, Rd, Rd, Rd, Rd, Rd, Dd^Vda, Dd^Fztd, Rd, Rd, Dd^Fztd, Dd^Fztd, Xos, Xos, Urb, Urb, Urb, Urb, Urb, Urb, Urb, Xos, Xos, Dd^Fztd, Dd^Fztd, Rd, Rd, Dd^Vda, Rd, Dd^Fztd, Rd, Rd, Dd^Vda, Rd, Rd, Dd^Vda, Dd^Fztd, Dd^Fts, Dd^Fts
Dd^Fztd, Rd, Rd, Dd^Fztd, Dd^Fts, Dd^Fts, Dd^Vda, Rd, Dd^Fztd, Dd^Vda, Dd^Fztd, Dd^Fztd, Dd^Fztd, Rd, Rd, Rd, Dd^Fztd, Dd^Fztd, Dd^Fztd, Dd^Fztd, Dd^Fztd, Xos, Xos, Urb, Urb, Urb, Xos, Xos, Dd^Fztd, Dd^Fts, Dd^Fztd, Dd^Vda, Dd^Fztd, Rd, Rd, Rd, Rd, Rd, Rd, Rd, Dd^Vda, Rd, Rd, Dd^Fts, Dd^Fztd, Dd^Fztd
Dd^Fts, Dd^Fts, Dd^Fztd, Rd, Rd, Dd^Fztd, Dd^Fts, Rd, Rd, Dd^Fztd, Dd^Vda, Dd^Fztd, Dd^Vda, Dd^Fztd, Rd, Dd^Vda, Dd^Fztd, Dd^Fztd, Dd^Fztd, Dd^Fztd, Kd^Xo, Dd^Fztd, Xos, Urb, Urb, Urb, Xol, Dd^Fztd, Kd^Xo, Dd^Fztd, Dd^Fztd, Dd^Fztd, Dd^Vda, Rd, Rd, Dd^Fts, Dd^Vda, Dd^Fztd, Rd, Dd^Fts, Dd^Fts, Dd^Fztd, Rd, Dd^Fts, Dd^Fts, Dd^Fztd
Dd^Fztd, Dd^Fztd, Dd^Vda, Rd, Rd, Dd^Vda, Dd^Fztd, Dd^Fts, Dd^Vda, Rd, Rd, Dd^Fztd, Rd, Rd, Dd^Fztd, Rd, Dd^Fztd, Dd^Fztd, Kd^Xo, Kd^Xo, Kd^Xo, Kd^Xo, Xos, Urb, Xol, Urb, Xol, Kd^Xo, Kd^Xo, Kd^Xo, Kd^Xo, Dd^Fztd, Dd^Fztd, Dd^Fztd, Dd^Fts, Rd, Rd, Rd, Dd^Fts, Rd, Rd, Dd^Vda, Rd, Dd^Fztd, Dd^Fztd, Dd^Fztd
Dd^Fts, Dd^Fztd, Rd, Rd, Rd, Rd, Rd, Dd^Fztd, Dd^Fztd, Rd, Dd^Fztd, Rd, Dd^Vda, Dd^Fztd, Dd^Fztd, Dd^Fztd, Kd^Xo, Kd^Xo, Kd^Xo, Kd^Xo, Re, Re, Rb, Rb, 1 Rb, Rb, Re, Re, Re, Kd^Xo, Kd^Xo, Kd^Xo, Kd^Xo, Dd^Fztd, Rd, Rd, Rd, Dd^Fztd, Dd^Fztd, Dd^Fztd, Dd^Fztd, Rd, Rd, Dd^Vda, Dd^Fztd, Dd^Fztd
Rd, Rd, Dd^Fztd, Dd^Fts, Rd, Dd^Vda, Dd^Fztd, Rd, Rd, Dd^Vda, Rd, Rd, Dd^Fztd, Dd^Fztd, Dd^Fztd, Dd^Fztd, Kd^Xo, Kd^Xo, Re, Re, Re, Rb, Rb, Rb, Rb^Vdt, Rb, Re, Re, Re, Re, Re, Kd^Xo, Kd^Xo, Rd, Dd^Fztd, Dd^Fts, Dd^Vda, Rd, Rd, Dd^Vda, Dd^Fztd, Dd^Vda, Rd, Rd, Dd^Fztd, Dd^Fztd
Dd^Fztd, Dd^Fts, Dd^Fztd, Dd^Vda, Rd, Dd^Fztd, Dd^Fts, Dd^Fztd, Dd^Vda, Rd, Rd, Dd^Fztd, Dd^Fztd, Dd^Fztd, Kd^Xo, Kd^Xo, Kd^Xo, Kd^Xo, Re, Re, Cdr, Rb, Rb, Rb, Re, Re, Re, Re, Cdr, Re, Re, Kd^Xo, Kd^Xo, Kd^Xo, Kd^Xo, Dd^Fztd, Dd^Fztd, Rd, Rd, Dd^Fztd, Dd^Fztd, Rd, Rd, Rd, Dd^Vda, Dd^Fztd
Dd^Fztd, Dd^Fts, Dd^Fztd, Dd^Fztd, Rd, Rd, Rd, Dd^Fztd, Dd^Fztd, Rd, Dd^Fztd, Rd, Rd, Dd^Fztd, Kd^Xo, Kd^Xo, Kd^Xo, Re, Re, Re, Rb, Rb, Rb, Re^Dr, Re^Dr, Re^Dr, Re, Re, Re, Re, Re, Re, Kd^Xo, Kd^Xo, Kd^Xo, Dd^Fztd, Dd^Fztd, Dd^Fztd, Dd^Vda, Rd, Rd, Rd, Dd^Fts, Rd, Dd^Fztd, Dd^Fztd
Rd, Rd, Rd, Dd^Vda, Rd, Rd, Rd, Rd, Rd, Rd, Dd^Fztd, Dd^Fts, Dd^Fztd, Kd^Xo, Kd^Xo, Kd^Xo, Re, Re, Rb^Vdt, Rb, Re^Dr, Rb, Re^Vdt, Re, Re, Re, Rb^Vdt, Re, Rb^Dr, Re, Re^Vdt, Re, Re, Kd^Xo, Kd^Xo, Kd^Xo, Dd^Fztd, Dd^Fztd, Rd, Rd, Dd^Fztd, Dd^Fztd, Dd^Fts, Rd, Dd^Vda, Dd^Fztd
Dd^Fztd, Dd^Fts, Dd^Fztd, Rd, Rd, Dd^Fztd, Dd^Fztd, Dd^Vda, Rd, Dd^Vda, Dd^Fztd, Dd^Fztd, Kd^Xo, Kd^Xo, Kd^Xo, Kd^Xo, Re, Re, Re, Re, Re^Dr, Re, Re, Re, Re, Re, Rb, Rb, Rb^Dr, Rb, Re, Re, Re, Kd^Xo, Kd^Xo, Kd^Xo, Kd^Xo, Rd, Dd^Fztd, Rd, Dd^Vda, Dd^Fztd, Dd^Vda, Rd, Dd^Fts, Dd^Fztd
Dd^Fztd, Dd^Fts, Dd^Vda, Dd^Fztd, Rd, Dd^Fts, Dd^Fztd, Dd^Fztd, Rd, Dd^Fztd, Dd^Fts, Dd^Fztd, Kd^Xo, Kd^Xo, Kd^Xo, Re, Re, Re, Re, Re^Dr, Re, Re, Re, Re, Re, Rb, Rb, Rb, Rb, Re^Dr, Re, Re, Re, Re, Kd^Xo, Kd^Xo, Kd^Xo, Dd^Fztd, Dd^Vda, Rd, Dd^Fztd, Dd^Fztd, Rd, Rd, Dd^Fztd, Dd^Fztd
Dd^Fztd, Dd^Fztd, Dd^Fztd, Dd^Fts, Rd, Dd^Vda, Dd^Fztd, Dd^Vda, Rd, Dd^Fztd, Dd^Fztd, Dd^Fztd, Kd^Xo, 3 Kd^Xo, Kd^Xo, Re, Re, Re, Cdr, Re, Re^Vdt, Re, Re, Re, Re, Re, Re, Rb, Rb^Vdt, Re, Cdr, Re, Re, Re, Kd^Xo, Kd^Xo, Kd^Xo, Dd^Fztd, Dd^Fztd, Rd, Dd^Vda, Dd^Fztd, Rd, Dd^Vda, Dd^Fts, Dd^Fztd
Rd, Dd^Fztd, Rd, Dd^Fztd, Rd, Rd, Rd, Dd^Fztd, Rd, Dd^Vda, Dd^Fztd, Dd^Fztd, Kd^Xo, Kd^Xo, Kd^Xo, Re, Re, Re, Re, Re, Re, Re, Re, Re, Re, Re, Re, Re, Re, Re, Re, Re, Re, Re, Kd^Xo, Kd^Xo, Kd^Xo, Dd^Fztd, Dd^Fts, Rd, Dd^Fztd, Dd^Fztd, Rd, Dd^Fts, Dd^Fztd, Dd^Fztd
Dd^Fztd, Rd, Dd^Fztd, Rd, Rd, Rd, Dd^Fts, Rd, Rd, Dd^Fztd, Dd^Fts, Dd^Fztd, Kd^Xo, Kd^Xo, Kd^Xo, Re, Re, Re, Re, Re^Dr, Re^Dr, Re, Re, Re, Re, Re, Re, Re, Re^Dr, Re^Dr, Re, Re, Re, Re, Kd^Xo, Kd^Xo, Kd^Xo, Dd^Fztd, Dd^Fztd, Rd, Rd, Rd, Rd, Dd^Vda, Dd^Fts, Dd^Fztd
Dd^Fztd, Dd^Fts, Dd^Fts, Dd^Vda, Rd, Dd^Fztd, Dd^Fztd, Dd^Vda, Rd, Rd, Rd, Rd, Dd^Fztd, Kd^Xo, Kd^Xo, Kd^Xo, Re, Re, Re^Vdt, Re, Re^Dr, Re, Re^Vdt, Re, Re, Re, Re^Vdt, Re, Re^Dr, Re, Re^Vdt, Re, Re, Kd^Xo, Kd^Xo, Kd^Xo, Dd^Fts, Rd, Rd, Rd, Dd^Vda, Dd^Fztd, Dd^Fztd, Rd, Dd^Fztd, Dd^Fts
Dd^Fts, Dd^Fztd, Dd^Fts, Dd^Fztd, Rd, Dd^Vda, Rd, Rd, Dd^Vda, Rd, Dd^Vda, Dd^Fztd, Dd^Fztd, Kd^Xo, Kd^Xo, Kd^Xo, Kd^Xo, Re, Re, Re, Re, Re, Re, Re, Re^Dr, Re, Rb, Re, Re, Re, Re, Re, Kd^Xo, Kd^Xo, Kd^Xo, Kd^Xo, Dd^Fztd, Dd^Fztd, Dd^Vda, Rd, Rd, Dd^Fztd, Dd^Fts, Rd, Dd^Fts, Dd^Fztd
Dd^Fztd, Dd^Fts, Rd, Rd, Rd, Rd, Dd^Vda, Dd^Fts, Dd^Fztd, Rd, Rd, Dd^Fztd, Dd^Fztd, Dd^Fztd, Kd^Xo, Kd^Xo, Kd^Xo, Re, Re, Re, Cdr, Re, Re, Re^Dr, Rb, Rb^Dr, Rb, Re, Cdr, Re, Re, Re, Kd^Xo, Kd^Xo, Kd^Xo, Dd^Fztd, Dd^Vda, Dd^Fts, Rd, Rd, Dd^Fztd, Rd, Rd, Rd, Dd^Fztd, Dd^Fztd
Rd, Rd, Rd, Dd^Fztd, Dd^Vda, Rd, Dd^Fztd, Dd^Fztd, Dd^Fztd, Dd^Vda, Rd, Dd^Fztd, Dd^Fztd, Dd^Fztd, Dd^Fztd, Kd^Xo, Kd^Xo, Kd^Xo, Re, Re, Re, Re, Re, Rb, Rb^Vdt, Rb, Rb, Rb, Re, Re, Re, Kd^Xo, Kd^Xo, Kd^Xo, Dd^Fztd, Dd^Fts, Dd^Fts, Rd, Rd, Dd^Vda, Dd^Fztd, Rd, Rd, Dd^Vda, Dd^Fztd, Dd^Fztd
Rd, Rd, Rd, Dd^Fztd, Dd^Fts, Rd, Rd, Dd^Vda, Dd^Fztd, Dd^Fztd, Rd, Dd^Vda, Dd^Fztd, Dd^Fts, Rd, Kd^Xo, Kd^Xo, Kd^Xo, Kd^Xo, Re, Re, Re, Rb, Rb, Rb, Rb, Rb, Re, Re, Re, Kd^Xo, Kd^Xo, Kd^Xo, Kd^Xo, Rd, Dd^Vda, Rd, Rd, Dd^Vda, Dd^Fztd, Dd^Fztd, Dd^Fts, Rd, Dd^Fts, Dd^Fztd, Dd^Fts
Dd^Fztd, Dd^Vda, Rd, Dd^Vda, Dd^Fztd, Dd^Fztd, Dd^Fztd, Rd, Rd, Dd^Fts, Dd^Vda, Rd, Rd, Rd, Dd^Fztd, Dd^Fztd, Dd^Fztd, Kd^Xo, Kd^Xo, Kd^Xo, Kd^Xo, Re, Xol, Rb, Xos, Rb, Xos, Re, Kd^Xo, Kd^Xo, Kd^Xo, Kd^Xo, Dd^Fztd, Dd^Fztd, Dd^Fts, Rd, Rd, Dd^Fztd, Dd^Fztd, Dd^Fts, Rd, Rd, Rd, Dd^Fts, Dd^Fztd, Gs^Ftp
Dd^Fztd, Dd^Fztd, Rd, Dd^Fztd, Dd^Vda, Dd^Fts, Dd^Fztd, Dd^Fztd, Dd^Vda, Rd, Rd, Rd, Rd, Dd^Fztd, Dd^Fztd, Dd^Fztd, Dd^Fztd, Dd^Fztd, Dd^Fztd, Kd^Xo, Kd^Xo, Kd^Xo, Xol, Urb, Urb, Urb, Xos, Kd^Xo, Kd^Xo, Kd^Xo, Dd^Fts, Dd^Fztd, Dd^Fztd, Dd^Fts, Rd, Rd, Dd^Vda, Rd, Rd, Rd, Dd^Vda, Dd^Fts, Rd, Dd^Vda, Dd^Fztd, Dd^Fztd
Rd, Rd, Rd, Rd, Dd^Fztd, Dd^Fts, Dd^Vda, Dd^Fztd, Rd, Rd, Dd^Vda, Dd^Fztd, Dd^Vda, Rd, Rd, Dd^Vda, Dd^Fztd, Dd^Fztd, Dd^Fztd, Dd^Fztd, Dd^Fztd, Kd^Xo, Xol, Urb, Urb, Urb, Xol, Kd^Xo, Dd^Fztd, Dd^Fztd, Dd^Fztd, Dd^Fts, Dd^Fztd, Dd^Vda, Rd, Dd^Fztd, Dd^Fztd, Dd^Fts, Dd^Fts, Rd, Dd^Fts, Dd^Fts, Rd, Dd^Fts, Dd^Fts, Dd^Fztd
Rd, Rd, Dd^Vda, Rd, Rd, Dd^Fts, Rd, Rd, Rd, Dd^Fztd, Dd^Fztd, Dd^Fts, Dd^Fztd, Dd^Fztd, Rd, Rd, Dd^Fztd, Dd^Fts, Dd^Fztd, Dd^Fztd, Xol, Xol, Urb, Urb, Urb, Urb, Urb, Xol, Xol, Dd^Fts, Dd^Fts, Dd^Fts, Dd^Fts, Rd, Rd, Dd^Fztd, Rd, Dd^Fts, Rd, Dd^Fztd, Rd, Rd, Dd^Vda, Dd^Fts, Dd^Fts, Dd^Fztd
Dd^Fztd, Dd^Fztd, Dd^Fts, Dd^Fztd, Dd^Vda, Rd, Rd, Dd^Vda, Dd^Fts, Rd, Rd, Dd^Vda, Dd^Fztd, Dd^Vda, Rd, Dd^Vda, Dd^Fztd, Dd^Fztd, Xol, Xol, Urb, Urb, Urb, Urb, Urb, Urb, Urb, Urb, Urb, Xol, Dd^Fztd, Dd^Fts, Dd^Fts, Dd^Vda, Rd, Rd, Dd^Vda, Rd, Dd^Fts, Rd, Dd^Fts, Dd^Fztd, Dd^Fztd, Dd^Fztd, Dd^Fts, Dd^Fztd
Rd, Dd^Fts, Dd^Fts, Dd^Fts, Rd, Rd, Rd, Dd^Fztd, Dd^Fztd, Dd^Fztd, Dd^Vda, Rd, Rd, Rd, Dd^Vda, Dd^Fztd, Dd^Fztd, Xol, Xol, Urb, Urb, Urb, Urb, Urb, Urb, Urb, Urb, Urb, Urb, Xol, Xol, Dd^Fztd, Rd, Rd, Dd^Vda, Rd, Dd^Fts, Dd^Fts, Dd^Fztd, Dd^Vda, Dd^Fts, Dd^Fztd, Dd^Fts, Dd^Fztd, Dd^Fts, Dd^Fztd
Rd, Dd^Vda, Rd, Rd, Rd, Dd^Vda, Dd^Fztd, Rd, Rd, Rd, Rd, Rd, Rd, Dd^Fztd, Dd^Fts, Dd^Fztd, Dd^Fztd, Xol, Xol, Urb, Urb, Urb, Urb, Urb, Urb, Urb, Urb, Urb, Urb, Xol, Xol, Dd^Fztd, Rd, Rd, Dd^Fztd, Rd, Rd, Dd^Fztd, Dd^Fts, Dd^Fts, Dd^Fztd, Dd^Fts, Dd^Fts, Dd^Fztd, Dd^Fts, Dd^Fts
Dd^Fztd, Rd, Dd^Vda, Rd, Rd, Dd^Fztd, Dd^Fts, Dd^Vda, Rd, Dd^Vda, Dd^Fztd, Dd^Fztd, Rd, Rd, Dd^Fts, Dd^Fztd, Dd^Fztd, Xol, Xol, Xol, Xol, Urb, Urb, Urb, Urb, Urb, Urb, Urb, Xol, Xol, Xol, Dd^Vda, Rd, Rd, Rd, Rd, Rd, Dd^Vda, Dd^Fts, Dd^Fztd, Dd^Fztd, Dd^Fztd, Dd^Fts, Dd^Fts, Dd^Fts, Dd^Fts
Dd^Fztd, Dd^Fts, Dd^Fts, Rd, Dd^Fts, Dd^Fztd, Dd^Fztd, Dd^Vda, Rd, Dd^Fztd, Dd^Fztd, Dd^Vda, Dd^Fztd, Rd, Dd^Fztd, Dd^Vda, Dd^Fztd, Xol, Xol, Xol, Xol, Xol, Xol, Xol, Xol, Xol, Xol, Xol, Xol, Xol, Xol, Rd, Rd, Dd^Vda, Dd^Fztd, Dd^Fts, Dd^Fts, Rd, Rd, Dd^Fztd, Dd^Fztd, Dd^Fts, Dd^Fztd, Dd^Fts, Dd^Fts, Dd^Fts
