border_size=1
usage=map

Md          , Md          , Zwsl        , Zwsl        , Zwsl        , Zwsl        , Zwsl        , Zwsl        , Zwsl        , Zwsl        , Uu          , Uu          , Zwsl        , Zwsl        , Zwsl        , Zwsl        , Uu          , Zwsl        , Uu^Dr       , Zwsl        , Zvw         , Zwsl        , Zvw         , Zvw         , Qlf         , Qlf         , Qlf         
Md          , Zwsl        , Uh^Vzps     , Zwsl        , Uu^Dr       , Uu          , Uu          , Zwsl        , Uu          , Zwsl        , Zwsl        , Uu^Dr       , Uu          , Zwsl        , Uh^Vzps     , Uu          , Zwsl        , Zvw         , Zvw         , Zvw         , Zvw         , Zvw         , Qlf         , Qlf         , Qlf         , Qlf         , Zvw         
Uu          , Zwsl        , Uh          , Uh          , Uu          , Zwsl        , Uh          , Zwsl        , Zwsl        , Uh          , Uh^Vzps     , Uh          , Zvw         , Uh          , Uh          , Uh          , Zvw         , Zvw         , Qlf         , Zvw         , Qlf^Bs\     , Qlf         , Qlf         , Qlf         , Qlf         , Zvw         , Zvw         
Md          , Uu          , Uu          , Uu          , Uu          , Zwsl^Vzps   , Zwsl        , Uu          , Uu          , Zvw         , Uh          , Zvw         , Zvw         , Zvw         , Zvw         , Zvw         , Qlf^Bs\     , Qlf         , Qlf         , Qlf         , Chr         , Zvw         , Zvw         , Qlf         , Qlf         , Zvw         , Zvw         
Md          , Uu          , Zwsl        , Uu          , Zwsl        , Uh          , Zwsl        , Uu^Dr       , Zvw         , Zvw         , Qlf         , Qlf         , Qlf         , Zvw         , Zvw         , Zvw         , Qlf         , Zvw         , Zvw         , Chr         , Chr         , Zvw^Vzps    , Zvw         , Qlf         , Qlf         , Zvw         , Zvw         
Md          , Md          , Zwsl        , Zwsl        , Zvw         , Zvw         , Zvw         , Zvw         , Zvw         , Zvw         , Qlf         , Zvw         , Zvw         , Qlf         , Qlf         , Qlf^Bs\     , Zvw         , Chr         , Chr         , Chr^Dr      , Chr^Dr      , Chr^Dr      , Zvw         , Qlf         , Qlf         , Zvw         , Zvw         
Md^Xm       , Md          , Zwsl        , Zvw         , Qlf         , Qlf         , Qlf         , Zvw         , Qlf         , Zvw         , Qlf^Bs\     , Zvw         , Zvw         , Zvw         , Zvw         , Qlf         , Zvw         , Zvw         , Zvw         , 2 Khr       , Chr         , Chr         , Qlf         , Qlf^Bs\     , Zvw         , Zvw         , Zwsl^Dr     
Md^Xm       , Md          , Md          , Md          , Mv          , Md          , Zvw         , Qlf         , Zvw         , Qlf         , Zvw         , Zvw         , Uh          , Zvw         , Zvw         , Qlf^Bs/     , Zvw         , Zvw^Vzps    , Zvw         , Chr         , Zvw         , Chr^Dr      , Qlf         , Qlf         , Zvw         , Zvw         , Uu          
Md^Xm       , Md          , Md          , Md          , Md          , Md          , Zvw         , Zvw         , Zvw         , Zvw         , Zvw         , Zvw         , Uh^Vzps     , Zvw         , Zvw         , Qlf         , Qlf         , Zvw         , Qlf         , Zvw         , Zvw         , Zvw         , Qlf         , Zvw         , Zvw         , Zwsl        , Zwsl        
Md^Xm       , Md^Xm       , Md          , Md          , Zwsl        , Zwsl        , Zwsl^Dr     , Zvw         , Uu          , Uu          , Uu          , Zwsl        , Zwsl        , Zvw         , Zvw         , Zvw         , Zvw         , Qlf         , Zvw         , Qlf^Bs/     , Qlf         , Qlf         , Zvw         , Zvw         , Zvw         , Uu          , Zwsl        
Md^Xm       , Md          , Uh          , Zwsl        , Uh          , Zwsl        , Zwsl        , Zwsl        , Uu          , Uh          , Uu          , Uu          , Zwsl        , Uu          , Uu          , Zvw         , Zvw         , Zvw         , Zvw         , Zvw         , Zvw         , Zvw         , Zvw         , Zvw         , Uh          , Zwsl        , Zwsl        
Md^Xm       , Md          , Uh          , Uh          , Uh^Vzps     , Uh          , Uh          , Zwsl        , Uu          , Uh^Vzps     , Uh^Dr       , Uu          , Zwsl        , Zwsl        , Uh          , Uu          , Zwsl        , Zvw         , Zwsl        , Zvw         , Zwsl        , Zvw         , Uh          , Uh^Dr       , Uh          , Zwsl        , Uu          
Md^Xm       , Md          , Md          , Uh          , Uh          , Zwsl        , Uu          , Zwsl        , Zwsl        , Uh          , Zwsl        , Zwsl        , Zwsl        , Uh          , Uh          , Uu          , Zwsl        , Zwsl        , Zwsl        , Zwsl        , Zwsl        , Uh          , Zwsl        , Zwsl        , Zwsl^Vzps   , Uh          , Uu          
Md^Xm       , Md          , Md          , Zwsl        , Zwsl        , Zwsl        , Zwsl        , Zwsl        , Uh          , Zwsl        , Zwsl        , Uu          , Zwsl        , Zwsl        , Zwsl        , Uh          , Uh^Vzps     , Uh          , Zwsl        , Zwsl        , Uu          , Md          , Uu          , Uu          , Uh          , Uh          , Zwsl        
Md^Xm       , Md^Xm       , Md^Xm       , Md          , Md          , Zwsl        , Zwsl        , Uh          , Uu          , Zwsl        , Uh          , Md          , Zwsl        , Uu          , Zwsl        , Zwsl        , Uh          , Uh          , Zwsl        , Zwsl        , Uh          , Md          , Md          , Uu          , Uu          , Zwsl        , Zwsl        
Md^Xm       , Md^Xm       , Md^Xm       , Md^Xm       , Md          , Zwsl        , Zwsl        , Zwsl^Vzps   , Uu          , Zwsl        , Zwsl        , Md          , Md          , Uu          , Zwsl        , Zwsl        , Zwsl        , Zwsl        , Uu          , Zwsl        , Uh          , Md          , Md          , Md          , Zwsl        , Zwsl        , Md          
Md^Xm       , Md^Xm       , Md          , Md          , Chr         , Zwsl        , Zwsl        , Zwsl        , Zwsl        , Zwsl        , Md          , Md          , Md^Xm       , Md          , Zwsl        , Uh          , Zwsl        , Uu          , Zwsl        , Zwsl^Dr     , Zwsl        , Md          , Md          , Md          , Md          , Zwsl        , Md          
Md          , Md          , Zwsl        , Chr         , 1 Khr       , Chr         , Md          , Zwsl        , Zwsl        , Md          , Md          , Md          , Md^Xm       , Md          , Md          , Zwsl        , Zwsl        , Zwsl        , Zwsl        , Zwsl        , Zwsl        , Zwsl        , Md          , Md          , Md          , Md          , Md^Xm       
Zwsl        , Zwsl        , Md          , Chr         , Chr         , Chr         , Md^Xm       , Md          , Md          , Md          , Md^Xm       , Md^Xm       , Md^Xm       , Md^Xm       , Md          , Md          , Md          , Zwsl        , Md          , Zwsl        , Zwsl        , Zwsl        , Md          , Md          , Md^Xm       , Md^Xm       , Md^Xm       
Md          , Md          , Md          , Md          , Md^Xm       , Md^Xm       , Md^Xm       , Md^Xm       , Md^Xm       , Md^Xm       , Md^Xm       , Md^Xm       , Md^Xm       , Md^Xm       , Md^Xm       , Md          , Md          , Md          , Md          , Md          , Md          , Md          , Md          , Md          , Md^Xm       , Md^Xm       , Md^Xm       
