border_size=1
usage=map

Xu          , Xu          , Xu          , Xu          , Xu          , Xu          , Xu          , Xu          , Xu          , Xu          , Xu          , Xu          , Xu          , Xu          , Xu          , Xu          , Xu          , Xu          , Xu          , Ww          , Uu          , Ur          , Uu          , Uu^Uf       , Xu          , Xu          , Xu          , Xu          , Xu          , Xu          , Xu          , Xu          , Xu          , Xu          , Xu          , Xu          , Xu          , Xu          , Xu          , Xu          , Xu          , Xu          , Xu          , Xu          , Xu          , Xu          
Xu          , Xu          , Xu          , Xu          , Xu          , Xu          , Xu          , Xu          , Xu          , Xu          , Xu          , Xu          , Xu          , Xu          , Xu          , Xu          , Xu          , Xu          , Xu          , Xu          , Uu          , Ur          , Uu          , Uu^Uf       , Xu          , Xu          , Xu          , Xu          , Xu          , Xu          , Xu          , Xu          , Xu          , Xu          , Xu          , Xu          , Xu          , Xu          , Xu          , Xu          , Xu          , Xu          , Xu          , Xu          , Xu          , Xu          
Xu          , Xu          , Xu          , Xu          , Xu          , Xu          , Uh          , Xu          , Uh          , Xu          , Xu          , Xu          , Xu          , Xu          , Xu          , Xu          , Xu          , Xu          , Xu          , Xu          , Uu          , Ur          , Uu          , Xu          , Xu          , Xu          , Xu          , Xu          , Xu          , Xu          , Xu          , Xu          , Qxu         , Qxu         , Qxu         , Xu          , Xu          , Xu          , Xu          , Xu          , Xu          , Xu          , Xu          , Xu          , Xu          , Xu          
Xu          , Xu          , Xu          , Xu          , Uh^Dr       , Uh          , Uh^Dr       , Uh          , Cud         , Uh^Dr       , Uh          , Xu          , Xu          , Xu          , Xu          , Xu          , Xu          , Xu          , Xu          , Xu          , Uu^Uf       , Ur          , Uu          , Xu          , Xu          , Xu          , Xu          , Xu          , Xu          , Xu          , Xu          , Xu          , Qxu         , Qxu         , Uu^Uf       , Uh          , Uh          , Ww          , Ww          , Xu          , Xu          , Xu          , 2 Kud       , Qxu         , Qxu         , Xu          
Xu          , Xu          , Xu          , Xu          , Uh          , Uh          , Uh          , Uh          , Cud         , 3 Kud       , Cud         , Uh          , Uh          , Xu          , Uh^Dr       , Ww          , Ww          , Xu          , Xu          , Uu^Uf       , Uu^Uf       , Ur          , Uu          , Uh          , Uh          , Xu          , Xu          , Xu          , Xu          , Xu          , Xu          , Xu          , Ur          , Uu          , Ur          , Uu^Uf       , Uu^Uf       , Uh^Dr       , Xu          , Xu          , Xu          , Cud         , Cud         , Qxu         , Xu          , Xu          
Xu          , Xu          , Xu          , Xu          , Xu          , Uh          , Uu          , Uu          , Uu          , Uu          , Ur          , Cud         , Uh          , Uh^Dr       , Uu^Vu       , Ww          , Ww          , Xu          , Uh^Dr       , Uu^Uf       , Uu          , Ur          , Uu          , Uh          , Uh          , Uh          , Uh          , Xu          , Uu^Uf       , Xu          , Uu          , Ur          , Xu          , Uu          , Uh          , Ur          , Uu          , Uu          , Uu          , Xu          , Uu^Uf       , Cud         , Cud         , Xu          , Xu          , Xu          
Xu          , Xu          , Xu          , Xu          , Xu          , Xu          , Xu          , Uu^Uf       , Uu          , Ur          , Uu          , Uu          , Ur          , Uu          , Uu          , Uu          , Uh          , Uh          , Uh          , Uu          , Uu          , Ur          , Uu^Cov      , Uu^Cov      , Uu^Cov      , Uh^Dr       , Uu          , Uu^Vu       , Ur          , Ur          , Xu          , Xu          , Xu          , Ww          , Xu          , Uh          , Uh^Dr       , Ur          , Ur          , Uu          , Uu^Uf       , Uu^Dr       , Cud         , Cud         , Xu          , Xu          
Xu          , Xu          , Xu          , Xu          , Xu          , Xu          , Uu^Uf       , Uu^Uf       , Ur          , Uu          , Uu          , Uu          , Uu^Uf       , Ur          , Uu^Uf       , Ur          , Ur          , Ur          , Uu          , Uu^Dr       , Ur          , Ur          , Ur          , 6 Uu^Kov    , Uu^Cov      , Uu          , Uu          , Ur          , Xu          , Xu          , Xu          , Xu          , Xu          , Wo          , Wo          , Xu          , Xu          , Uh          , Uu^Vu       , Uu          , Uu^Uf       , Uu^Uf       , Xu          , Xu          , Xu          , Xu          
Xu          , Xu          , Xu          , Xu          , Xu          , Xu          , Uu^Uf       , Uu^Uf       , Ur          , Uu^Dr       , Uu          , Uu^Uf       , Uu^Uf       , Uu^Uf       , Xu          , Xu          , Xu          , Uu^Uf       , Uu^Uf       , Ur          , Uu          , Uu          , Ur          , Uu^Cov      , Ur          , Ur          , Uu^Uf       , Uu^Uf       , Xu          , Xu          , Xu          , Xu          , Xu          , Xu          , Wo          , Xu          , Xu          , Xu          , Xu          , Ur          , Ur          , Uu^Uf       , Xu          , Xu          , Xu          , Xu          
Xu          , Qxu         , Qxu         , Xu          , Uh^Dr       , Xu          , Uh          , Uu          , Ur          , Uu          , Uh          , Uu^Uf       , Uh          , Xu          , Xu          , Xu          , Xu          , Xu          , Uu^Uf       , Uu^Uf       , Uu^Vu       , Uu          , Ur          , Ur          , Ur          , Uu          , Uu^Uf       , Uu^Uf       , Uu^Uf       , Xu          , Xu          , Xu          , Xu          , Xu          , Xu          , Wo          , Xu          , Xu          , Xu          , Uh          , Ur          , Uh          , Xu          , Xu          , Xu          , Xu          
Xu          , Qxu         , Uh          , Uh          , Uh          , Uh          , Uu^Vu       , Uu^Dr       , Ur          , Uu          , Uh          , Uh          , Uh^Dr       , Xu          , Uh          , Xu          , Uh^Dr       , Uh          , Uu^Uf       , Uu^Uf       , Uu^Uf       , Uu          , Ur          , Uu          , Ur          , Uu          , Uu          , Uu^Uf       , Uu^Uf       , Uh          , Uh^Dr       , Uh          , Xu          , Xu          , Xu          , Ww          , Xu          , Xu          , Uh          , Uh^Dr       , Uu          , Uh          , Xu          , Xu          , Xu          , Xu          
Xu          , Xu          , Xu          , Uh          , Uh          , Uu          , Uu          , Uu          , Ur          , Uu          , Uh          , Uh          , Uh          , Uh          , Uh^Dr       , Uh          , Uh          , Uh          , Uu^Uf       , Uu^Uf       , Ur          , Uu          , Uu          , Uu          , Uu          , Ur          , Uu          , Uu          , Uu          , Uh          , Uh          , Uh          , Xu          , Xu          , Qxu         , Qxu         , Qxu         , Xu          , Xu          , Uh          , Ur          , Uu          , Xu          , Xu          , Xu          , Xu          
Xu          , Ww          , Ww          , Uh^Dr       , Uu          , Uu          , Uu          , Uu          , Uu          , Ur          , Uu^Uf       , Qxu         , Qxu         , Xu          , Xu          , Xu          , Uh          , Uu^Uf       , Uu          , Uu^Uf       , Ur          , Uu^Uf       , Uu^Uf       , Uu^Uf       , Uu          , Ur          , Uu          , Uu          , Uu          , Uh^Dr       , Uh          , Xu          , Xu          , Qxu         , Qxu^Bs/     , Uu^Vu       , Qxu         , Xu          , Xu          , Uu          , Ur          , Uu          , Uh^Dr       , Xu          , Xu          , Xu          
Xu          , Ww          , Ww          , Ww          , Uu^Uf       , Uu^Uf       , Uu^Uf       , Uu^Uf       , Uu^Uf       , Ur          , Uu^Uf       , Uu^Uf       , Uu^Uf       , Xu          , Xu          , Xu          , Uu          , Uu          , Uu          , Ur          , Uu^Uf       , Uu^Uf       , Xu          , Uu^Uf       , Uu          , Ur          , Uu          , Uu          , Uu^Vu       , Uh          , Xu          , Xu          , Qxu         , Uu^Vu       , Qxu         , Qxu         , Qxu         , Uh          , Uh          , Uu          , Ur          , Uu          , Uu^Vu       , Xu          , Xu          , Xu          
Xu          , Xu          , Ww          , Ww          , Xu          , Uu^Uf       , Xu          , Uu^Uf       , Xu          , Ur          , Uu          , Ur          , Ur          , Uu          , Ur          , Ur          , Ur          , Uu          , Ur          , Uu          , Xu          , Xu          , Xu          , Xu          , Uu          , Ur          , Uu          , Uu          , Xu          , Xu          , Xu          , Xu          , Qxu         , Qxu         , Qxu         , Qxu         , Xu          , Uh          , Uu          , Uu          , Uu          , Uu^Uf       , Uh^Dr       , Xu          , Xu          , Xu          
Xu          , Xu          , Xu          , Xu          , Xu          , Xu          , Xu          , Xu          , Xu          , Xu          , Uh^Dr       , Uu^Dr       , Uu          , Uu^Uf       , Uu^Uf       , Uu^Uf       , Uu^Uf       , Ur          , Uu^Vu       , Xu          , Xu          , Xu          , Xu          , Xu          , Uu          , Ur          , Uu          , Uu          , Uu^Uf       , Xu          , Qxu         , Qxu         , Qxu         , Qxu         , Xu          , Xu          , Uu^Dr       , Uu^Dr       , Ur          , Ur          , Uu^Uf       , Uu^Uf       , Xu          , Xu          , Xu          , Xu          
Xu          , Xu          , Xu          , Xu          , Xu          , Xu          , Xu          , Xu          , Xu          , Uh          , Uh          , Uu          , Uu          , Xu          , Xu          , Uu^Uf       , Uu^Uf       , Uu          , Xu          , Xu          , Ww          , Ww          , Uu^Uf       , Uu^Uf       , Uu          , Ur          , Uu          , Uu          , Uu^Uf       , Uu^Uf       , Qxu         , Qxu         , Qxu         , Xu          , Xu          , Uh^Dr       , Uh^Dr       , Ur          , Xu          , Xu          , Uu^Uf       , Uu^Uf       , Uh          , Xu          , Xu          , Xu          
Xu          , Xu          , Xu          , Xu          , Xu          , Xu          , Xu          , Xu          , Xu          , Uh          , Uh^Dr       , Uu^Uf       , Uu^Uf       , Xu          , Xu          , Xu          , Uu          , Ur          , Xu          , Xu          , Ww          , Uu^Uf       , Uu^Uf       , Uu^Uf       , Uu          , Ur          , Uu          , Uu          , Uu          , Uu^Uf       , Uu^Uf       , Qxu         , Qxu         , Xu          , Uh          , Uh^Dr       , Uu          , Uu          , Xu          , Xu          , Uu^Uf       , Uu^Uf       , Ww          , Xu          , Xu          , Xu          
Xu          , Xu          , Xu          , Xu          , Xu          , Xu          , Xu          , Xu          , Xu          , Xu          , Uh          , Uh          , Uu^Uf       , Uu^Uf       , Uu          , Uu          , Uu          , Ur          , Xu          , Xu          , Xu          , Uu^Uf       , Uu^Uf       , Uu^Uf       , Uu          , 1 Ur        , Ur          , Uu          , Uu          , Uu^Uf       , Uu^Uf       , Qxu         , Xu          , Xu          , Xu          , Uh          , Uu          , Ur          , Uu          , Xu          , Ww          , Uu^Uf       , Ww          , Xu          , Xu          , Xu          
Xu          , Xu          , Xu          , Xu          , Xu          , Xu          , Xu          , Xu          , Xu          , Xu          , Xu          , Uh          , Uu^Uf       , Uu^Uf       , Uu          , Ur          , Uu          , Uu          , Xu          , Xu          , Xu          , Uu^Uf       , Uu^Uf       , Uu^Uf       , Uu          , Uu          , Uu          , Ur          , Uu^Vu       , Uu          , Uu^Uf       , Xu          , Xu          , Ww          , Ww          , Uh          , Uh          , Ur          , Uu          , Uu          , Uu^Vu       , Ww          , Ww          , Xu          , Xu          , Xu          
Xu          , Xu          , Xu          , Xu          , Xu          , Xu          , Xu          , Xu          , Xu          , Xu          , Xu          , Xu          , Xu          , Uu^Uf       , Uu          , Ur          , Uu          , Uu          , Xu          , Xu          , Xu          , Xu          , Uu          , Uu          , Uu          , Uu^Uf       , Uu          , Ur          , Ur          , Uu          , Uu          , Xu          , Uu^Uf       , Ww          , Ww          , Xu          , Uu          , Ur          , Uu^Dr       , Uu          , Ww          , Uh^Dr       , Xu          , Xu          , Xu          , Xu          
Xu          , Xu          , Xu          , Xu          , Xu          , Xu          , Xu          , Xu          , Xu          , Xu          , Xu          , Xu          , Xu          , Uu^Uf       , Uu          , Ur          , Uu          , Uu          , Qxu         , Xu          , Xu          , Xu          , Uu          , Uu          , Uu^Uf       , Uu^Uf       , Uu^Uf       , Uu          , Uu          , Ur          , Ur          , Uu          , Uu          , Uu^Uf       , Uu          , Xu          , Ur          , Uu          , Uu          , Uu          , Uh^Dr       , Xu          , Xu          , Xu          , Xu          , Xu          
Xu          , Xu          , Xu          , Xu          , Ww          , Ww          , Ww          , Xu          , Uh^Dr       , Xu          , Ww          , Ww          , Uh          , Uh          , Uu          , Uu          , Uu          , Uu^Vu       , Qxu         , Qxu         , Uu          , Uu          , Uu          , Xu          , Xu          , Ww          , Xu          , Xu          , Xu          , Uu          , Uu          , Ur          , Uu          , Uu          , Uu^Dr       , Ur          , Uu          , Uu          , Uu^Uf       , Uh          , Uh^Dr       , Xu          , Xu          , Xu          , Xu          , Xu          
Xu          , Xu          , Xu          , Xu          , Ww          , Ww          , Uu^Uf       , Uu^Uf       , Uu          , Uu^Vu       , Uh          , Uu          , Uh          , Uh^Dr       , Uu          , Ur          , Uu^Dr       , Uu          , Uu          , Uu          , Uu          , Uu          , Xu          , Xu          , Xu          , Xu          , Xu          , Xu          , Xu          , Uu^Uf       , Uu^Uf       , Ur          , Ur          , Ur          , Ur          , Uu          , Xu          , Xu          , Xu          , Uu^Uf       , Uu^Uf       , Ww          , Uh^Dr       , Xu          , Xu          , Xu          
Xu          , Xu          , Xu          , Xu          , Uh          , Uu^Uf       , Uu^Uf       , Uu          , Xu          , Xu          , Xu          , Xu          , Xu          , Xu          , Uu^Uf       , Ur          , Ur          , Uu          , Uu          , Uu          , Uu          , Xu          , Uh          , Xu          , Xu          , Xu          , Xu          , Xu          , Xu          , Uu^Uf       , Uu^Uf       , Uu          , Ur          , Uu          , Uu          , Qxu         , Xu          , Xu          , Xu          , Xu          , 5 Kud       , Uu^Uf       , Xu          , Xu          , Xu          , Xu          
Xu          , Xu          , Xu          , Uh^Dr       , Uh          , Uu^Uf       , Uu^Uf       , Xu          , Xu          , Xu          , Xu          , Xu          , Xu          , Xu          , Uu^Uf       , Uu^Uf       , Uu          , Uu^Uf       , Uu^Uf       , Xu          , Uh          , Uu^Uf       , Uu^Uf       , Uh          , Uh          , Uh          , Uh          , Uh          , Uu^Uf       , Uu^Uf       , Uu^Uf       , Uu          , Ur          , Ur          , Uu          , Uu          , Uu          , Xu          , Cud         , Cud         , Uh^Dr       , Cud         , Xu          , Xu          , Xu          , Xu          
Xu          , Xu          , Xu          , Xu          , Xu          , Uu^Uf       , Cud         , Xu          , Xu          , Xu          , Uh          , Xu          , Uh          , Uh          , Uu^Uf       , Uu^Uf       , Ur          , Uu^Uf       , Uu^Uf       , Uh          , Uh          , Uu^Uf       , Uu^Uf       , Uu^Uf       , Uu          , Uh          , Uu          , Uu^Vu       , Ur          , Uu          , Uu          , Ur          , Uu          , Ur          , Ur          , Uu          , Uu          , Xu          , Uu^Uf       , Uh^Dr       , Xu          , Xu          , Xu          , Xu          , Xu          , Xu          
Xu          , Xu          , Xu          , Xu          , Xu          , Cud         , Cud         , Cud         , Ur          , Uu          , Uu          , Uh^Dr       , Uh^Dr       , Uh          , Uh          , Uu          , Uu          , Ur          , Ur          , Uh          , Uu^Uf       , Uu^Uf       , Ur          , Uu          , Ur          , Ur          , Uu^Uf       , Uu^Uf       , Xu          , Ur          , Xu          , Uu          , Uu          , Uu          , Ur          , Uu          , Uu          , Uu^Uf       , Uu^Uf       , Uu^Uf       , Ww          , Xu          , Xu          , Xu          , Xu          , Xu          
Xu          , Xu          , Xu          , Xu          , Xu          , 4 Kud       , Cud         , Cud         , Uu          , Ur          , Uu^Uf       , Ur          , Ur          , Uh          , Xu          , Uh          , Xu          , Uu          , Ur          , Ur          , Uu^Uf       , Uu^Uf       , Uu^Dr       , Ur          , Uu^Uf       , Uu^Uf       , Uu^Uf       , Uu^Uf       , Uu^Uf       , Xu          , Xu          , Xu          , Uu^Uf       , Uu          , Uu          , Ur          , Uu          , Uu^Dr       , Uh          , Uh^Dr       , Uh^Dr       , Xu          , Xu          , Xu          , Xu          , Xu          
Xu          , Xu          , Xu          , Xu          , Xu          , Xu          , Xu          , Xu          , Xu          , Uu^Uf       , Uu^Uf       , Uu^Uf       , Ur          , Uu          , Xu          , Xu          , Uh          , Xu          , Ur          , Uu          , Uu^Uf       , Uu^Uf       , Uh          , Uu          , Ww          , Uu^Uf       , Uh          , Uu^Uf       , Uh          , Xu          , Xu          , Xu          , Uh          , Uu^Uf       , Uu          , Ur          , Ur          , Uu^Vu       , Uh          , Uh^Dr       , Xu          , Xu          , Xu          , Xu          , Xu          , Xu          
Xu          , Xu          , Xu          , Xu          , Xu          , Xu          , Xu          , Xu          , Xu          , Xu          , Qxu         , Xu          , Uh^Dr       , Ur          , Uu^Dr       , Ur          , Uu          , Uu^Vu       , Uu          , Uu^Uf       , Uu^Uf       , Uh          , Uh          , Ww          , Xu          , Ww          , Xu          , Uh^Dr       , Uh          , Uh          , Uh          , Uh          , Uh          , Uu^Uf       , Uu^Uf       , Uu          , Ur          , Uu          , Uh^Dr       , Uh^Dr       , Xu          , Xu          , Xu          , Xu          , Xu          , Xu          
Xu          , Xu          , Xu          , Xu          , Xu          , Xu          , Xu          , Xu          , Xu          , Qxu         , Uu          , Qxu^Bs/     , Xu          , Uh          , Uh          , Ww          , Ww          , Uh          , Uh          , Uu^Uf       , Xu          , Xu          , Xu          , Xu          , Xu          , Xu          , Xu          , Xu          , Xu          , Uh          , Uh^Dr       , Uh          , Xu          , Xu          , Uu^Uf       , Uu^Uf       , Ur          , Uu          , Uu          , Xu          , Xu          , Xu          , Xu          , Xu          , Xu          , Xu          
Xu          , Xu          , Xu          , Xu          , Xu          , Xu          , Xu          , Xu          , Xu          , Qxu         , Qxu         , Qxu^Bs\     , Uu          , Xu          , Xu          , Ww          , Xu          , Xu          , Xu          , Xu          , Xu          , Xu          , Xu          , Xu          , Xu          , Xu          , Xu          , Xu          , Xu          , Xu          , Xu          , Xu          , Xu          , Xu          , Xu          , Uu^Uf       , Uu          , Ur          , Ww          , Xu          , Xu          , Xu          , Xu          , Xu          , Xu          , Xu          
Xu          , Xu          , Xu          , Xu          , Xu          , Xu          , Xu          , Xu          , Xu          , Xu          , Xu          , Xu          , Xu          , Uu          , Xu          , Xu          , Xu          , Xu          , Xu          , Xu          , Xu          , Xu          , Xu          , Xu          , Xu          , Xu          , Xu          , Xu          , Xu          , Xu          , Xu          , Xu          , Xu          , Xu          , Xu          , Uu^Uf       , Ur          , Ur          , Ww          , Xu          , Xu          , Xu          , Xu          , Xu          , Xu          , Xu          
Xu          , Xu          , Xu          , Xu          , Xu          , Xu          , Xu          , Xu          , Xu          , Xu          , Xu          , Xu          , Xu          , Uu          , Xu          , Xu          , Xu          , Xu          , Xu          , Xu          , Xu          , Xu          , Xu          , Xu          , Xu          , Xu          , Xu          , Xu          , Xu          , Xu          , Xu          , Xu          , Xu          , Xu          , Xu          , Xu          , Ur          , Ww          , Ww          , Xu          , Xu          , Xu          , Xu          , Xu          , Xu          , Xu          
