border_size=1
usage=map

Rrc         , Gg          , Gg          , Gg^Efm      , Gg^Efm      , Gg^Efm      , Gg^Efm      , Gg          , Gg          , Wwt         , Gg          , Gg          , Gg          , Gg          , Gg          , Gg          , Gg          , Gg          , Gg          , Gg          , Gg          , Gg          , Ss          , Wwt         , Wwt         , Ss          , Ss          , Ss          , Gg          , Gg          , Gg          , Gg          , Gg          , Gg          , Gg          , Gg          , Gg          
Gg          , Rrc         , Rrc         , Gg          , Gg          , Gg          , Gg          , Gg          , Gg          , Wwt         , Gg          , Gg          , Gg          , Gg          , Re^Gvs      , Gg          , Re^Gvs      , Gg          , Gg          , Gg          , Gg          , Gg          , Ss          , Wwt         , Ss          , Wwt         , Wwt         , Ss          , Gg          , Gg          , Sm^Gvs      , Re^Gvs      , Re^Gvs      , Re^Gvs      , Re^Gvs      , Gg          , Gg          
Gg^Efm      , Gg          , Rrc         , Gg          , Ch          , Ch          , 1 Kh        , Ch          , Gg          , Wwt         , Sm^Gvs      , Re^Gvs      , Re^Gvs      , Gg          , Re^Gvs      , Re^Gvs      , Re^Gvs      , Re^Gvs      , Gg          , Gg          , Gg          , Gg          , Gg          , Wwt         , Ss          , Ss          , Sm^Gvs      , Wwt         , Wwt         , Sm^Gvs      , Sm^Gvs      , Sm^Gvs      , Sm^Gvs      , Re^Gvs      , Re^Gvs      , Re^Gvs      , Gg          
Gg^Efm      , Gg^Efm      , Rrc         , Ch          , Ch          , Ch          , Ch          , Ch          , Gg          , Wwt         , Sm^Gvs      , Re^Gvs      , Re^Gvs      , Gg          , Gg          , Re^Gvs      , Re^Gvs      , Re^Gvs      , Gs^Vh       , Gg          , Re^Gvs      , Re^Gvs      , Sm^Gvs      , Wwt         , Sm^Gvs      , Sm^Gvs      , Sm^Gvs      , Sm^Gvs      , Sm^Gvs      , Wwt         , Wwt         , Sm^Gvs      , Sm^Gvs      , Sm^Gvs      , Re^Gvs      , Re^Gvs      , Gg          
Gg^Efm      , Gg^Efm      , Rrc         , Ch          , Gg          , Gg          , Gg          , Gg          , Gg^Efm      , Wwt         , Sm^Gvs      , Re^Gvs      , Gs^Vh       , Gg          , Gg          , Re^Gvs      , Re^Gvs      , Re^Gvs      , Gg          , Re^Gvs      , Re^Gvs      , Sm^Gvs      , Sm^Gvs      , Wwt         , Gg          , Sm^Gvs      , Sm^Gvs      , Sm^Gvs      , Sm^Gvs      , Sm^Gvs      , Sm^Gvs      , Wwt         , Wwt         , Sm^Gvs      , Re^Gvs      , Gs^Vh       , Gg          
Wwt         , Gg^Efm      , Gg          , Rrc         , Rrc         , Gg^Efm      , Gg^Efm      , Gg^Efm      , Gg^Efm      , Wwt         , Sm^Gvs      , Re^Gvs      , Re^Gvs      , Gg          , Gg          , Gg          , Gg          , Re^Gvs      , Gg          , Re^Gvs      , Re^Gvs      , Sm^Gvs      , Sm^Gvs      , Wwt         , Sm^Gvs      , Gg          , Gg          , Re^Gvs      , Re^Gvs      , Re^Gvs      , Re^Gvs      , Re^Gvs      , Gg          , Wwt         , Wwt^Bw/     , Gg          , Gg          
Gg          , Wwt         , Wwt^Bw/     , Gg          , Gg          , Rrc         , Rrc         , Gg^Efm      , Gg          , Wwt         , Gg          , Re^Gvs      , Gg          , Gg          , Re^Gvs      , Re^Gvs      , Gg          , Gg          , Gs^Vh       , Re^Gvs      , Re^Gvs      , Sm^Gvs      , Sm^Gvs      , Wwt         , Sm^Gvs      , Re^Gvs      , Re^Gvs      , Gg          , Re^Gvs      , Re^Gvs      , Gs^Vh       , Re^Gvs      , Gg          , Gg          , Gg          , Wwt         , Wwt         
Gg          , Gg          , Sm^Gvs      , Wwt         , Wwt         , Gg          , Ss          , Rrc         , Rrc         , Wwt         , Gg          , Gg          , Gg          , Gg          , Re^Gvs      , Re^Gvs      , Re^Gvs      , Gg          , Gg          , Gg          , Gg          , Re^Gvs      , Gg          , Wwt         , Sm^Gvs      , Sm^Gvs      , Re^Gvs      , Re^Gvs      , Gg          , Gg          , Gg          , Gg          , Gg          , Gg          , Gg          , Gg          , Gg          
Gg          , Re^Gvs      , Re^Gvs      , Sm^Gvs      , Sm^Gvs      , Wwt         , Wwt         , Ss          , Ss          , Wwt^Bsb\    , Rrc         , Gg          , Gg          , Re^Gvs      , Re^Gvs      , Re^Gvs      , Re^Gvs      , Re^Gvs      , Gg          , Gg          , Re^Gvs      , Gg          , Re^Gvs      , Wwt         , Sm^Gvs      , Sm^Gvs      , Re^Gvs      , Re^Gvs      , Gg          , Gg          , Gg          , Gg          , Re^Gvs      , Gg          , Re^Gvs      , Re^Gvs      , Re^Gvs      
Gg          , Re^Gvs      , Re^Gvs      , Re^Gvs      , Re^Gvs      , Sm^Gvs      , Gg          , Wwt         , Wwt         , Wwt         , Gg          , Rrc         , Rrc         , Gg          , Gg          , Re^Gvs      , Gs^Vh       , Re^Gvs      , Gg          , Gg          , Re^Gvs      , Re^Gvs      , Sm^Gvs      , Wwt         , Sm^Gvs      , Sm^Gvs      , Re^Gvs      , Re^Gvs      , Gg          , Gg          , Gg          , Re^Gvs      , Re^Gvs      , Re^Gvs      , Re^Gvs      , Re^Gvs      , Re^Gvs      
Gg          , Re^Gvs      , Re^Gvs      , Re^Gvs      , Re^Gvs      , Re^Gvs      , Gg          , Ss          , Ss          , Wwt         , Wwt         , Gg          , Gg          , Rrc         , Rrc         , Gg          , Gg          , Gg          , Gg          , Gs^Vh       , Re^Gvs      , Re^Gvs      , Sm^Gvs      , Wwt         , Gg          , Re^Gvs      , Gs^Vh       , Re^Gvs      , Gg          , Gg          , Gg          , Gg          , Gg          , Gs^Vh       , Re^Gvs      , Re^Gvs      , Re^Gvs      
Gg          , Gg          , Gg          , Re^Gvs      , Gs^Vh       , Gg          , Gg          , Gg          , Ss          , Wwt         , Ss          , Wwt         , Wwt         , Gg          , Gg          , Rrc         , Rrc         , Gg          , Gg          , Re^Gvs      , Re^Gvs      , Re^Gvs      , Sm^Gvs      , Wwt         , Gg          , Gg          , Gg          , Gg          , Re^Gvs      , Re^Gvs      , Re^Gvs      , Gg          , Gg          , Gg          , Re^Gvs      , Re^Gvs      , Gg          
Re^Gvs      , Gg          , Gs^Vh       , Gg          , Gg          , Gg          , Gg          , Gg          , Ss          , Wwt         , Ss          , Gg          , Gg          , Wwt         , Wwt         , Gg          , Gg          , Rrc         , Rrc         , Gg          , Gg          , Re^Gvs      , Sm^Gvs      , Wwt         , Gg          , Gg          , Gg          , Gg          , Re^Gvs      , Re^Gvs      , Re^Gvs      , Re^Gvs      , Re^Gvs      , Gg          , Gg          , Re^Gvs      , Gg          
Re^Gvs      , Re^Gvs      , Re^Gvs      , Gg          , Gg          , Gs^Vh       , Re^Gvs      , Gg          , Gg          , Wwt         , Gg          , Gg          , Gg          , Sm^Gvs      , Sm^Gvs      , Wwt         , Wwt         , Gg          , Gg          , Rrc         , Rrc         , Gg          , Gg          , Wwt         , Gg          , Gg          , Gg          , Gs^Vh       , Gg          , Re^Gvs      , Re^Gvs      , Re^Gvs      , Re^Gvs      , Gg          , Gg          , Re^Gvs      , Re^Gvs      
Re^Gvs      , Re^Gvs      , Re^Gvs      , Gg          , Re^Gvs      , Re^Gvs      , Re^Gvs      , Re^Gvs      , Gg          , Wwt^Bw/     , Gg          , Gg          , Re^Gvs      , Sm^Gvs      , Sm^Gvs      , Sm^Gvs      , Sm^Gvs      , Wwt         , Wwt         , Gg          , Gg          , Rrc         , Rrc         , Wwt         , Gg          , Gg          , Gg          , Gg          , Gg          , Re^Gvs      , Re^Gvs      , Re^Gvs      , Gg          , Gg          , Gg          , Re^Gvs      , Re^Gvs      
Re^Gvs      , Re^Gvs      , Re^Gvs      , Gg          , Gg          , Re^Gvs      , Re^Gvs      , Re^Gvs      , Gg          , Wwt         , Sm^Gvs      , Re^Gvs      , Re^Gvs      , Re^Gvs      , Re^Gvs      , Sm^Gvs      , Re^Gvs      , Re^Gvs      , Gg          , Wwt^Bw/     , Wwt         , Gg          , Ss          , Wwt^Bsb\    , Rrc         , Gg          , Gg          , Gg          , Gg          , Gg          , Gg          , Gg          , Gg          , Gg          , Re^Gvs      , Re^Gvs      , Re^Gvs      
Gg          , Re^Gvs      , Re^Gvs      , Gg          , Gg          , Re^Gvs      , Re^Gvs      , Re^Gvs      , Gg          , Wwt         , Sm^Gvs      , Sm^Gvs      , Re^Gvs      , Re^Gvs      , Re^Gvs      , Re^Gvs      , Re^Gvs      , Gg          , Re^Gvs      , Sm^Gvs      , Sm^Gvs      , Wwt         , Wwt         , Wwt         , Ss          , Rrc         , Rrc         , Gg          , Gg          , Gg          , Gg          , Gg          , Gg          , Gs^Vh       , Re^Gvs      , Re^Gvs      , Re^Gvs      
Gg          , Gg          , Gg          , Gg          , Gg          , Gg          , Gg          , Gg          , Gg          , Wwt         , Sm^Gvs      , Sm^Gvs      , Re^Gvs      , Re^Gvs      , Gg          , Gs^Vh       , Gg          , Gg          , Re^Gvs      , Re^Gvs      , Sm^Gvs      , Sm^Gvs      , Sm^Gvs      , Wwt         , Wwt         , Ss          , Rrc         , Gg          , Gg          , Re^Gvs      , Re^Gvs      , Gs^Vh       , Re^Gvs      , Gg          , Re^Gvs      , Re^Gvs      , Gg          
Re^Gvs      , Gg          , Re^Gvs      , Re^Gvs      , Gg          , Gg          , Gg          , Gg          , Re^Gvs      , Wwt         , Sm^Gvs      , Sm^Gvs      , Re^Gvs      , Re^Gvs      , Gg          , Gg          , Gg          , Gg          , Re^Gvs      , Re^Gvs      , Re^Gvs      , Sm^Gvs      , Sm^Gvs      , Wwt         , Ss          , Wwt         , Wwt^Bsb|    , Gg          , Gg          , Re^Gvs      , Re^Gvs      , Re^Gvs      , Re^Gvs      , Re^Gvs      , Gg          , Re^Gvs      , Gg          
Re^Gvs      , Re^Gvs      , Re^Gvs      , Re^Gvs      , Gs^Vh       , Gg          , Re^Gvs      , Re^Gvs      , Sm^Gvs      , Wwt         , Re^Gvs      , Re^Gvs      , Re^Gvs      , Gs^Vh       , Re^Gvs      , Gg          , Re^Gvs      , Gg          , Gg          , Re^Gvs      , Re^Gvs      , Sm^Gvs      , Sm^Gvs      , Wwt         , Ss          , Ss          , Rrc         , Wwt         , Wwt         , Sm^Gvs      , Sm^Gvs      , Re^Gvs      , Re^Gvs      , Re^Gvs      , Re^Gvs      , Gg          , Gg          
Re^Gvs      , Re^Gvs      , Re^Gvs      , Re^Gvs      , Gg          , Gg          , Re^Gvs      , Re^Gvs      , Sm^Gvs      , Wwt         , Gg          , Re^Gvs      , Re^Gvs      , Re^Gvs      , Re^Gvs      , Re^Gvs      , Re^Gvs      , Re^Gvs      , Gg          , Gg          , Gs^Vh       , Re^Gvs      , Sm^Gvs      , Wwt         , Ss          , Ss          , Rrc         , Ch          , Ch          , Wwt         , Wwt         , Sm^Gvs      , Sm^Gvs      , Re^Gvs      , Re^Gvs      , Gg          , Gg          
Gg          , Re^Gvs      , Re^Gvs      , Re^Gvs      , Gg          , Gs^Vh       , Re^Gvs      , Re^Gvs      , Sm^Gvs      , Wwt         , Gg          , Gg          , Gg          , Gg          , Gg          , Re^Gvs      , Re^Gvs      , Re^Gvs      , Gs^Vh       , Gg          , Gg          , Re^Gvs      , Sm^Gvs      , Wwt         , Ss          , Ch          , Rrc         , Ch          , Ch          , Re^Gvs      , Re^Gvs      , Wwt         , Wwt         , Sm^Gvs      , Sm^Gvs      , Gg          , Gg          
Wwt         , Gg          , Gg          , Gg          , Gg          , Gg          , Gg          , Re^Gvs      , Sm^Gvs      , Wwt         , Gg          , Gg          , Re^Gvs      , Re^Gvs      , Gg          , Re^Gvs      , Re^Gvs      , Re^Gvs      , Gg          , Gg          , Gg          , Gg          , Gg          , Wwt         , Ss          , 3 Kh        , Rrc         , 2 Kh        , Ch          , Re^Gvs      , Re^Gvs      , Re^Gvs      , Re^Gvs      , Wwt         , Wwt         , Gg          , Gg          
Gg          , Wwt         , Wwt         , Gg          , Gg          , Gg          , Gg          , Re^Gvs      , Gg          , Wwt         , Gg          , Gg          , Re^Gvs      , Re^Gvs      , Re^Gvs      , Re^Gvs      , Re^Gvs      , Gg          , Gg          , Gg          , Re^Gvs      , Gg          , Gg          , Wwt         , Ss          , Ch          , Ch          , Rrc         , Rrc         , Ch          , Gs^Vh       , Re^Gvs      , Re^Gvs      , Re^Gvs      , Re^Gvs      , Wwt         , Wwt         
Gg          , Re^Gvs      , Sm^Gvs      , Wwt         , Wwt         , Gg          , Gg          , Gg          , Gg          , Wwt^Bw/     , Sm^Gvs      , Gg          , Gg          , Re^Gvs      , Re^Gvs      , Re^Gvs      , Re^Gvs      , Re^Gvs      , Gg          , Gg          , Re^Gvs      , Re^Gvs      , Sm^Gvs      , Wwt         , Sm^Gvs      , Ch          , Ch          , Gs^Vh       , Re^Gvs      , Rrc         , Rrc         , Gg          , Gg          , Re^Gvs      , Re^Gvs      , Re^Gvs      , Gg          
Gg          , Re^Gvs      , Re^Gvs      , Sm^Gvs      , Sm^Gvs      , Wwt         , Wwt         , Gg          , Ss          , Wwt         , Sm^Gvs      , Re^Gvs      , Re^Gvs      , Gg          , Gg          , Re^Gvs      , Gs^Vh       , Re^Gvs      , Gg          , Gg          , Re^Gvs      , Re^Gvs      , Sm^Gvs      , Wwt         , Sm^Gvs      , Sm^Gvs      , Re^Gvs      , Re^Gvs      , Re^Gvs      , Re^Gvs      , Re^Gvs      , Rrc         , Rrc         , Gg          , Gg          , Gg          , Gg          
Gg          , Re^Gvs      , Re^Gvs      , Re^Gvs      , Re^Gvs      , Sm^Gvs      , Gg          , Wwt^Bw|     , Wwt         , Wwt         , Sm^Gvs      , Re^Gvs      , Re^Gvs      , Re^Gvs      , Gs^Vh       , Gg          , Gg          , Re^Gvs      , Gg          , Gs^Vh       , Re^Gvs      , Re^Gvs      , Sm^Gvs      , Wwt         , Sm^Gvs      , Sm^Gvs      , Re^Gvs      , Re^Gvs      , Re^Gvs      , Re^Gvs      , Re^Gvs      , Gg          , Gg          , Rrc         , Rrc         , Gg          , Gg          
Gg          , Gg          , Gg          , Re^Gvs      , Re^Gvs      , Gs^Vh       , Gg          , Gg          , Gg          , Wwt         , Wwt         , Sm^Gvs      , Re^Gvs      , Re^Gvs      , Gg          , Gg          , Gg          , Gg          , Gg          , Gg          , Gg          , Re^Gvs      , Gg          , Wwt         , Sm^Gvs      , Sm^Gvs      , Sm^Gvs      , Re^Gvs      , Gg          , Re^Gvs      , Gg          , Re^Gvs      , Gg          , Gg          , Gg          , Rrc         , Rrc         
