border_size=1
usage=map

Xuc         , Xuc         , Xuc         , Xuc         , Xuc         , Xuc         , Xuc         , Xuc         , Xuc         , Xuc         , Xuc         , Xuc         , Xuc         , Xuc         , Xuc         , Xuc         , Xuc         , Xuc         , Xuc         , Xuc         , Xuc         , Xuc         , Xuc         , Xuc         , Xuc         , Xuc         , Xuc         , Xuc         , Xuc         , Xuc         , Xuc         , Xuc         , Xuc         , Xuc         , Xuc         , Xuc         , Xuc         , Xuc         , Xuc         , Xuc         , Xol         , Xol         , Xol         , Xol         , Xol         , Xol         
Xuc         , Xuc         , Xuc         , Xuc         , Xuc         , Xuc         , Urb         , Urb         , Urb         , Urb         , Urb         , Xuc         , Xuc         , Xuc         , Xuc         , Xuc         , Xuc         , Xuc         , Xuc         , Xuc         , Xuc         , Xuc         , Xuc         , Xuc         , Xuc         , Xuc         , Xuc         , Xuc         , Xuc         , Xuc         , Xuc         , Xuc         , Xuc         , Xuc         , Xuc         , Xuc         , Xuc         , Xuc         , Xol         , Xol         , Urb         , Xol         , Xol         , Xol         , Xol         , Xol         
Xuc         , Xuc         , Xuc         , Xuc         , Urb         , Urb         , Sm^Bw\      , Sm          , Sm          , Sm          , Urb         , Xuc         , Urb         , Xuc         , Xuc         , Xuc         , Uu^Vu       , Xuc         , Xuc         , Xuc         , Xuc         , Xuc         , Xuc         , Xuc         , Urb         , Xuc         , Xuc         , Xuc         , Xuc         , Xuc         , Xuc         , Xuc         , Xuc         , Xuc         , Urb         , Urb         , Urb         , Xuc         , Urb         , Urb         , Urb         , Urb         , Urb         , Xol         , Xol         , Xol         
Xuc         , Xuc         , Xuc         , Xuc         , Urb         , Sm          , Urb         , Urb         , Urb         , Sm          , Sm          , Urb         , Sm          , Urb         , Urb         , Urb         , Sm          , Urb         , Urb         , Xuc         , Xuc         , Xuc         , Urb         , Urb         , Sm          , Urb         , Urb         , Xuc         , Xuc         , Xuc         , Xuc         , Xuc         , Urb         , Urb         , Sm          , Sm          , Sm          , Urb         , Urb         , Urb         , Xol         , Urb         , Urb         , 3 Urb       , Xol         , Xol         
Xuc         , Xuc         , Xuc         , Xuc         , Urb         , Sm          , Urb         , Xuc         , Xuc         , Urb         , Urb         , Sm          , Urb         , Sm          , Sm          , Sm          , Urb         , Sm^Bw/      , Sm          , Urb         , Urb         , Urb         , Sm          , Sm          , Urb         , Sm          , Sm^Bw|r     , Urb         , Urb         , Xuc         , Urb         , Urb         , Sm          , Sm          , Urb         , Urb         , Urb         , Sm          , Urb         , Urb         , Xol         , Xol         , Urb         , Urb         , Xol         , Xol         
Xuc         , Xuc         , Xuc         , Xuc         , Urb         , Sm          , Sm          , Urb         , Xuc         , Xuc         , Xuc         , Urb         , Xuc         , Urb         , Urb         , Urb         , Xuc         , Urb         , Urb         , Sm          , Sm          , Sm          , Urb         , Urb         , Xuc         , Urb         , Urb         , Sm          , Sm          , Urb         , Sm          , Sm          , Urb         , Urb         , Xuc         , Xuc         , Urb         , Sm          , Urb         , Urb         , Urb         , Urb         , Urb         , Urb         , Xol         , Xol         
Xuc         , Xuc         , Xuc         , Xuc         , Xuc         , Urb         , Sm          , Urb         , Xuc         , Xuc         , Xuc         , Xuc         , Xuc         , Xuc         , Xuc         , Xuc         , Urb         , Urb         , Sm          , Sm          , Sm          , Urb         , Xuc         , Xuc         , Xuc         , Xuc         , Xuc         , Urb         , Urb         , Sm          , Urb         , Urb         , Xuc         , Xuc         , Xuc         , Xuc         , Urb         , Sm          , Urb         , Urb         , Urb         , Urb         , Xol         , Xol         , Xol         , Xol         
Xuc         , Xuc         , Xuc         , Xuc         , Xuc         , Urb         , Sm          , Urb         , Urb         , Xuc         , Xuc         , Xuc         , Xuc         , Xuc         , Urb         , Urb         , Sm          , Sm          , Urb         , Urb         , Sm          , Urb         , Xuc         , Xuc         , Xuc         , Xuc         , Xuc         , Xuc         , Xuc         , Uu^Vu       , Xuc         , Xuc         , Xuc         , Xuc         , Urb         , Urb         , Sm^Bw\      , Sm          , Urb         , Urb         , Xuc         , Xol         , Xuc         , Xuc         , Xuc         , Xol         
Xuc         , Xuc         , Xuc         , Xuc         , Xuc         , Urb         , Urb         , Sm          , Urb         , Xuc         , Xuc         , Xuc         , Urb         , Urb         , Sm          , Sm^Bw\      , Urb         , Urb         , Xuc         , Urb         , Sm          , Urb         , Xuc         , Xuc         , Xuc         , Xuc         , Xuc         , Xuc         , Xuc         , Xuc         , Xuc         , Xuc         , Xuc         , Xuc         , Urb         , Sm          , Urb         , Urb         , Xuc         , Xuc         , Xuc         , Xuc         , Xuc         , Xuc         , Xuc         , Xuc         
Xuc         , Xuc         , Xuc         , Xuc         , Xuc         , Xuc         , Urb         , Sm          , Urb         , Xuc         , Urb         , Urb         , Sm          , Sm          , Urb         , Urb         , Xuc         , Xuc         , Xuc         , Urb         , Sm          , Urb         , Xuc         , Xuc         , Xuc         , Xuc         , Xuc         , Xuc         , Xuc         , Xuc         , Xuc         , Xuc         , Xuc         , Xuc         , Urb         , Sm          , Urb         , Xuc         , Xuc         , Xuc         , Xuc         , Xuc         , Xuc         , Xuc         , Xuc         , Xuc         
Xuc         , Xuc         , Xuc         , Xuc         , Xuc         , Xuc         , Urb         , Sm          , Sm          , Uu^Vu       , Sm          , Sm          , Urb         , Urb         , Xuc         , Xuc         , Xuc         , Xuc         , Xuc         , Urb         , Sm          , Urb         , Xuc         , Xuc         , Xuc         , Xuc         , Xuc         , Xuc         , Xuc         , Xuc         , Xuc         , Xuc         , Urb         , Urb         , Urb         , Sm          , Urb         , Xuc         , Xuc         , Xuc         , Xuc         , Xuc         , Xuc         , Xuc         , Xuc         , Xuc         
Xuc         , Xuc         , Xuc         , Xuc         , Xuc         , Xuc         , Xuc         , Urb         , Sm          , Sm          , Urb         , Urb         , Xuc         , Xuc         , Xuc         , Xuc         , Xuc         , Xuc         , Xuc         , Urb         , Sm          , Urb         , Xuc         , Xuc         , Xuc         , Xuc         , Xuc         , Xuc         , Xuc         , Xuc         , Urb         , Urb         , Xuc         , Xuc         , Urb         , Sm          , Urb         , Xuc         , Xuc         , Xuc         , Xuc         , Xuc         , Xuc         , Xuc         , Xuc         , Xuc         
Xuc         , Xuc         , Xuc         , Xuc         , Xuc         , Xuc         , Xuc         , Urb         , Sm          , Urb         , Xuc         , Xuc         , Xuc         , Xuc         , Xuc         , Xuc         , Xuc         , Xuc         , Xuc         , Urb         , Sm          , Urb         , Xuc         , Xuc         , Xuc         , Xuc         , Xuc         , Xuc         , Urb         , Urb         , Xuc         , Xuc         , Xuc         , Xuc         , Urb         , Sm          , Urb         , Xuc         , Xuc         , Xuc         , Xuc         , Xuc         , Xuc         , Xuc         , Xuc         , Xuc         
Xuc         , Xuc         , Xuc         , Xuc         , Xuc         , Xuc         , Xuc         , Urb         , Sm          , Urb         , Xuc         , Xuc         , Xuc         , Xuc         , Xuc         , Xuc         , Xuc         , Xuc         , Xuc         , Urb         , Sm          , Urb         , Xuc         , Xuc         , Xuc         , Xuc         , Urb         , Urb         , Xuc         , Xuc         , Xuc         , Xuc         , Xuc         , Xuc         , Urb         , Sm          , Uu^Vu       , Xuc         , Xuc         , Xuc         , Xuc         , Xuc         , Xuc         , Xuc         , Xuc         , Xuc         
Xuc         , Xuc         , Xuc         , Xuc         , Xuc         , Xuc         , Xuc         , Urb         , Sm^Bw/      , Urb         , Urb         , Xuc         , Xuc         , Xuc         , Xuc         , Xuc         , Xuc         , Xuc         , Urb         , Urb         , Sm^Bw\r     , Urb         , Xuc         , Xuc         , Urb         , Urb         , Xuc         , Xuc         , Xuc         , Xuc         , Xuc         , Xuc         , Xuc         , Xuc         , Urb         , Sm          , Urb         , Xuc         , Xuc         , Xuc         , Xuc         , Xuc         , Xuc         , Xuc         , Xuc         , Xuc         
Xuc         , Xuc         , Xuc         , Xuc         , Xuc         , Xuc         , Xuc         , Urb         , Urb         , Sm          , Sm          , Urb         , Xuc         , Xuc         , Xuc         , Xuc         , Xuc         , Urb         , Sm          , Sm          , Urb         , Urb         , Urb         , Urb         , Xuc         , Xuc         , Xuc         , Xuc         , Xuc         , Xuc         , Xuc         , Xuc         , Xuc         , Xuc         , Urb         , Sm          , Sm          , Urb         , Urb         , Xuc         , Xuc         , Xuc         , Xuc         , Xuc         , Xuc         , Xuc         
Xuc         , Xuc         , Xuc         , Xuc         , Xuc         , Xuc         , Xuc         , Xuc         , Urb         , Sm          , Sm          , Urb         , Urb         , Xuc         , Xuc         , Xuc         , Urb         , Urb         , Sm          , Sm          , Uu^Vu       , Xuc         , Xuc         , Xuc         , Xuc         , Xuc         , Xuc         , Xuc         , Xuc         , Xuc         , Xuc         , Xuc         , Xuc         , Xuc         , Xuc         , Urb         , Urb         , Sm^Bw/r     , Sm          , Urb         , Urb         , Xuc         , Xuc         , Xuc         , Xuc         , Xuc         
Xuc         , Xuc         , Xuc         , Xuc         , Xuc         , Xuc         , Xuc         , Xuc         , Xuc         , Urb         , Urb         , Sm          , Sm          , Urb         , Urb         , Xuc         , Urb         , Sm          , Urb         , Urb         , Xuc         , Xuc         , Xuc         , Xuc         , Xuc         , Xuc         , Xuc         , Xuc         , Xuc         , Xuc         , Xuc         , Xuc         , Xuc         , Xuc         , Xuc         , Xuc         , Uu^Vu       , Urb         , Urb         , Sm          , Urb         , Xuc         , Xuc         , Xuc         , Xuc         , Xuc         
Xuc         , Xuc         , Xuc         , Xuc         , Xuc         , Xuc         , Xuc         , Xuc         , Xuc         , Xuc         , Xuc         , Urb         , Urb         , Sm          , Sm          , Urb         , Urb         , Sm          , Urb         , Xuc         , Xuc         , Xuc         , Urb         , Urb         , Urb         , Urb         , Urb         , Xuc         , Xuc         , Xuc         , Xuc         , Xuc         , Xuc         , Xuc         , Urb         , Urb         , Xuc         , Xuc         , Urb         , Sm          , Urb         , Xuc         , Xuc         , Xuc         , Xuc         , Xuc         
Xuc         , Xuc         , Xuc         , Xuc         , Xuc         , Xuc         , Xuc         , Xuc         , Xuc         , Xuc         , Xuc         , Xuc         , Xuc         , Urb         , Urb         , Sm          , Sm          , Sm          , Urb         , Xuc         , Urb         , Urb         , Sm          , Sm          , Sm          , Sm          , Sm          , Urb         , Urb         , Xuc         , Xuc         , Xuc         , Urb         , Urb         , Xuc         , Xuc         , Xuc         , Xuc         , Urb         , Sm          , Urb         , Xuc         , Xuc         , Xuc         , Xuc         , Xuc         
Xuc         , Xuc         , Xuc         , Xuc         , Xuc         , Xuc         , Xuc         , Xuc         , Xuc         , Xuc         , Xuc         , Xuc         , Xuc         , Xuc         , Xuc         , Urb         , Urb         , Sm          , Uu^Vu       , Urb         , Sm          , Sm          , Urb         , Urb         , Urb         , Urb         , Urb         , Sm          , Sm^Bw/r     , Urb         , Urb         , Urb         , Xuc         , Xuc         , Xuc         , Xuc         , Xuc         , Xuc         , Urb         , Sm          , Urb         , Xuc         , Xuc         , Xuc         , Xuc         , Xuc         
Xuc         , Xuc         , Xuc         , Xuc         , Xuc         , Xuc         , Xuc         , Xuc         , Xuc         , Xuc         , Xuc         , Xuc         , Xuc         , Xuc         , Xuc         , Xuc         , Urb         , Sm          , Sm          , Sm          , Urb         , Urb         , Xuc         , Xuc         , Xuc         , Xuc         , Xuc         , Urb         , Urb         , Sm          , Urb         , Xuc         , Xuc         , Xuc         , Xuc         , Xuc         , Xuc         , Xuc         , Urb         , Sm^Bw\r     , Urb         , Xuc         , Xuc         , Xuc         , Xuc         , Xuc         
Xuc         , Xuc         , Xuc         , Xuc         , Xuc         , Xuc         , Xuc         , Xuc         , Xuc         , Xuc         , Xuc         , Xuc         , Xuc         , Xuc         , Xuc         , Xuc         , Urb         , Urb         , Sm          , Urb         , Xuc         , Xuc         , Xuc         , Xuc         , Xuc         , Xuc         , Xuc         , Xuc         , Urb         , Sm          , Urb         , Xuc         , Xuc         , Xuc         , Xuc         , Xuc         , Xuc         , Xuc         , Urb         , Sm          , Urb         , Xuc         , Xuc         , Xuc         , Xuc         , Xuc         
Xuc         , Xuc         , Xuc         , Xuc         , Xuc         , Xuc         , Xuc         , Xuc         , Xuc         , Xuc         , Xuc         , Xuc         , Xuc         , Xuc         , Xuc         , Xuc         , Urb         , Sm          , Urb         , Urb         , Xuc         , Xuc         , Xuc         , Xuc         , Xuc         , Xuc         , Xuc         , Xuc         , Urb         , Sm          , Sm          , Urb         , Urb         , Xuc         , Xuc         , Xuc         , Xuc         , Xuc         , Urb         , Sm          , Urb         , Xuc         , Xuc         , Xuc         , Xuc         , Xuc         
Xuc         , Xuc         , Xuc         , Xuc         , Xuc         , Xuc         , Xuc         , Xuc         , Xuc         , Xuc         , Xuc         , Xuc         , Xuc         , Xuc         , Xuc         , Xuc         , Urb         , Sm          , Urb         , Urb         , Xuc         , Xuc         , Xuc         , Xuc         , Xuc         , Xuc         , Xuc         , Xuc         , Xuc         , Urb         , Urb         , Sm          , Sm          , Urb         , Urb         , Xuc         , Xuc         , Xuc         , Urb         , Sm          , Urb         , Xuc         , Xuc         , Xuc         , Xuc         , Xuc         
Xuc         , Xuc         , Xuc         , Xuc         , Xuc         , Xuc         , Xuc         , Xuc         , Xuc         , Xuc         , Xuc         , Xuc         , Xuc         , Xuc         , Uu^Vu       , Urb         , Sm          , Sm^Bw\r     , Urb         , Xuc         , Xuc         , Xuc         , Xuc         , Xuc         , Xuc         , Xuc         , Xuc         , Xuc         , Xuc         , Xuc         , Xuc         , Urb         , Urb         , Sm          , Sm          , Urb         , Urb         , Urb         , Sm          , Sm          , Urb         , Xuc         , Xuc         , Xuc         , Xuc         , Xuc         
Xuc         , Xuc         , Xuc         , Xuc         , Xuc         , Xuc         , Xuc         , Xuc         , Xuc         , Xuc         , Xuc         , Xuc         , Xuc         , Xuc         , Urb         , Sm          , Urb         , Urb         , Xuc         , Xuc         , Xuc         , Xuc         , Xuc         , Xuc         , Xuc         , Xuc         , Xuc         , Xuc         , Xuc         , Xuc         , Xuc         , Xuc         , Xuc         , Urb         , Urb         , Sm          , Sm          , Uu^Vu       , Sm          , Urb         , Xuc         , Xuc         , Xuc         , Xuc         , Xuc         , Xuc         
Xuc         , Xuc         , Xuc         , Xuc         , Xuc         , Xuc         , Xuc         , Xuc         , Xuc         , Xuc         , Xuc         , Xuc         , Urb         , Urb         , Sm          , Sm          , Urb         , Xuc         , Xuc         , Xuc         , Xuc         , Xuc         , Xuc         , Xuc         , Xuc         , Xuc         , Xuc         , Xuc         , Xuc         , Xuc         , Xuc         , Xuc         , Xuc         , Xuc         , Xuc         , Urb         , Urb         , Sm          , Urb         , Urb         , Xuc         , Xuc         , Xuc         , Xuc         , Xuc         , Xuc         
Xuc         , Xuc         , Xuc         , Xuc         , Xuc         , Xuc         , Xuc         , Xuc         , Xuc         , Xuc         , Xuc         , Xuc         , Urb         , Sm          , Urb         , Urb         , Xuc         , Xuc         , Xuc         , Xuc         , Xuc         , Xuc         , Xuc         , Xuc         , Xuc         , Xuc         , Xuc         , Xuc         , Xuc         , Xuc         , Xuc         , Xuc         , Xuc         , Xuc         , Xuc         , Xuc         , Xuc         , Urb         , Xuc         , Xuc         , Xuc         , Xuc         , Xuc         , Xuc         , Xuc         , Xuc         
Xuc         , Xuc         , Xuc         , Xuc         , Xuc         , Xuc         , Xuc         , Xuc         , Xuc         , Xuc         , Xuc         , Urb         , Sm          , Sm          , Urb         , Xuc         , Xuc         , Xuc         , Xuc         , Xuc         , Xuc         , Xuc         , Xuc         , Xuc         , Xuc         , Xuc         , Xuc         , Xuc         , Xuc         , Xuc         , Xuc         , Xuc         , Xuc         , Xuc         , Xuc         , Xuc         , Xuc         , Xuc         , Xuc         , Xuc         , Xuc         , Xuc         , Xuc         , Xuc         , Xuc         , Xuc         
Xuc         , Xuc         , Xuc         , Xuc         , Xuc         , Xuc         , Xuc         , Xuc         , Xuc         , Xuc         , Urb         , Urb         , Sm          , Urb         , Xuc         , Xuc         , Xuc         , Xuc         , Xuc         , Xuc         , Xuc         , Xuc         , Xuc         , Xuc         , Xuc         , Xuc         , Xuc         , Xuc         , Xuc         , Xuc         , Xuc         , Xuc         , Xuc         , Xuc         , Xuc         , Xuc         , Xuc         , Xuc         , Xuc         , Xuc         , Xuc         , Xuc         , Xuc         , Xuc         , Xuc         , Xuc         
Xuc         , Xuc         , Xuc         , Xuc         , Xuc         , Xuc         , Xuc         , Xuc         , Xuc         , Xuc         , Urb         , Sm          , Cud         , Cud         , Xuc         , Xuc         , Xuc         , Xuc         , Xuc         , Xuc         , Xuc         , Xuc         , Xuc         , Xuc         , Xuc         , Xuc         , Xuc         , Xuc         , Xuc         , Xuc         , Xuc         , Xuc         , Xuc         , Xuc         , Xuc         , Xuc         , Xuc         , Xuc         , Xuc         , Xuc         , Xuc         , Xuc         , Xuc         , Xuc         , Xuc         , Xuc         
Xuc         , Xuc         , Xuc         , Xuc         , Xuc         , Xuc         , Xuc         , Xuc         , Urb         , Urb         , Sm          , Sm          , Cud         , Cud         , Xuc         , Xuc         , Xuc         , Xuc         , Xuc         , Xuc         , Xuc         , Xuc         , Xuc         , Xuc         , Xuc         , Xuc         , Xuc         , Xuc         , Xuc         , Xuc         , Xuc         , Xuc         , Xuc         , Xuc         , Xuc         , Xuc         , Xuc         , Xuc         , Xuc         , Xuc         , Xuc         , Xuc         , Xuc         , Xuc         , Xuc         , Xuc         
Xuc         , Xuc         , Xuc         , Xuc         , Xuc         , Xuc         , Urb         , Urb         , Sm          , Sm^Bw\r     , Urb         , Cud         , Cud         , 1 Kud       , Xuc         , Xuc         , Xuc         , Xuc         , Xuc         , Xuc         , Xuc         , Xuc         , Xuc         , Xuc         , Xuc         , Xuc         , Xuc         , Xuc         , Xuc         , Xuc         , Xuc         , Xuc         , Xuc         , Xuc         , Xuc         , Xuc         , Xuc         , Xuc         , Xuc         , Xuc         , Xuc         , Xuc         , Xuc         , Xuc         , Xuc         , Xuc         
Xuc         , Xuc         , Xuc         , Xuc         , Xuc         , Urb         , Urb         , Sm          , Urb         , Urb         , Xuc         , Xuc         , Xuc         , Xuc         , Xuc         , Xuc         , Xuc         , Xuc         , Xuc         , Xuc         , Xuc         , Xuc         , Xuc         , Xuc         , Xuc         , Xuc         , Xuc         , Xuc         , Xuc         , Xuc         , Xuc         , Xuc         , Xuc         , Xuc         , Xuc         , Xuc         , Xuc         , Xuc         , Xuc         , Xuc         , Xuc         , Xuc         , Xuc         , Xuc         , Xuc         , Xuc         
