border_size=1
usage=map

Xol, Xol, Xol, Xol, Xol, Xol, Xol, Xol, Xol, Xol, Xol, Xol, Iwr, Iwr, Iwr, Iwr, Xol, Xol, Xos, Xol, Xol, Xol
Xol, Xol, Xol, Xol, Xol, Xol, Xol, Xol, Xol, Xol, Iwr, Iwr, Iwr, Iwr, Iwr, Iwr, Iwr, Xol, Xol, Xol, Xol, Xol
Xol, Xol, Xol, Xol, Xol, Xol, Xol, Xos, Xos, Iwr, Iwr^Es, Iwr, Iwr, Iwr, Iwr, Xol, Xol, Xol, Xol, Xol, Xol, Xol
Xol, Xol, Xol, Xol, Xol, Xol, Xol, Xos, Xos, Iwr, Iwr, Iwr, Iwr, Iwr, Iwr, Iwr, Iwr, Xol, Xol, Xol, Xol, Xol
Xol, Xol, Xol, Xol, Xol, Xol, Xol, Xos, Xos, Iwr, Iwr, Iwr, Iwr, Iwr, Iwr, Xol, Xol, Xol, Xol, Xol, Xol, Xol
Xol, Xol, Xol, Xol, Rrc, Xol, Xos, Xos, Xos, Iwr, Xos, Iwr, Iwr^Ii, Iwr, Iwr, Xol, Xol, Xol, Xol, Xol, Xol, Xol
Xol, Xol, Xol, Xol, Xol, Rrc, Rrc, Xol, Xol, Iwr, Iwr, Iwr^Ii, Iwr^Ii, Iwr^Ii, Iwr^Ii, Xol, Iwr, Xol, Xol, Xol, Xol, Xol
Xol, Xol, Xol, Xol, Xos, Rrc, Rrc, Rrc, Rrc, Iwr, Iwr, Xos, Iwr^Ii, Iwr^Ii, Iwr, Iwr, Xol, Xol, Xol, Xol, Xol, Xol
Xol, Xol, Xol, Xol, Xol, Rrc, Xos, Rrc, Rrc, Rrc, Xol, Xos, Xol, Xos, Iwr, Iwr, Xol, Xol, Xol, Xol, Xol, Xol
Xol, Xol, Xol, Xol, Iwr, Rrc, Xol, Xol, Rrc, Rrc, Rrc, Xol, Rrc, Xol, Iwr, Iwr^Es, Iwr, Xol, Iwr, 2 Iwr, Xol, Xol
Xol, Xol, Xol, Xol, Iwr^Ii, Xol, Xol, Rrc, Rrc, Rrc, Rrc, Rrc, Iwr, Rrc, Iwr, Iwr, Xol, Xol, Iwr, Iwr, Xol, Xol
Xol, Xol, Xol, Xol, Iwr^Ii, Iwr^Ii, Iwr^Ii, Iwr, Xol, Xos, Iwr, Rrc, Xos, Xol, Xol, Iwr, Iwr, Xol, Xol, Xol, Xol, Xol
Xol, Xol, Xol, Xol, Xol, Iwr^Ii, Iwr^Ii, Xol, Iwr, Iwr, Xos, Xol, Xol, Iwr, Iwr, Xos, Iwr, Iwr, Xol, Xol, Xol, Xol
Xol, Xol, Xol, Xol, Xol, Xol, Xol, Iwr, Xol, Iwr, Xos, Iwr, Iwr, Iwr, Iwr^Es, Iwr, Xol, Iwr, Xol, Xol, Xol, Xol
Xol, Xol, Xol, Xol, Xol, Xos, Rrc, Xol, Rrc, Rrc, Xos, Iwr, Iwr, Iwr, Iwr, Iwr, Xos, Xol, Xol, Xol, Xol, Xol
Xol, Xol, Xol, Xol, Iwr, Rrc, Xol, Iwr, Xos, Iwr, Xos, Xos, Iwr, Xos, Xol, Iwr, Iwr, Xos, Xos, Xol, Xol, Xol
Xol, Xol, Xol, Xol, Xos, Rrc, Rrc, Rrc, Xol, Xol, Xos, Xos, Iwr, Iwr, Iwr, Xol, Xos, Iwr, Xol, Xol, Xol, Xol
Xol, Xol, Xol, Xol, Xos, Xos, Rrc, Rrc, Rrc, Iwr, Iwr, Iwr, Xos, Iwr, Xos, Iwr, Xos, Iwr, Xos, Xol, Xol, Xol
Xol, Xol, Xos, Xos, Xos, Iwr, Rrc, Rrc, Xos, Iwr, Iwr, Iwr, Xos, Xol, Xol, Xol, Iwr, Iwr, Iwr, Xos, Xol, Xol
Xol, Xos, Xol, Xos, Xol, Xol, Iwr, Iwr, Iwr, Iwr^Ii, Iwr^Ii, Iwr^Ii, Iwr^Ii, Iwr, Iwr, Iwr, Iwr, Iwr, Iwr^Es, Xos, Xol, Xol
Xol, Xos, Xol, Xol, Xos, Iwr, Iwr, Iwr, Iwr^Ii, Iwr^Ii, Iwr^Ii, Iwr^Ii, Iwr^Ii, Iwr, Xos, Iwr, Xos, Xos, Iwr, Xol, Xol, Xol
Xol, Xos, Xol, Xol, Xol, Iwr, Xol, Xol, Iwr^Ii, Iwr^Ii, Iwr^Ii, Iwr^Ii, Iwr, Iwr, Xos, Iwr, Xos, Xos, Xos, Iwr, Xos, Xol
Xol, Xos, Xos, Rrc, Rrc, Rrc, Rrc, Iwr^Esd, Iwr, Iwr^Ii, Iwr, Iwr^Ii, Xos, Iwr, Iwr, Iwr, Xos, Xos, Xos, Iwr, Xos, Xos
Xos, Xos, Xos, Rrc, Iwr, Iwr, Xol, Xol, Xol, Iwr, Xol, Xos, Xol, Xol, Xol, Iwr, Xos, Xol, Xos, Iwr, Xos, Xol
Xol, Xos, Xol, Rrc, Iwr, Iwr, Iwr, Iwr, Xol, Iwr, Iwr, Xol, Xol, Xol, Iwr, Iwr, Iwr, Xos, Iwr^Ii, Xos, Xos, Xol
Xol, Xol, Iwr^Ii, Iwr, Iwr^Ii, Xol, Iwr, Iwr, Iwr, Iwr, Xol, Iwr, Xol, Iwr, Iwr, Iwr^Es, Iwr, Iwr^Ii, Iwr^Ii, Iwr^Ii, Xos, Xos
Xol, Xol, Xos, Iwr^Ii, Iwr^Ii, Xos, Iwr, Iwr, Xol, Xol, Xol, Xol, Iwr, Iwr, Iwr, Xos, Iwr, Iwr^Ii, Iwr^Ii, Iwr^Ii, Xos, Xos
Xol, Xos, Xos, Iwr^Ii, Iwr^Ii, Iwr^Ii, Iwr, Xol, Xol, Xol, Iwr^Es, Xol, Iwr, Iwr, Iwr, Xos, Iwr, Iwr^Ii, Iwr^Ii, Iwr^Ii, Xos, Xos
Xol, Xol, Xos, Iwr^Ii, Iwr^Ii, Iwr^Ii, Xos, Rrc, Rrc, Xol, Iwr, Iwr, Iwr, Iwr, Xol, Xos, Iwr, Iwr^Ii, Iwr^Ii, Xos, Xol, Xol
Xol, Xos, Xol, Iwr^Ii, Iwr, Xos, Xos, Xos, Rrc, Rrc, Rrc, Iwr, Iwr, Iwr, Iwr, Xol, Iwr, Iwr, Xos, Xos, Xol, Xol
Xol, Xol, Rrc, Rrc, Rrc, Xol, Xol, Xol, Rrc, Rrc, Rrc, Iwr, Iwr, Iwr, Iwr, Iwr, Iwr, Iwr, Xos, Xol, Xol, Xol
Xol, Xos, Xos, Rrc, Rrc, Rrc, Rrc, Rrc, Rrc, Xol, Xol, Iwr, 1 Iwr, Iwr, Iwr, Iwr^Esd, Iwr, Xos, Xol, Xol, Xol, Xol
Xol, Xos, Xos, Rrc, Rrc, Rrc, Xos, Rrc, Xos, Xol, Iwr, Iwr, Iwr, Iwr, Iwr, Iwr, Xos, Xos, Xol, Xol, Xol, Xol
Xol, Xol, Xos, Xos, Xos, Rrc^Em, Xol, Xos, Xos, Xol, Iwr, Iwr, Iwr, Iwr, Xos, Iwr, Xos, Xol, Xol, Xol, Xol, Xol
Xol, Xol, Xol, Xos, Xol, Xos, Xol, Xol, Xol, Xos, Iwr, Iwr, Xos, Xos, Xol, Xos, Xol, Xol, Xol, Xol, Xol, Xol
