border_size=1
usage=map

Md^Xm, Md^Xm, Md^Xm, Md^Xm, Md^Xm, Md, Md, Md, Uh, Uh, Zvw, Zvw, Zvw, Zvw, Zvw, Uh, Uh, Md, Md, Md, Md, Md, Md^Xm, Md^Xm, Md^Xm, Md^Xm, Md^Xm, Md^Xm, Md^Xm, Md, Md^Xm, Md^Xm, Md^Xm, Md^Xm, Md^Xm, Md^Xm, Md^Xm, Md^Xm, Md^Xm, Md^Xm, Md^Xm, Md^Xm, Md^Xm, Md^Xm, Md^Xm, Md^Xm, Md^Xm, Md^Xm, Md^Xm, Md^Xm, Md^Xm, Md^Xm, Md^Xm, Md^Xm, Md^Xm, Md^Xm
Md^Xm, Md^Xm, Md^Xm, Md^Xm, Md, Md, Uh, Uh, Uh, Zvw, Zwsl, Zvw, Zwsl, Zwsl, Uu^Vzps, Uh, Uh, Uh, Uh, Uh, Uh, Md, Uh, Md^Xm, Md, Md^Xm, Md, Md^Xm, Md^Xm, Md^Xm, Md^Xm, Md^Xm, Md^Xm, Md^Xm, Md^Xm, Md^Xm, Md^Xm, Md^Xm, Md^Xm, Md^Xm, Md^Xm, Md^Xm, Md^Xm, Md^Xm, Md^Xm, Md^Xm, Md^Xm, Md^Xm, Md^Xm, Md^Xm, Md^Xm, Md^Xm, Md^Xm, Md^Xm, Md^Xm, Md^Xm
Md^Xm, Md^Xm, Md^Xm, Md, Md, Uh, Uh, Uh, Zvw, Zwsl, Zvw, Zwsl, Zvw, Zwsl, Zwsl, Uu, Uu, Uh, Uu, Uu, Uh^Vzps, Uh, Uh, Uh, Uh, Uh, Uh, Uh, Uh, Md^Xm, Md, Md^Xm, Md, Md^Xm, Md^Xm, Md^Xm, Md^Xm, Md^Xm, Xu, Xu, Xu, Xu, Xu, Xu, Xu, Xu, Xu, Xu, Xu, Xu, Xu, Xu, Xu, Xu, Md^Xm, Md^Xm
Md^Xm, Md^Xm, Md^Xm, Md, Md, Md, Uh, Uh, Zwsl, Zvw^Zewe, Zwsl, Zwsl, Zwsl^Zewt, Zwsl^Zews, Zvw, Zwsl, Zvw, Uu^Zewc, Uh, Uh, Md, Md, Md, Uh, Zwsl, Zwsl, Zvw^Zewc, Uh, Uh, Md, Md, Md, Md, Md, Md, Md^Xm, Md^Xm, Md^Xm, Xu, Xu, Xu, Xu, Cud, Xu, Xu, Xu, Uh, Xu, Uh, Xu, Xu, Xu, Xu, Xu, Md^Xm, Md^Xm
Md^Xm, Md^Xm, Md^Xm, Md, Md, Md, Uh, Uh, Zvw, Zvw, Zvw, Zvw, Zvw, Zwsl, Zwsl, Zwsl^Zewt, Zwsl, Zvw, Uh, Md, Md, Md, Md, Uh, Zwsl^Zewe, Zvw, Zvw, Zvw, Uh, Md, Uh, Md, Md, Md, Md, Md^Xm, Md^Xm, Md^Xm, Xu, Xu, Xu, 2 Kud, Cud, Uu^Uf, Uu, Xu, Ur^Zews, Xu, Ur, Uu, Uu^Uf, Xu, Xu, Xu, Md^Xm, Md^Xm
Md^Xm, Md^Xm, Md^Xm, Md, Md, Md, Uh, Uh, Zwsl, Zvw, Zvw, Zvw, Zvw, Zvw, Zvw, Zvw, Uh, Uh, Md, Md, Md^Xm, Md, Md, Uh, Zvw, Zwsl^Ziff, Zwsl^Ziff, Zwsl, Uh, Uh, Uh^Vzps, Uh, Md, Md, Md^Xm, Md^Xm, Md^Xm, Md^Xm, Xu, Xu, Uu^Uf, Uu^Uf, Uh, Xu, Uh, Ur, Uh, Ur, Xu, Uh, Uu^Uf, Xu, Xu, Xu, Md^Xm, Md^Xm
Md^Xm, Md^Xm, Md^Xm, Md, Md, Md, Uh, Uh, Zwsl^Zews, Zvw, Zvw, Zvw, Zwsl, Zwsl, Zwsl^Zewe, Uh, Md, Md, Md^Xm, Md^Xm, Md, Md, Uh, Uh, Zvw, Zwsl^Ziff, Zwsl^Ziff, Zvw, Zwsl, Zvw, Uh, Uh, Md, Md, Md^Xm, Md^Xm, Md^Xm, Md^Xm, Xu, Xu, Xu, Uu^Uf, Uu^Uf, Uh, Uu, Zgwl, Uh, Uu, Uu^Zewc, Uu, Uu^Uf, Xu, Xu, Xu, Md^Xm, Md^Xm
Md^Xm, Md^Xm, Md^Xm, Md^Xm, Md, Md, Uh, Zwsl, Uh, Uh, Uh, Uh, Uh^Vzps, Uh, Zwsl, Uh, Md, Md, Md^Xm, Md^Xm, Md, Uh, Uh, Uu, Zwsl, Zwsl^Ziff, Zwsl^Ziff, Zwsl^Ziff, Zvw, Zgwl, Zvw, Uh, Md, Md^Xm, Md^Xm, Md^Xm, Md^Xm, Md^Xm, Xu, Xu, Uu^Uf, Uu^Uf, Uh, Xu, Ur, Ur, Xu, Uu, Uu, Uu, Xu, Xu, Xu, Xu, Md^Xm, Md^Xm
Md^Xm, Md^Xm, Md^Xm, Md^Xm, Md, Md, Uh, Uh, Uh, Uh, Md, Uh, Uh, Uh, Zwsl, Uh^Zewc, Uh, Md, Md^Xm, Md, Md, Uh, Uu, Uu, Zvw, Zwsl^Ziff, Zwsl^Ziff, Zwsl^Ziff, Zwsl, Zwsl, Zwsl, Uh, Md, Md, Md, Md^Xm, Md^Xm, Md^Xm, Xu, Xu, Xu, Uu^Uf, Uh, Uu^Vzps, Ur, Xu, Uh, Uh, Uh, Uu^Uf, Xu, Xu, Xu, Xu, Md^Xm, Md^Xm
Md^Xm, Md^Xm, Md^Xm, Md, Md, Md, Md, Md, Md, Md, Md, Md, Uh, Uh, Zvw, Zwsl, Uh, Md, Uh, Md, Uh, Uh, Zwsl, Zwsl, Zwsl^Ziff, Zwsl^Ziff, Zwsl^Ziff, Zwsl^Ziff, Zwsl, Zwsl^Zews, Uu, Uh, Uh, Uh, Md, Md, Md, Md^Xm, Xu, Xu, Xu, Uu^Uf, Xu, Uu, Xu, Ur, Xu, Xu, Xu, Uh, Xu, Xu, Xu, Xu, Md^Xm, Md^Xm
Md^Xm, Md^Xm, Md^Xm, Md^Xm, Md^Xm, Md, Md^Xm, Md, Md^Xm, Md^Xm, Md, Md, Uh, Uh, Zwsl, Zvw, Zvw, Uh, Zvw^Zews, Uh, Zvw, Zvw, Zwsl^Ziff, Zwsl^Ziff, Zwsl^Ziff, Zwsl^Ziff, Zwsl^Ziff, Zwsl, Zvw^Vzps, Zwsl, Uu, Uh, Md, Uh, Md, Md, Md^Xm, Md^Xm, Xu, Xu, Xu, Xu, Xu, Xu, Xu, Uu, Xu, Xu, Xu, Xu, Xu, Xu, Xu, Xu, Md^Xm, Md^Xm
Md^Xm, Md^Xm, Md^Xm, Md^Xm, Md^Xm, Md^Xm, Md^Xm, Md^Xm, Md^Xm, Md, Md, Md, Uh, Uu, Zgwl, Zwsl^Zewt, Zvw, Zvw, Zvw, Zvw, Zwsl^Ziff, Zvw^Zewt, Zwsl^Ziff, Zwsl^Ziff, Zwsl^Ziff, Zwsl^Ziff, Zwsl, Zwsl, Zwsl, Zwsl, Uu, Uh, Uh, Md, Md, Md, Md, Md^Xm, Md^Xm, Xu, Md^Xm, Xu, Md^Xm, Xu, Md^Xm, Zvw, Md^Xm, Xu, Xu, Xu, Md^Xm, Xu, Md^Xm, Xu, Md^Xm, Md^Xm
Md^Xm, Md^Xm, Md^Xm, Md^Xm, Md^Xm, Md^Xm, Md^Xm, Md^Xm, Md, Md, Md, Uh, Uh, Uu^Zewc, Uu, Zvw, Zgwl, Zvw, Zvw^Vzps, Zvw, Zwsl^Ziff, Zwsl^Ziff, Zwsl^Ziff, Zwsl^Ziff, Zwsl^Ziff, Zvw^Zews, Zvw, Zvw, Zvw, Zvw, Uu, Uu^Zewc, Uh, Uh, Md, Md, Md, Md, Md, Md^Xm, Md^Xm, Md^Xm, Md^Xm, Md^Xm, Md, Zvw, Md, Md^Xm, Md^Xm, Md^Xm, Md^Xm, Md^Xm, Md^Xm, Md^Xm, Md^Xm, Md^Xm
Md^Xm, Md^Xm, Md^Xm, Md^Xm, Md^Xm, Md^Xm, Md, Md^Xm, Md, Md, Uh, Uh, Uh, Uu, Zwsl, Zwsl, Zvw, Zwsl^Zewe, Zwsl, Zwsl, Zwsl^Ziff, Zwsl^Ziff, Zwsl^Ziff, Zwsl^Ziff, Zwsl, Zvw, Uh, Uh, Uh, Uh, Uh, Uh, Md, Uh, Uh, Uh, Md, Md, Md, Md, Md, Md, Md, Md, Zvw, Zvw, Md, Md^Xm, Md^Xm, Md^Xm, Md^Xm, Md^Xm, Md^Xm, Md^Xm, Md^Xm, Md^Xm
Md^Xm, Md^Xm, Md^Xm, Md^Xm, Md^Xm, Md^Xm, Md, Md, Uh, Uh, Uh, Uh, Zwsl, Zwsl, Zgwl, Zwsl, Uu, Zwsl, Zvw, Zwsl^Ziff, Zwsl^Ziff, Zvw, Zvw, Zvw, Uh, Uh, Uh, Uh, Md, Md, Md^Xm, Md, Md, Md, Md, Uh, Uh, Uh, Uh, Md, Md, Md, Uh, Md, Zvw, Md, Md, Md^Xm, Md^Xm, Md^Xm, Md^Xm, Md^Xm, Md^Xm, Md^Xm, Md^Xm, Md^Xm
Md^Xm, Md^Xm, Md^Xm, Md^Xm, Md^Xm, Md^Xm, Uh, Uh, Uh, Uh, Uu, Uu^Zewt, Zwsl, Zwsl^Ziff, Zwsl, Uu, Uh, Uu, Zwsl, Zwsl^Ziff, Zwsl, Zwsl, Uu, Uu, Uh, Uh, Md, Md, Md^Xm, Md^Xm, Md^Xm, Md^Xm, Md, Md, Uh, Uh, Uu, Uu^Zews, Uu, Uh, Uh, Uh, Uh, Uh, Zwsl^Zewc, Md, Md, Md^Xm, Md^Xm, Md^Xm, Md^Xm, Md^Xm, Md^Xm, Md^Xm, Md^Xm, Md^Xm
Md^Xm, Md^Xm, Md^Xm, Md^Xm, Md, Uh, Uh, Uh, Zvw, Zwsl, Zwsl^Ziff, Zwsl, Zwsl^Ziff, Zwsl^Ziff, Zwsl, Uu, Uu, Uu^Zewt, Zwsl, Zwsl^Ziff, Zvw, Uu, Uh, Uh, Uh, Md, Md, Md, Md^Xm, Md^Xm, Md^Xm, Md^Xm, Md, Md, Uh, Uh, Zvw, Uu^Vzps, Zvw, Zvw, Zvw, Zvw, Zvw, Zvw, Zwsl, Uh, Uh, Md, Md, Md^Xm, Md^Xm, Md^Xm, Md^Xm, Md^Xm, Md^Xm, Md^Xm
Md^Xm, Md^Xm, Md^Xm, Md, Md, Uh^Vzps, Uh, Zvw, Zwsl^Ziff, Zwsl^Ziff, Zwsl^Ziff, Zwsl^Ziff, Zwsl, Zwsl, Zwsl, Zwsl, Zvw, Zwsl, Zvw, Zvw^Ziff, Zvw, Uh, Uh, Uh, Md, Md, Md^Xm, Md^Xm, Md, Md^Xm, Md, Md, Md, Uh, Zvw, Zvw, Zvw, Zvw, Zvw, Zvw, Zwsl^Ziff, Zwsl^Ziff, Zwsl^Ziff, Zwsl, Zwsl, Uh, Uh, Uh, Md, Md^Xm, Md^Xm, Md^Xm, Md^Xm, Md^Xm, Md^Xm, Md^Xm
Md^Xm, Md^Xm, Md^Xm, Md, Uh, Uh, Uh, Zgwl, Zwsl, Zwsl^Ziff, Zvw, Zwsl^Vzps, Uu, Uu^Zews, Uu, Zwsl^Zewe, Uh, Zvw, Zvw, Zvw, Zvw, Uh^Zewc, Uh, Md, Md, Md^Xm, Md, Md, Md, Md, Md, Md, Uh, Uh, Zwsl, Zvw, Zwsl^Ziff, Zvw^Ziff, Zvw^Ziff, Zwsl^Ziff, Zwsl^Ziff, Zwsl^Ziff, Zwsl^Ziff, Zwsl^Ziff, Zwsl, Zvw, Uh, Uh, Md, Md, Md^Xm, Md^Xm, Md^Xm, Md^Xm, Md^Xm, Md^Xm
Md^Xm, Md^Xm, Md, Md, Uh, Uh, Uh^Zewt, Uh, Uh, Zwsl, Uu, Uu, Uh, Uh, Uh, Uu, Md, Uh, Uh, Zvw, Zwsl, Uh, Uh^Vzps, Md, Md, Md, Uh, Md, Uh, Md, Uh, Uh^Zewt, Uh, Zwsl^Zews, Zwsl, Zwsl, Zwsl^Ziff, Zwsl^Ziff, Zwsl^Ziff, Zwsl^Ziff, Zwsl^Ziff, Zwsl^Ziff, Zwsl^Ziff, Zwsl^Ziff, Zwsl, Zwsl, Uh, Uh, Md, Md, Md, Md^Xm, Md^Xm, Md^Xm, Md^Xm, Md^Xm
Md^Xm, Md^Xm, Md, Md, Uh, Uh, Uh, Uh, Uh, Uh, Uh, Uh, Md, Uh, Md, Md, Md, Md, Uh, Zwsl, Zwsl, Uh, Uh, Md, Uh, Uh^Zewt, Zwsl, Uh, Zwsl, Uh, Zwsl, Uh, Zwsl, Zwsl, Zwsl, Zwsl, Zwsl, Zwsl^Ziff, Zwsl^Ziff, Zwsl^Ziff, Zwsl, Zwsl^Ziff, Zwsl, Zvw, Zwsl, Zwsl, Uh, Uh, Md, Md, Md, Md^Xm, Md^Xm, Md^Xm, Md^Xm, Md^Xm
Md^Xm, Md^Xm, Md^Xm, Md, Md, Uh, Uh, Uh, Md, Md, Md, Uh, Md, Md, Md^Xm, Md^Xm, Md, Uh, Uh, Zgwl, Zwsl, Zwsl^Zewt, Zwsl, Uh, Zwsl^Zewe, Zvw, Zwsl^Zewt, Zwsl, Zwsl^Zewc, Zwsl, Zwsl, Zwsl, Zwsl, Zwsl, Zwsl, Zwsl, Zwsl, Zwsl, Zwsl, Zvw, Zvw, Zwsl^Vzps, Zwsl, Zwsl, Uu, Uu^Zews, Uu, Uh, Md, Md, Md, Md^Xm, Md^Xm, Md^Xm, Md^Xm, Md^Xm
Md^Xm, Md^Xm, Md^Xm, Md, Md, Md, Md, Md, Md, Md, Md^Xm, Md, Md^Xm, Md^Xm, Md^Xm, Md^Xm, Md, Uh, Uh, Uu, Zwsl, Zwsl, Zwsl, Zwsl, Zwsl, Zwsl, Zvw, Zwsl, Zwsl, Zwsl, Zvw, Zvw, Zwsl, Uu^Zewe, Uh, Uh, Uh, Uu^Zews, Zwsl, Zwsl, Zwsl, Zvw, Zvw, Uu, Uu, Uu, Uh, Uh, Md, Md, Md^Xm, Md^Xm, Md^Xm, Md^Xm, Md^Xm, Md^Xm
Md^Xm, Md^Xm, Md^Xm, Md^Xm, Md^Xm, Md, Md^Xm, Md, Md^Xm, Md^Xm, Md^Xm, Md^Xm, Md^Xm, Md^Xm, Md, Md, Uh, Uh^Zewt, Zwsl, Zwsl, Uh, Zwsl^Zews, Uh, Zvw, Uh, Zvw, Uh, Zvw, Zvw, Zwsl, Zvw, Zwsl^Vzps, Zwsl, Uu, Uh, Uh, Uh, Uh, Uh, Uh, Uh, Uh, Uh, Uu, Uh, Uh, Uh, Uh, Md, Md, Md^Xm, Md^Xm, Md^Xm, Md^Xm, Md^Xm, Md^Xm
Md^Xm, Md^Xm, Md^Xm, Md^Xm, Md^Xm, Md^Xm, Md^Xm, Md^Xm, Md^Xm, Md^Xm, Md^Xm, Md^Xm, Md, Md, Md, Md, Uh^Vzps, Zwsl, Uh, Uh^Zewt, Uh, Uh, Md, Uh, Uh, Uh, Uh, Uh, Zvw, Zwsl, Zvw, Zwsl, Zvw^Zewc, Uu, Uh, Md, Md, Uh, Md, Md, Md, Uh, Md, Uh, Uh, Uh, Md, Uh, Md, Md, Md^Xm, Md^Xm, Md^Xm, Md^Xm, Md^Xm, Md^Xm
Md^Xm, Md^Xm, Md^Xm, Md^Xm, Md^Xm, Md^Xm, Md^Xm, Md^Xm, Md^Xm, Md^Xm, Md^Xm, Md^Xm, Md, Md, Uh, Uh, Zwsl^Zewt, Zwsl, Md, Uh, Md, Md, Md, Md, Md, Md, Uh, Uh^Zewt, Zwsl, Zwsl, Zwsl^Ziff, Zvw, Zvw, Uh, Uh, Md, Md^Xm, Md, Md^Xm, Md, Md, Md, Md, Md, Md, Md, Md, Md, Md, Md^Xm, Md^Xm, Md^Xm, Md^Xm, Md^Xm, Md^Xm, Md^Xm
Md^Xm, Md^Xm, Md^Xm, Md^Xm, Md^Xm, Md^Xm, Md^Xm, Md^Xm, Md, Md, Md, Md, Uh, Uh, Uh^Zewt, Uh, Zvw, Uh, Md, Md, Md, Md, Md^Xm, Md^Xm, Md^Xm, Md, Uh, Uh, Zwsl, Zwsl^Ziff, Zwsl^Ziff, Zwsl, Zwsl, Zvw, Uh, Md, Md^Xm, Md^Xm, Md^Xm, Md^Xm, Md^Xm, Md, Md^Xm, Md, Md, Md, Md, Md, Md^Xm, Md^Xm, Md^Xm, Md^Xm, Md^Xm, Md^Xm, Md^Xm, Md^Xm
Md^Xm, Md^Xm, Md^Xm, Md^Xm, Md^Xm, Md^Xm, Md^Xm, Md, Md, Md, Uh, Md, Zwsl, Zvw, Zvw, Zvw, Uh, Uh^Zewt, Md, Md, Md^Xm, Md^Xm, Md^Xm, Md^Xm, Md, Md, Uh, Zwsl, Zwsl, Zwsl^Ziff, Zwsl^Ziff, Zvw, Zwsl, Uh, Uh, Md, Md, Md^Xm, Md^Xm, Md^Xm, Md^Xm, Md^Xm, Md^Xm, Md^Xm, Md^Xm, Md, Md, Md, Md^Xm, Md^Xm, Md^Xm, Md^Xm, Md^Xm, Md^Xm, Md^Xm, Md^Xm
Md^Xm, Md^Xm, Md^Xm, Md^Xm, Md^Xm, Md^Xm, Md, Md, Uh, Uh^Zewt, Zwsl, Zwsl^Vzps, Uh, Uh, Uh, Zwsl^Zewe, Zwsl, Uh, Md, Md^Xm, Md^Xm, Md^Xm, Md, Md, Uh, Uh, Uu, Zwsl^Zews, Zwsl, Zwsl^Ziff, Zwsl^Ziff, Zwsl, Zwsl^Zewc, Uh, Uh, Uh, Md, Md, Md^Xm, Md^Xm, Md, Md^Xm, Md^Xm, Md^Xm, Md^Xm, Md^Xm, Md^Xm, Md^Xm, Md^Xm, Md^Xm, Md^Xm, Md^Xm, Md^Xm, Md^Xm, Md^Xm, Md^Xm
Md^Xm, Md^Xm, Md^Xm, Md^Xm, Md^Xm, Md^Xm, Md, Md, Zwsl, Zwsl^Zewt, Uh, Zwsl, Md, Md, Md, Uh, Zwsl, Md, Uh, Md, Md, Md, Uh, Uh, Uh, Uh, Uu^Vzps, Zwsl, Zwsl, Zwsl, Zwsl, Zwsl, Zwsl, Zwsl, Uh, Uh, Uh, Md, Uh, Md, Md, Md^Xm, Md^Xm, Md^Xm, Md^Xm, Md^Xm, Md^Xm, Md^Xm, Md^Xm, Md^Xm, Md^Xm, Md^Xm, Md^Xm, Md^Xm, Md^Xm, Md^Xm
Md^Xm, Md^Xm, Md^Xm, Md^Xm, Md^Xm, Md, Md, Uh, Uh, Zwsl, Md, Uh, Md, Md, Md, Uh, Uh, Zwsl, Uh, Uh, Uh, Uh, Uh, Uh, Uu, Uu, Zwsl, Zwsl, Zwsl, Zvw^Zewt, Zvw, Zwsl, Zvw, Zgwl, Zwsl, Zwsl, Uu, Uu, Uh, Md, Md, Md, Md, Md^Xm, Md^Xm, Md^Xm, Md^Xm, Md^Xm, Md^Xm, Md^Xm, Md^Xm, Md^Xm, Md^Xm, Md^Xm, Md^Xm, Md^Xm
Md^Xm, Md^Xm, Md^Xm, Md^Xm, Md^Xm, Md, Md, Md, Md, Md, Md, Md, Md^Xm, Md^Xm, Md, Md, Uh, Zwsl, Zwsl, Zgwl, Zwsl^Vzps, Zwsl, Zwsl, Zwsl, Zwsl, Zwsl, Zwsl^Ziff, Zwsl, Zwsl, Zwsl, Zwsl, Zwsl, Zwsl, Zwsl, Zvw, Zwsl, Zvw, Uu^Zewc, Zwsl, Uh, Uh, Md, Md, Md, Md, Md^Xm, Md^Xm, Md^Xm, Md^Xm, Md^Xm, Md^Xm, Md^Xm, Md^Xm, Md^Xm, Md^Xm, Md^Xm
Md^Xm, Md^Xm, Md^Xm, Md^Xm, Md^Xm, Md^Xm, Md^Xm, Md, Md, Md, Md^Xm, Md^Xm, Md^Xm, Md^Xm, Md, Md, Uh, Uh, Zwsl^Zews, Zwsl, Zwsl, Zwsl, Zwsl, Zwsl, Zwsl^Ziff, Zwsl^Ziff, Zwsl^Ziff, Zwsl, Zgwl, Zwsl, Zwsl, Zwsl, Zwsl, Zwsl, Zwsl, Zwsl, Zwsl, Zwsl, Uu, Uh, Uh, Uh, Uh, Md, Md, Md^Xm, Md^Xm, Md^Xm, Md^Xm, Md^Xm, Md^Xm, Md^Xm, Md^Xm, Md^Xm, Md^Xm, Md^Xm
Md^Xm, Md^Xm, Md^Xm, Md^Xm, Md^Xm, Md^Xm, Md^Xm, Md^Xm, Md^Xm, Md^Xm, Md^Xm, Md^Xm, Md, Md, Uh, Md, Uh, Uh, Zwsl, Zwsl, Zwsl^Ziff, Zwsl^Ziff, Zwsl^Ziff, Zwsl^Ziff, Zwsl^Ziff, Zwsl^Ziff, Zwsl^Ziff, Zwsl, Zwsl, Zwsl, Zwsl, Uu^Zews, Uu, Zwsl, Zwsl, Zwsl^Vzps, Zvw, Zwsl, Zvw, Uu, Uu, Uh, Uh, Uh, Md, Md, Md, Md^Xm, Md^Xm, Md^Xm, Md^Xm, Md^Xm, Md^Xm, Md^Xm, Md^Xm, Md^Xm
Md^Xm, Md^Xm, Md^Xm, Md^Xm, Md^Xm, Md^Xm, Md^Xm, Md^Xm, Md^Xm, Md^Xm, Md, Md, Uh, Md, Uh, Uh^Zewt, Zvw, Zvw^Zewt, Zwsl^Ziff, Zwsl^Ziff, Zwsl^Ziff, Zwsl^Ziff, Zwsl^Ziff, Zwsl^Ziff, Zwsl^Ziff, Zwsl^Ziff, Zwsl^Zewe, Zwsl, Zvw, Zwsl, Uu, Uu, Uu, Uu, Uu, Uu, Uu, Zvw, Zwsl, Zwsl^Zews, Zwsl, Uu^Zewt, Zwsl, Uh, Uh, Md, Md, Md^Xm, Md^Xm, Md^Xm, Md^Xm, Md^Xm, Md^Xm, Md^Xm, Md^Xm, Md^Xm
Md^Xm, Md^Xm, Md^Xm, Md^Xm, Md^Xm, Md^Xm, Md^Xm, Md^Xm, Md, Md, Md, Md, Uh, Uh, Zwsl, Zvw, Zwsl, Zvw, Zwsl^Ziff, Zvw^Ziff, Uu^Ziff, Zwsl^Ziff, Zwsl^Ziff, Zwsl^Ziff, Zwsl, Zwsl, Zwsl^Vzps, Zwsl, Zwsl, Zwsl, Zwsl, Uu^Zewt, Uh, Uh, Uh, Uh, Uh, Uh, Uh, Uu, Zwsl, Zwsl, Zwsl, Uu^Zewc, Uu, Uh, Uh, Md, Md, Md^Xm, Md^Xm, Md^Xm, Md^Xm, Md^Xm, Md^Xm, Md^Xm
Md^Xm, Md^Xm, Md^Xm, Md^Xm, Md^Xm, Md^Xm, Md^Xm, Md^Xm, Md, Md, Uh, Uh, Zwsl, Zvw, Zvw, Zwsl^Vzps, Zgwl, Uu, Uu^Ziff, Uu^Ziff, Uu^Ziff, Uu^Ziff, Zwsl^Ziff, Zwsl^Ziff, Zwsl^Zewc, Zwsl, Zwsl, Zwsl, Uu^Zewt, Uh, Uh, Uh, Md, Uh, Md, Uh^Zewt, Uh, Md, Md, Uh, Uh, Zwsl, Zwsl, Zwsl, Zwsl, Uh, Uh, Md, Md, Md, Md, Md^Xm, Md^Xm, Md^Xm, Md^Xm, Md^Xm
Md^Xm, Md^Xm, Md^Xm, Md^Xm, Md^Xm, Md^Xm, Md^Xm, Md^Xm, Md, Md, Uh, Zwsl, Zwsl, Zwsl^Zews, Zwsl, Zwsl, Zwsl^Ziff, Uu^Ziff, Uu^Ziff, Uu^Ziff, Uu^Ziff, Zwsl^Ziff, Zwsl^Ziff, Zwsl, Zwsl, Zwsl, Uu, Uu, Uh, Uh, Md, Md, Md, Md, Md, Md, Md, Md, Uh, Uh, Zwsl, Zwsl, Zwsl^Ziff, Zwsl, Zwsl^Vzps, Zwsl, Uh, Uh, Uh, Md, Md, Md^Xm, Md^Xm, Md^Xm, Md^Xm, Md^Xm
Md^Xm, Md^Xm, Md^Xm, Md^Xm, Md^Xm, Md^Xm, Md^Xm, Md^Xm, Md^Xm, Md, Zwsl, Zwsl, Uh, Zwsl, Zwsl, Zwsl, Zwsl^Ziff, Zwsl^Ziff, Zwsl^Ziff, Zwsl^Ziff, Zwsl, Zwsl^Zewe, Zwsl, Zwsl, Uh, Uh, Uh, Uh, Md, Md, Md, Md, Md, Md, Md^Xm, Md, Md, Md, Uh, Uh, Zwsl, Zwsl, Zwsl^Ziff, Zwsl^Ziff, Zvw, Zvw, Uu, Uh, Uh, Uh, Md, Md^Xm, Md^Xm, Md^Xm, Md^Xm, Md^Xm
Md^Xm, Xu, Xu, Xu, Xu, Xu, Xu, Xu, Xu, Md^Xm, Zwsl, Md, Md, Uh, Uh, Uh, Uh, Zvw, Zvw, Zvw, Zwsl, Zwsl, Uh^Zewt, Uh, Uh, Md, Md, Md, Md, Md, Md, Md^Xm, Md^Xm, Md^Xm, Md^Xm, Md^Xm, Md, Md, Uh, Uh, Zvw, Zvw, Zvw, Zvw, Zvw, Zvw, Uu, Uu^Zewe, Uh, Uh, Uh, Md, Md, Md^Xm, Md^Xm, Md^Xm
Md^Xm, Xu, Xu, Xu, Uh, Xu, Xu, Xu, Zwsl, Zwsl, Xu, Md^Xm, Md^Xm, Md, Md, Uh, Uh^Zewt, Uh, Uh, Zvw^Vzps, Uh, Uh, Uh, Uh, Md, Md, Md, Md, Md^Xm, Md^Xm, Md^Xm, Md^Xm, Md, Md^Xm, Md, Md, Md, Md, Uh, Uh, Zwsl, Zvw, Zwsl, Zvw, Zwsl, Zwsl^Zewc, Zvw, Zvw, Uh, Uh, Md, Md, Md, Md^Xm, Md^Xm, Md^Xm
Md^Xm, Xu, Xu, Uh, Uu, Uh, Uh, Zwsl, Xu, Xu, Xu, Md^Xm, Md^Xm, Md, Md, Md, Md, Uh, Uh, Uh, Uh, Uh, Md, Md, Md, Md, Md^Xm, Md^Xm, Md^Xm, Md^Xm, Md, Md, Md, Md, Md, Md, Uh, Uh, Uh, Zwsl, Zwsl^Zews, Zwsl, Zgwl, Zvw, Zwsl^Zewt, Zwsl, Zwsl, Zwsl^Zewt, Zwsl, Uh, Uh^Zewt, Md, Md, Md, Md^Xm, Md^Xm
Md^Xm, Xu, Uu^Uf, Uu, Uu^Vzps, Uh^Zewc, Ur, Ur^Zewt, Uh, Uh, Xu, Md^Xm, Md^Xm, Md^Xm, Md^Xm, Md, Md, Md, Uh, Uh, Md, Md, Md, Md, Md, Md, Md^Xm, Md^Xm, Md, Md, Md, Md, Uh, Uh, Uh, Uh, Uh, Uh, Zwsl, Zwsl, Zwsl, Zwsl, Zwsl, Zwsl, Zwsl, Zwsl, Zwsl, Zwsl, Zwsl^Vzps, Zwsl, Uh, Uh, Md, Md, Md^Xm, Md^Xm
Md^Xm, Xu, Uu^Uf, Xu, Uh, Ur, Xu, Uh^Zewc, Uu, Xu, Xu, Md^Xm, Md^Xm, Md^Xm, Md^Xm, Md, Md, Md, Md, Md, Md, Md, Md, Md, Md^Xm, Md^Xm, Md^Xm, Md^Xm, Md, Md, Md, Md, Uh, Uh, Uu^Zewt, Uh, Zwsl, Zvw, Zwsl, Zvw^Zewe, Zvw, Zwsl, Zvw, Zwsl, Zwsl, Zwsl, Zwsl, Uu, Uu, Uu, Uh, Uh, Md, Md, Md^Xm, Md^Xm
Md^Xm, Xu, Xu, Uu^Uf, Ur^Zews, Ur, Xu, Xu, Uu^Uf, Xu, Xu, Md^Xm, Md^Xm, Md^Xm, Md^Xm, Md^Xm, Md^Xm, Md, Md, Md, Md, Md, Md^Xm, Md^Xm, Md^Xm, Md^Xm, Md^Xm, Md, Md, Md, Md, Uh, Uh, Uu, Zwsl, Zwsl, Zwsl^Vzps, Zwsl, Zwsl, Zwsl, Zvw, Zvw^Zews, Zvw, Zvw, Zvw, Zwsl, Uu, Uu, Uh, Uh, Md, Md, Md, Md, Md^Xm, Md^Xm
Md^Xm, Xu, Uh^Zewe, Uu, Ur, Uu, Xu, Xu, Uu^Uf, Uu^Uf, Xu, Md^Xm, Md^Xm, Md^Xm, Md^Xm, Md^Xm, Md^Xm, Md^Xm, Md^Xm, Md^Xm, Md^Xm, Md^Xm, Md^Xm, Md^Xm, Md^Xm, Md^Xm, Md^Xm, Md, Md, Md, Md, Uh, Uh, Uu^Zewt, Zwsl, Zwsl, Zwsl, Zwsl, Zwsl, Zwsl, Zwsl, Zwsl, Zwsl, Zvw, Zwsl, Zwsl, Uu, Uh^Zewt, Uh, Uh, Md, Md, Md^Xm, Md^Xm, Md^Xm, Md^Xm
Md^Xm, Xu, Uh, Ur, Uh, Uu, Uu, Uu^Uf, Uu^Uf, Xu, Xu, Md^Xm, Md^Xm, Md^Xm, Md^Xm, Md^Xm, Md^Xm, Md^Xm, Md^Xm, Md^Xm, Md^Xm, Md^Xm, Md^Xm, Md^Xm, Md^Xm, Md^Xm, Md^Xm, Md, Md, Md, Md, Md, Md, Uh, Uh, Zwsl, Zwsl, Zwsl, Zwsl, Zwsl, Zvw, Zwsl, Zvw, Zwsl, Uh, Uu, Uh, Uh, Md, Md, Md, Md, Md^Xm, Md^Xm, Md^Xm, Md^Xm
Md^Xm, Xu, Xu, Uh, Xu, Uh, Uh, Uu^Uf, Xu, Xu, Xu, Md^Xm, Md^Xm, Md^Xm, Md^Xm, Md^Xm, Md^Xm, Md^Xm, Md^Xm, Md^Xm, Md^Xm, Md^Xm, Md^Xm, Md^Xm, Md^Xm, Md^Xm, Md^Xm, Md, Md, Md, Md, Md, Md, Uh, Uh, Uh, Zvw, Zwsl, Zvw, 1 Zvw, Zvw, Zvw, Zvw, Zvw, Uh, Uh, Md, Md, Md, Md, Md^Xm, Md, Md^Xm, Md^Xm, Md^Xm, Md^Xm
Md^Xm, Xu, Xu, Xu, Xu, Xu, Xu, Xu, Xu, Xu, Xu, Md^Xm, Md^Xm, Md^Xm, Md^Xm, Md^Xm, Md^Xm, Md^Xm, Md^Xm, Md^Xm, Md^Xm, Md^Xm, Md^Xm, Md^Xm, Md^Xm, Md^Xm, Md^Xm, Md^Xm, Md^Xm, Md, Md, Md, Md, Md, Md, Uh, Zwsl, Zwsl, Zwsl, Zwsl, Zwsl, Zwsl, Zwsl, Uh, Md, Md, Md, Md, Md^Xm, Md^Xm, Md^Xm, Md^Xm, Md^Xm, Md^Xm, Md^Xm, Md^Xm
Md^Xm, Md^Xm, Md^Xm, Md^Xm, Md^Xm, Md^Xm, Md^Xm, Md^Xm, Md^Xm, Md^Xm, Md^Xm, Md^Xm, Md^Xm, Md^Xm, Md^Xm, Md^Xm, Md^Xm, Md^Xm, Md^Xm, Md^Xm, Md^Xm, Md^Xm, Md^Xm, Md^Xm, Md^Xm, Md^Xm, Md^Xm, Md^Xm, Md^Xm, Md^Xm, Md, Md, Md, Md, Md, Uh, Uh, Zvw, Zvw, Zvw, Zvw, Zvw, Zvw, Uh, Md, Md, Md^Xm, Md^Xm, Md^Xm, Md^Xm, Md^Xm, Md^Xm, Md^Xm, Md^Xm, Md^Xm, Md^Xm
