border_size=1
usage=map

Ha^Fda      , Aa^Fda      , Aa^Fda      , Gd          , Gd          , Gd          , Ha^Fda      , Ha^Fda      , Ha^Fda      , Ms          , Ms          , Ms          , Ms^Fda      , Ms^Xm       , Ms^Xm       , Ms^Xm       , Ms^Xm       , Ms^Xm       , Ms^Xm       , Ms^Xm       , Ms^Xm       , Ms^Xm       , Ms^Xm       , Ms^Xm       , Ms^Xm       , Ms^Xm       , Ms^Xm       , Ms^Xm       , Ms^Xm       , Ms^Xm       , Ms^Xm       , Ms^Xm       , Ms^Xm       , Ms^Xm       , Ms^Xm       , Ms          , Ms^Xm       , Ms^Xm       , Ms^Xm       , Ms^Xm       , Ms^Xm       , Ms^Xm       , Ha^Fda      , Ha^Fda      , Aa          , Aa          
Aa^Fda      , Ha^Fda      , Ha^Fda      , Aa^Fda      , Cha         , 4 Kha       , Cha         , Cha         , Ha^Fda      , Ms          , Ms^Fda      , Ms          , Ai          , Ms          , Ms^Fda      , Ms^Xm       , Ms^Xm       , Ms^Xm       , Ms^Xm       , Ms^Xm       , Ms^Xm       , Ms^Xm       , Ms^Xm       , Ms^Xm       , Ms^Xm       , Ms^Xm       , Ms^Xm       , Ms^Xm       , Ms^Xm       , Ms^Xm       , Ms^Xm       , Ms^Xm       , Ms^Fda      , Ms^Xm       , Ms          , Ms          , Ms          , Ms          , Ms^Xm       , Ms^Xm       , Ha^Fda      , Ha^Fda      , Ha^Fda      , Ha^Fda      , Aa          , Aa          
Aa^Fda      , Ha^Fda      , Ha^Fda      , Ha^Fda      , Ha^Fda      , Cha         , Cha         , Cha         , Aa^Fda      , Ha^Fda      , Aa^Fda      , Ms^Fda      , Ai          , Ms^Fda      , Ms          , Ms^Xm       , Ms^Fda      , Ms^Xm       , Ms^Xm       , Ms^Xm       , Ms^Xm       , Ms^Xm       , Ms^Xm       , Ms^Xm       , Ms^Xm       , Ms^Xm       , Ms          , Ms^Xm       , Ms          , Ms          , Ms^Xm       , Ms          , Ms          , Ms          , Ha^Fda      , Ms          , Ha^Fda      , Ha^Fda      , Ha^Fda      , Ha^Fda      , Aa          , Aa          , Gd          , 1 Aa        , Aa          , Aa          
Gd          , Aa^Fda      , Aa^Fda      , Ha^Fda      , Ms          , Ha^Fda      , Ha^Fda      , Aa^Fda      , Aa^Fda      , Aa^Fda      , Aa^Fda      , Ha^Fda      , Ai          , Ms^Fda      , Ms          , Ms          , Ms          , Ms          , Ms          , Ms^Xm       , Ms^Xm       , Ms^Xm       , Ms^Xm       , Ms^Xm       , Ms^Xm       , Ms^Xm       , Ms          , Ms          , Ms^Fda      , Ms^Fda      , Ha^Fda      , Ha^Fda      , Ha^Fda      , Ha^Fda      , Aa          , Aa          , Aa          , Gd          , Gd^Es       , Gd          , Gd          , Gd          , Gd^Es       , Gd          , Ha^Fda      , Aa          
Gd          , Aa^Fda      , Aa^Fda      , Ha^Fda      , Ms          , Ms^Fda      , Ms          , Ha^Fda      , Ha^Fda      , Aa^Fda      , Aa^Fda      , Ai          , Aa^Fda      , Ha^Fda      , Ha^Fda      , Ms^Fda      , Ms^Fda      , Ms^Fda      , Ms          , Ms^Xm       , Ms^Xm       , Ms^Xm       , Ms^Xm       , Ms^Xm       , Ms^Xm       , Ms          , Ms          , Ms^Fda      , Ha^Fda      , Ha^Fda      , Ha^Fda      , Aa          , Aa          , Gd          , Gd          , Gd          , Aa          , Gd          , Aa          , Aa          , Gd^Vht      , Gd          , Gd          , Aa          , Ha^Fda      , Ha^Fda      
Gd          , Gd          , Aa^Fda      , Ha^Fda      , Ms          , Ms^Fda      , Ms^Fda      , Ms          , Ha^Fda      , Ha^Fda      , Aa          , Ai          , Aa          , Aa          , Ha^Fda      , Ms          , Ha^Fda      , Ha^Fda      , Ms^Fda      , Ms^Fda      , Ms          , Ms^Xm       , Ms^Xm       , Ms^Xm       , Ms^Fda      , Ms^Fda      , Ms          , Ha^Fda      , Aa          , Aa          , Gd          , Gd          , Gd          , Gd          , Gd          , Gd^Es       , Aa^Fda      , Aa          , Aa^Fda      , Aa^Fda      , Gd          , Aa          , Aa          , Ha^Fda      , Ms^Fda      , Ha^Fda      
Gd          , Gd^Es       , Aa^Fda      , Ha^Fda      , Ai          , Ai          , Ms^Fda      , Ms          , Ha^Fda      , Aa^Vla      , Ha^Fda      , Ai          , Wog         , Aa          , Aa          , Ha^Fda      , Ha^Fda      , Ha^Fda      , Ms          , Ms          , Ms^Fda      , Ms^Xm       , Ms^Xm       , Ms^Xm       , Ms^Fda      , Ms          , Ms^Fda      , Ha^Fda      , Aa          , Aa          , Gd^Es       , Gd          , Gd          , Gd^Vht      , Gd          , Gd          , Aa          , Aa^Fda      , Aa^Fda      , Aa^Fda      , Gd          , Aa          , Ha^Fda      , Ms          , Ms          , Ms^Xm       
Gd          , Gd          , Ai          , Ai          , Ha^Fda      , Ms          , Ms          , Ms^Fda      , Ms          , Ha^Fda      , Aa^Fda      , Aa          , Ai          , Aa          , Aa          , Aa          , Aa          , Ha^Fda      , Ha^Fda      , Ms^Fda      , Ms          , Ms          , Ms^Xm       , Ms^Xm       , Ms          , Ms          , Ha^Fda      , Aa          , Aa          , Gd          , Gd          , Gd          , Aa          , Aa          , Aa^Fda      , Gd          , Gd          , Aa          , Aa          , Gd          , Gd          , Aa          , Ha^Fda      , Ms          , Ms          , Ms^Xm       
Gd          , Gd          , Ai          , Aa^Fda      , Aa^Fda      , Ha^Fda      , Ha^Fda      , Ms          , Ms          , Ha^Fda      , Ha^Fda      , Aa^Fda      , Gd          , Ai          , Ai          , Gd^Es       , Gd^Vht      , Aa          , Ha^Fda      , Ms          , Ms          , Ms          , Ms^Xm       , Ms^Xm       , Ms^Xm       , Ms^Fda      , Ms^Fda      , Ha^Fda      , Aa          , Gd          , Gd          , Gd          , Aa^Fda      , Aa^Fda      , Aa^Fda      , Aa^Fda      , Gd^Es       , Gd          , Gd          , Gd          , Ha^Fda      , Ha^Fda      , Ms          , Ha^Fda      , Ms^Xm       , Ms^Xm       
Gd          , Gd          , Ai          , Aa          , Aa^Fda      , Aa^Fda      , Ha^Fda      , Ha^Fda      , Ms          , Ha^Fda      , Ha^Fda      , Aa^Fda      , Aa^Fda      , Gd          , Gd          , Ai          , Gd          , Aa          , Ha^Fda      , Ms^Fda      , Ms^Fda      , Ms^Fda      , Ms^Xm       , Ms^Xm       , Ms^Xm       , Ms          , Ms          , Ms^Fda      , Aa          , Gd          , Gd          , Aa          , Aa^Fda      , Aa^Fda      , Aa          , Aa^Fda      , Gd          , Gd          , Gd          , Aa          , Ha^Fda      , Ms^Fda      , Ms          , Ms^Xm       , Ms^Xm       , Ms^Xm       
Gd          , Ai          , Gd^Vht      , Aa          , Aa          , Aa^Fda      , Aa^Fda      , Ha^Fda      , Ha^Fda      , Aa^Vla      , Ha^Fda      , Ha^Fda      , Aa^Fda      , Gd^Es       , Gd          , Ai          , Aa          , Ha^Fda      , Ha^Fda      , Ms^Fda      , Ms^Fda      , Ms^Fda      , Ms^Fda      , Ms^Xm       , Ms^Xm       , Ms^Xm       , Ms          , Ha^Fda      , Gd          , Gd          , Gd          , Aa          , Gd          , Aa^Fda      , Gd          , Aa          , Gd          , Gd          , Aa          , Aa          , Ms          , Ms          , Ha^Fda      , Ms          , Ms^Xm       , Ms^Xm       
Gd          , Ai          , Gd          , Gd^Es       , Aa          , Aa          , Aa          , Aa^Fda      , Aa^Fda      , Ha^Fda      , Aa^Fda      , Aa^Fda      , Aa^Fda      , Aa^Fda      , Gd          , Ai          , Aa^Fda      , Aa          , Aa          , Ha^Fda      , Aa^Vla      , Ms^Fda      , Ms          , Ms^Xm       , Ms^Xm       , Ms^Xm       , Ms          , Ha^Fda      , Cha         , Gd          , Gd          , Gd^Es       , Gd          , Gd          , Gd          , Gd^Es       , Gd          , Gd^Vht      , Aa          , Ha^Fda      , Ha^Fda      , Ms^Fda      , Ms^Fda      , Ms          , Ms^Xm       , Ms^Xm       
Gd          , Ai          , Ai          , Aa          , Ha^Fda      , Aa          , Ha^Fda      , Ha^Fda      , Ha^Fda      , Aa^Fda      , Aa^Fda      , Aa^Fda      , Gd          , Aa^Fda      , Gd          , Ai          , Aa^Fda      , Aa          , Aa          , Aa^Fda      , Ha^Fda      , Ha^Fda      , Ms^Fda      , Ms^Xm       , Ms^Xm       , Ms^Xm       , Ms          , Cha         , Cha         , Cha         , Gd          , Gd          , Aa          , Aa          , Aa          , Gd          , Aa          , Ha^Fda      , Ha^Fda      , Ms          , Ha^Fda      , Ms^Fda      , Ha^Fda      , Ms^Xm       , Ms^Xm       , Ms^Xm       
Gd          , Gd          , Ai          , Aa          , Ha^Fda      , Ha^Fda      , Ms          , Ms^Fda      , Ha^Fda      , Ha^Fda      , Aa^Fda      , Aa^Fda      , Gd          , Gd          , Gd^Es       , Ai          , Aa^Fda      , Aa^Fda      , Gd          , Aa^Fda      , Aa^Fda      , Ha^Fda      , Ha^Fda      , Ms^Xm       , Ms^Fda      , Ms^Fda      , Ha^Fda      , Cha         , 2 Kha       , Cha         , Ha^Fda      , Aa          , Ha^Fda      , Ha^Fda      , Ms^Fda      , Ha^Fda      , Ha^Fda      , Ha^Fda      , Ha^Fda      , Ms^Fda      , Ha^Fda      , Ms^Fda      , Ms^Xm       , Ms^Xm       , Ms^Xm       , Ms^Xm       
Gd          , Gd^Es       , Ai          , Aa          , Ha^Fda      , Ms          , Ms^Fda      , Ms^Fda      , Ha^Fda      , Aa          , Gd          , Gd          , Gd^Vht      , Gd          , Gd          , Ai          , Gd          , Gd          , Gd          , Aa^Fda      , Aa          , Ha^Fda      , Ha^Fda      , Ha^Fda      , Ha^Fda      , Ha^Fda      , Gd          , Cha         , Cha         , Cha         , Ms          , Ha^Fda      , Ms^Xm       , Ms^Xm       , Ms^Xm       , Ms^Xm       , Ms^Xm       , Ms^Xm       , Ms^Xm       , Ms^Xm       , Ms^Xm       , Ms^Xm       , Ms^Xm       , Ms^Xm       , Ms^Xm       , Ms^Xm       
Gd          , Gd          , Ai          , Aa^Fda      , Ha^Fda      , Ms          , Ms^Fda      , Ms          , Aa^Vla      , Aa          , Gd          , Gd          , Gd          , Gd          , Gd          , Ai          , Gd          , Gd^Es       , Gd          , Gd          , Gd^Vht      , Aa          , Aa          , Aa^Fda      , Aa^Fda      , Aa^Fda      , Gd          , Gd          , Ha^Fda      , Ms^Fda      , Ms^Xm       , Ms^Xm       , Ms^Xm       , Ms^Xm       , Ms^Xm       , Ms^Xm       , Ms^Xm       , Ms^Xm       , Ms^Xm       , Ms^Xm       , Ms^Xm       , Ms^Xm       , Ms^Xm       , Ms^Xm       , Ms^Xm       , Ms^Xm       
Gd          , Ai          , Cha         , Aa^Fda      , Ha^Fda      , Ms          , Ms^Fda      , Ms^Fda      , Ha^Fda      , Aa          , Gd          , Gd          , Gd^Es       , Gd          , Ai          , Ai          , Ai          , Gd          , Gd          , Gd          , Gd          , Gd          , Gd          , Aa          , Gd          , Gd          , Gd^Es       , Aa          , Ha^Fda      , Ms^Fda      , Ms^Fda      , Ms^Fda      , Ms^Fda      , Ms          , Ms          , Ms^Xm       , Ms^Fda      , Ms^Fda      , Ms          , Ms^Xm       , Ms^Xm       , Ms^Xm       , Ms^Xm       , Ms^Xm       , Ms^Xm       , Ms^Xm       
Gd          , Ai          , 5 Kha       , Cha         , Cha         , Ms^Fda      , Ha^Fda      , Ha^Fda      , Ha^Fda      , Aa          , Gd          , Gd          , Ai          , Ai          , Gd          , Gd          , Gd          , Ai          , Ai          , Gd          , Gd          , Gd          , Gd          , Gd^Es       , Gd          , Gd          , Gd          , Aa          , Ha^Fda      , Ha^Fda      , Aa^Vla      , Ms^Fda      , Ms^Fda      , Ms          , Ms^Fda      , Ms^Fda      , Ms^Fda      , Ms          , Ms          , Ms          , Ms          , Ms          , Ms          , Ms^Xm       , Ms^Xm       , Ms^Xm       
Ha^Fda      , Ai          , Ai          , Cha         , Cha         , Ms^Fda      , Ha^Fda      , Aa          , Aa          , Aa          , Gd          , Gd          , Ai          , Gd          , Gd^Es       , Gd          , Aa          , Aa          , Aa          , Ai          , Ai          , Ai          , Ai          , Gd          , Gd          , Gd^Vht      , Gd          , Aa          , Aa          , Ha^Fda      , Ha^Fda      , Ha^Fda      , Ha^Fda      , Ha^Fda      , Ha^Fda      , Ha^Fda      , Ha^Fda      , Ms^Fda      , Ms^Fda      , Ms^Fda      , Ms^Fda      , Ms          , Ms^Fda      , Ms          , Ms^Fda      , Ms^Xm       
Ms^Fda      , Ha^Fda      , Ha^Fda      , Ai          , Ai          , Ha^Fda      , Ai          , Ha^Fda      , Aa          , Aa          , Ai          , Gd          , Ai          , Gd          , Gd          , Gd          , Aa          , Aa          , Ha^Fda      , Aa          , Aa          , Aa          , Aa          , Ai          , Ai          , Gd          , Gd          , Aa          , Aa          , Aa^Fda      , Aa^Fda      , Aa^Fda      , Ha^Fda      , Ha^Fda      , Aa^Fda      , Ha^Fda      , Ha^Fda      , Ha^Fda      , Ha^Fda      , Aa^Vla      , Ha^Fda      , Ms^Fda      , Ms          , Ms^Fda      , Ms^Fda      , Ms          
Ms^Fda      , Ms          , Ha^Fda      , Ha^Fda      , Ha^Fda      , Ai          , Aa^Fda      , Ai          , Ai          , Ai          , Gd          , Ai          , Gd          , Ai          , Gd          , Gd          , Gd          , Aa          , Aa          , Ha^Fda      , Ha^Fda      , Aa          , Aa          , Gd          , Gd          , Ai          , Ai          , Gd          , Gd^Es       , Aa          , Gd          , Aa          , Gd          , Aa          , Aa          , Aa^Fda      , Ha^Fda      , Ha^Fda      , Ha^Fda      , Ha^Fda      , Ha^Fda      , Ha^Fda      , Ha^Fda      , Ms^Fda      , Ms^Fda      , Ms          
Ms^Xm       , Ms^Fda      , Ms          , Ha^Fda      , Ha^Fda      , Ha^Fda      , Aa^Fda      , Aa^Fda      , Aa^Fda      , Gd          , Gd          , Gd^Es       , Gd          , Ai          , Gd          , Gd^Es       , Gd          , Gd          , Aa^Fda      , Aa^Fda      , Ha^Fda      , Ha^Fda      , Ha^Fda      , Aa          , Aa          , Gd          , Gd          , Ai          , Ai          , Gd          , Gd          , Gd^Es       , Gd          , Gd^Vht      , Gd          , Aa          , Aa          , Ha^Fda      , Aa^Fda      , Ha^Fda      , Aa^Fda      , Ha^Fda      , Ha^Fda      , Ha^Fda      , Ha^Fda      , Ha^Fda      
Ms^Xm       , Ms^Fda      , Ms          , Ms          , Ms^Fda      , Ha^Fda      , Ha^Fda      , Aa^Fda      , Ha^Fda      , Aa^Fda      , Aa^Fda      , Gd          , Gd          , Ai          , Gd          , Gd          , Gd^Vht      , Gd          , Aa^Fda      , Ha^Fda      , Aa^Vla      , Ha^Fda      , Ha^Fda      , Aa^Fda      , Aa          , Gd^Es       , Gd^Vht      , Gd          , Gd          , Ai          , Wog^Es      , Gd          , Ai          , Gd          , Gd          , Aa          , Gd          , Aa          , Aa          , Aa          , Aa          , Aa          , Cha         , Aa^Fda      , Aa^Fda      , Ha^Fda      
Ms^Xm       , Ms^Xm       , Ms^Xm       , Ms          , Ms          , Ms^Fda      , Ms^Fda      , Ha^Fda      , Ha^Fda      , Ha^Fda      , Ha^Fda      , Aa          , Aa          , Ai          , Gd          , Gd          , Gd^Es       , Gd          , Aa^Fda      , Ha^Fda      , Ms          , Ms          , Ha^Fda      , Aa^Fda      , Aa          , Gd          , Gd          , Gd          , Ai          , Ai          , Aa          , Ai          , Aa          , Ai          , Ai          , Ai          , Ai          , Gd          , Gd^Es       , Gd          , Gd          , Cha         , 3 Kha       , Aa          , Gd          , Aa          
Ms^Xm       , Ms^Xm       , Ms^Xm       , Ms          , Ms^Fda      , Ms^Fda      , Ms^Fda      , Ms          , Aa^Vla      , Ha^Fda      , Ha^Fda      , Ha^Fda      , Aa          , Ai          , Gd          , Gd          , Aa^Fda      , Aa^Fda      , Ha^Fda      , Ms^Fda      , Ms          , Ms          , Ha^Fda      , Ha^Fda      , Aa^Fda      , Aa          , Ai          , Ai          , Aa          , Aa          , Aa^Fda      , Aa^Fda      , Aa^Fda      , Aa          , Aa          , Aa          , Aa          , Ai          , Ai          , Gd          , Gd          , Cha         , Cha         , Gd          , Gd^Es       , Gd          
Ms^Xm       , Ms^Xm       , Ms^Xm       , Ms          , Ms          , Ms^Fda      , Ms^Fda      , Ms^Fda      , Ms^Fda      , Ha^Fda      , Ms^Fda      , Ha^Fda      , Ai          , Ai          , Aa^Fda      , Aa^Fda      , Aa^Fda      , Aa^Fda      , Ha^Fda      , Ms          , Ms^Fda      , Ms^Fda      , Ha^Fda      , Ha^Fda      , Aa          , Aa          , Ai          , Gd          , Aa          , Ha^Fda      , Ha^Fda      , Ha^Fda      , Ha^Fda      , Aa^Fda      , Ha^Fda      , Aa^Fda      , Aa          , Gd          , Gd          , Ai          , Ai          , Ai          , Ai          , Gd          , Gd          , Gd          
Ms^Xm       , Ms^Xm       , Ms^Xm       , Ms^Xm       , Ms^Xm       , Ms^Xm       , Ms^Xm       , Ms^Fda      , Ms^Fda      , Ms^Fda      , Ms^Fda      , Ai          , Ha^Fda      , Ha^Fda      , Ha^Fda      , Aa^Fda      , Ms^Fda      , Ha^Fda      , Ha^Fda      , Ms^Fda      , Ha^Fda      , Ha^Fda      , Ha^Fda      , Aa^Fda      , Aa^Fda      , Aa          , Ai          , Gd          , Aa          , Ha^Fda      , Ha^Fda      , Ms^Fda      , Ms          , Ha^Fda      , Ha^Fda      , Aa^Fda      , Ha^Fda      , Aa          , Aa          , Gd          , Gd          , Gd          , Gd          , Ai          , Ai          , Gd          
Ms^Xm       , Ms^Xm       , Ms^Xm       , Ms^Xm       , Ms^Xm       , Ms^Xm       , Ms^Xm       , Ms          , Ms          , Ms          , Ms          , Ai          , Ai          , Ms^Fda      , Ms^Fda      , Ms^Fda      , Ms^Fda      , Ms^Fda      , Ms^Fda      , Ha^Fda      , Ha^Fda      , Ha^Fda      , Aa^Fda      , Aa^Fda      , Aa          , Gd          , Ai          , Gd          , Gd          , Aa          , Aa          , Ha^Fda      , Ms^Fda      , Ms          , Ms          , Ha^Fda      , Ms          , Ha^Fda      , Ha^Fda      , Aa          , Aa          , Gd          , Gd          , Gd^Es       , Gd          , Ai          
Ms^Xm       , Ms^Xm       , Ms^Xm       , Ms^Xm       , Ms^Xm       , Ms^Xm       , Ms^Xm       , Ms          , Ms^Xm       , Ms          , Ms          , Ms^Fda      , Ms^Fda      , Ms^Fda      , Ms^Fda      , Ms^Fda      , Ms^Fda      , Ms^Fda      , Ms^Fda      , Ms^Fda      , Ha^Fda      , Ha^Fda      , Aa^Fda      , Aa^Fda      , Gd^Es       , Gd          , Ai          , Gd          , Gd          , Gd          , Aa^Fda      , Ha^Fda      , Ha^Fda      , Ms^Fda      , Ms          , Ms^Fda      , Ms          , Ms          , Aa^Vla      , Aa^Fda      , Aa          , Aa          , Aa          , Gd          , Gd          , Gd          
Ms^Xm       , Ms^Xm       , Ms^Xm       , Ms^Xm       , Ms^Xm       , Ms^Xm       , Ms^Xm       , Ms^Xm       , Ms^Xm       , Ms^Xm       , Ms^Xm       , Ms^Fda      , Ms^Xm       , Ms          , Ms^Xm       , Ms^Xm       , Ms^Fda      , Ms^Fda      , Ms^Fda      , Ms^Fda      , Ha^Fda      , Ha^Fda      , Ha^Fda      , Aa^Fda      , Gd          , Ai          , Gd^Vht      , Gd          , Gd^Es       , Gd          , Gd          , Aa^Fda      , Aa^Fda      , Ha^Fda      , Ha^Fda      , Ms          , Ms          , Ms^Fda      , Ms          , Ha^Fda      , Ha^Fda      , Ha^Fda      , Aa          , Gd^Vht      , Gd          , Gd          
Ms^Xm       , Ms^Xm       , Ms^Xm       , Ms^Xm       , Ms^Xm       , Ms^Xm       , Ms^Xm       , Ms^Xm       , Ms^Xm       , Ms^Xm       , Ms^Xm       , Ms^Xm       , Ms          , Ms^Xm       , Ms^Xm       , Ms^Xm       , Ms^Fda      , Ms^Fda      , Ms^Fda      , Ms^Fda      , Aa^Vla      , Ha^Fda      , Ha^Fda      , Aa^Fda      , Aa          , Ai          , Gd          , Gd          , Gd          , Gd          , Gd          , Aa^Fda      , Aa^Fda      , Ha^Fda      , Aa^Fda      , Ha^Fda      , Ha^Fda      , Ms^Fda      , Ms          , Ms^Fda      , Ha^Fda      , Ha^Fda      , Aa          , Gd          , Gd          , Gd          
Ms^Xm       , Ms^Xm       , Ms^Xm       , Ms^Xm       , Ms^Xm       , Ms^Xm       , Ms^Xm       , Ms^Xm       , Ms^Xm       , Ms^Xm       , Ms^Xm       , Ms^Xm       , Ms^Xm       , Ms^Xm       , Ms^Xm       , Ms^Xm       , Ms^Xm       , Ms^Fda      , Ms^Fda      , Ms^Fda      , Ha^Fda      , Ha^Fda      , Ha^Fda      , Aa^Fda      , Aa^Fda      , Ai          , Gd          , Gd          , Gd^Es       , Gd          , Gd          , Gd          , Gd          , Aa^Fda      , Aa^Fda      , Aa^Fda      , Aa^Fda      , Ha^Fda      , Ha^Fda      , Ms^Fda      , Ha^Fda      , Ha^Fda      , Aa          , Gd          , Gd          , Gd          
Ms^Xm       , Ms^Xm       , Ms^Xm       , Ms^Xm       , Ms^Xm       , Ms^Xm       , Ms^Xm       , Ms^Xm       , Ms^Xm       , Ms^Xm       , Ms^Xm       , Ms^Xm       , Ms^Xm       , Ms^Xm       , Ms^Xm       , Ms^Xm       , Ms^Xm       , Ms^Fda      , Ms          , Ms^Fda      , Ms^Fda      , Ha^Fda      , Ha^Fda      , Ha^Fda      , Ai          , Ai          , Aa^Fda      , Gd          , Gd          , Gd          , Gd          , Gd          , Cha         , Cha         , Cha         , Gd          , Gd          , Aa^Fda      , Aa^Fda      , Ha^Fda      , Aa^Fda      , Ha^Fda      , Aa          , Aa          , Gd          , Gd          
Ms^Xm       , Ms^Xm       , Ms^Xm       , Ms^Xm       , Ms^Xm       , Ms^Xm       , Ms^Xm       , Ms^Xm       , Ms^Xm       , Ms^Xm       , Ms^Xm       , Ms^Xm       , Ms^Xm       , Ms^Xm       , Ms^Xm       , Ms^Xm       , Ms^Xm       , Ms^Xm       , Ms          , Ms^Fda      , Ms^Fda      , Ms          , Ms          , Ms          , Ai          , Ha^Fda      , Ha^Fda      , Aa^Fda      , Aa^Fda      , Aa          , Aa^Fda      , Gd          , Cha         , 6 Kha       , Cha         , Gd          , Gd          , Gd^Es       , Gd          , Aa^Fda      , Aa^Fda      , Aa^Fda      , Aa^Fda      , Aa          , Gd          , Gd          
Ms^Xm       , Ms^Xm       , Ms^Xm       , Ms^Xm       , Ms^Xm       , Ms^Xm       , Ms^Xm       , Ms^Xm       , Ms^Xm       , Ms^Xm       , Ms^Xm       , Ms^Xm       , Ms^Xm       , Ms^Xm       , Ms^Xm       , Ms^Xm       , Ms^Xm       , Ms^Xm       , Ms^Xm       , Ms^Xm       , Ms^Xm       , Ms^Fda      , Ms^Fda      , Ms          , Ms          , Ms^Fda      , Ms^Fda      , Ha^Fda      , Ha^Fda      , Ha^Fda      , Aa^Fda      , Gd          , Gd          , Gd          , Gd          , Gd          , Gd          , Gd          , Gd          , Gd          , Gd          , Gd          , Gd          , Aa          , Gd          , Gd          
