border_size=1
usage=map

Mm^Xm       , Mm^Xm       , Mm^Xm       , Mm^Xm       , Mm^Xm       , Mm^Xm       , Mm^Xm       , Mm^Xm       , Mm^Xm       , Mm^Xm       , Mm^Xm       , Mm^Xm       , Mm^Xm       , Mm^Xm       , Mm^Xm       , Mm^Xm       , Mm^Xm       , Mm^Xm       , Mm^Xm       , Mm^Xm       , Mm^Xm       , Mm^Xm       , Mm^Xm       , Mm^Xm       , Mm^Xm       , Mm^Xm       , Mm^Xm       , Ww          , Mm^Xm       , Mm^Xm       , Mm^Xm       , Mm^Xm       , Mm^Xm       , Mm^Xm       , Mm^Xm       , Mm^Xm       , Mm^Xm       , Mm^Xm       , Mm^Xm       , Mm^Xm       , Xuc         , Xuc         , Xuc         
Mm          , Mm^Xm       , Mm^Xm       , Mm^Xm       , Mm^Xm       , Mm^Xm       , Mm^Xm       , Mm^Xm       , Mm^Xm       , Mm^Xm       , Mm          , Mm^Xm       , Mm          , Mm^Xm       , Mm          , Mm^Xm       , Mm          , Mm          , Mm          , Mm^Xm       , Mm          , Mm          , Mm          , Mm          , Mm          , Mm          , Mm          , Ww          , Mm          , Mm          , Mm          , Mm          , Mm          , Mm^Xm       , Mm^Xm       , Mm^Xm       , Mm^Xm       , Mm^Xm       , Mm^Xm       , Mm^Xm       , Xuc         , Xuc         , Xuc         
Mm^Xm       , Mm^Xm       , Mm^Xm       , Mm^Xm       , Mm^Xm       , Mm          , Mm          , Mm          , Mm          , Mm          , Mm          , Mm          , Mm          , Mm          , Mm          , Mm          , Mm          , Mm          , Mm          , Mm          , Hh^Fds      , Hh^Fds      , Hh^Fds      , Mm          , Gg          , Mm          , Ww          , Ww          , Hh^Fds      , Mm          , Mm          , Mm          , Mm          , Mm          , Mm          , Mm^Xm       , Mm^Xm       , Mm^Xm       , Mm^Xm       , Mm^Xm       , Xuc         , Xuc         , Xuc         
Mm^Xm       , Mm^Xm       , Mm^Xm       , Mm^Xm       , Mm          , Mm          , Mm          , Mm          , Mm          , Mm          , Ww          , Mm          , Mm          , Mm          , Mm          , Mm          , Mm          , Mm          , Hh^Fds      , Hh^Fds      , Gg          , Gg          , Gg          , Gg          , Ww          , Ww          , Co          , Co          , Co          , Mm          , Mm          , Mm          , Mm          , Mm          , Mm          , Mm^Xm       , Mm^Xm       , Mm^Xm       , Mm^Xm       , Mm^Xm       , Xuc         , Xuc         , Xuc         
Mm^Xm       , Mm^Xm       , Mm^Xm       , Mm          , Mm          , Mm          , Mm          , Mm          , Mm          , Ww          , Ww          , Mm          , Mm          , Mm          , Mm          , Mm          , Hh^Fds      , Hh^Fds      , Hh^Fds      , Gg          , Gg          , Gg          , Ww          , Ww          , Gg          , Gg          , Co          , 3 Ko        , Co          , Mm          , Mm          , Mm          , Mm          , Ww          , Gd^Vo       , Mm          , Mm^Xm       , Mm^Xm       , Mm^Xm       , Mm^Xm       , Xuc         , Xuc         , Xuc         
Mm          , Mm^Xm       , Mm          , Mm          , Mm          , Mm          , Mm          , Mm          , Mm          , Mm          , Ww          , Mm          , Mm          , Mm          , Mm          , Hh^Fds      , Hh^Fds      , Hh^Fds      , Gg          , Gg          , Ww          , Ww          , Gg          , Gg          , Hh^Fds      , Hh^Fds      , Mm          , Co          , Mm          , Mm          , Mm          , Mm          , Ww          , Ww          , Mm          , Mm          , Mm^Xm       , Mm^Xm       , Mm^Xm       , Xuc         , Xuc         , Xuc         , Xuc         
Mm          , Mm          , Mm          , Mm          , Mm          , Mm          , Mm          , Mm          , Mm          , Mm          , Ww          , Ww          , Mm          , Mm          , Hh^Fds      , Hh^Fds      , Gg          , Gg          , Ww          , Ww          , Gg          , Gg          , Gd^Vo       , Hh^Fds      , Hh^Fds      , Mm          , Mm          , Mm          , Mm          , Mm          , Hh^Fds      , Ww          , Mm          , Mm          , Mm          , Mm          , Mm^Xm       , Mm^Xm       , Mm^Xm       , Xuc         , Xuc         , Xuc         , Xuc         
Mm          , Mm          , Mm          , Mm          , Mm          , Mm          , Mm          , Mm          , Hh^Fds      , Hh^Fds      , Ww          , Mm          , Mm          , Mm          , Hh^Fds      , Hh^Fds      , Gg          , Gg          , Ww          , Gg          , Gg          , Gg          , Hh^Fds      , Hh^Fds      , Mm          , Mm          , Mm          , Mm          , Hh^Fds      , Hh^Fds      , Ww          , Ww          , Mm          , Mm          , Mm          , Mm          , Mm^Xm       , Mm^Xm       , Mm^Xm       , Xuc         , Xuc         , Xuc         , Xuc         
Hh^Fds      , Hh^Fds      , Hh^Fds      , Hh^Fds      , Hh^Fds      , Hh^Fds      , Hh^Fds      , Hh^Fds      , Ww          , Ww          , Mm          , Mm          , Mm          , Mm          , Hh^Fds      , Gd^Vo       , Gg          , Gg          , Ww          , Gg          , Hh^Fds      , Hh^Fds      , Mm          , Mm          , Mm          , Mm          , Hh^Fds      , Hh^Fds      , Gd^Vo       , Hh^Fds      , Ww          , Hh^Fds      , Hh^Fds      , Mm          , Mm          , Mm          , Mm^Xm       , Mm^Xm       , Xuc         , Xuc         , Xuc         , Xuc         , Xuc         
Hh^Fds      , Hh^Fds      , Hh^Fds      , Hh^Fds      , Hh^Fds      , Hh^Fds      , Ww          , Ww          , Gg          , Gg          , Mm          , Mm          , Mm          , Hh^Fds      , Hh^Fds      , Gg          , Ww          , Ww          , Hh^Fds      , Gg          , Hh^Fds      , Mm          , Mm          , Mm          , Mm          , Mm          , Mm          , Hh^Fds      , Hh^Fds      , Gg          , Ww          , Gg          , Hh^Fds      , Mm          , Mm          , Mm^Xm       , Mm^Xm       , Mm^Xm       , Xuc         , Xuc         , Xuc         , Xuc         , Xuc         
Hh^Fds      , Hh^Fds      , Gd^Vo       , Gg          , Gg          , Ww          , Gg          , Gg          , Gg          , Ch          , Ch          , Mm          , Mm          , Hh^Fds      , Gg          , Gg          , Ww          , Gg          , Hh^Fds      , Hh^Fds      , Mm          , Mm          , Mm          , Mm          , Mm          , Mm          , Hh^Fds      , Hh^Fds      , Hh^Fds      , Gg          , Ww          , Gg          , Hh^Fds      , Mm          , Mm          , Mm^Xm       , Mm^Xm       , Mm^Xm       , Xuc         , Xuc         , Xuc         , Xuc         , Xuc         
Hh^Fds      , Hh^Fds      , Gg          , Gg          , Ww          , Ww          , Gg          , Gg          , 1 Kh        , Ch          , Ch          , Mm          , Hh^Fds      , Hh^Fds      , Gg          , Ww          , Gg          , Hh^Fds      , Hh^Fds      , Hh^Fds      , Mm          , Mm          , Mm          , Mm          , Hh^Fds      , Hh^Fds      , Hh^Fds      , Hh^Fds      , Gg          , Gg          , Ww          , Gg          , Gd^Vo       , Hh^Fds      , Mm          , Mm^Xm       , Mm^Xm       , Mm^Xm       , Xuc         , Xuc         , Xuc         , Xuc         , Xuc         
Hh^Fds      , Hh^Fds      , Gg          , Gg          , Ww          , Gg          , Rp          , Rp          , Mm          , Ch          , Mm          , Mm          , Hh^Fds      , Hh^Fds      , Ww          , Ww          , Gg          , Hh^Fds      , Mm          , Mm          , Mm          , Mm          , Mm          , Mm          , Hh^Fds      , Hh^Fds      , Gg          , Gg          , Ww          , Ww          , Gg          , Gg          , Gg          , Hh^Fds      , Mm          , Mm^Xm       , Mm^Xm       , Xuc         , Xuc         , Xuc         , Xuc         , Xuc         , Urb         
Hh^Fds      , Hh^Fds      , Gg          , Ww          , Gg          , Rp          , Mm          , Mm          , Mm          , Mm          , Mm          , Hh^Fds      , Hh^Fds      , Hh^Fds      , Ww          , Gd^Vo       , Hh^Fds      , Hh^Fds      , Mm          , Mm          , Mm          , Mm          , Hh^Fds      , Hh^Fds      , Gg          , Hh^Fds      , Gg          , Ww          , Gg          , Gg          , Gg          , Gg          , Gg          , Hh^Fds      , Mm          , Mm^Xm       , Mm^Xm       , Xuc         , Xuc         , Xuc         , Urb         , Urb         , Urb         
Rr          , Gg          , Gg          , Ww          , Rp          , Rp          , Mm          , Mm          , Mm          , Mm          , Hh^Fds      , Hh^Fds      , Ww          , Ww          , Hh^Fds      , Hh^Fds      , Mm          , Mm          , Mm          , Mm          , Mm          , Hh^Fds      , Hh^Fds      , Hh^Fds      , Gg          , Gg          , Gg          , Ww          , Gg          , Gg          , Ch          , Ch          , Ch          , Hh^Fds      , Gg          , Mm          , Rp          , Urb         , Urb         , Urb         , Urb         , Urb         , Urb         
Hh^Fds      , Rr          , Rr          , Ww^Bw/      , Gg          , Mm          , Mm          , Mm          , Hh^Fds      , Hh^Fds      , Ww          , Ww          , Hh^Fds      , Hh^Fds      , Mm          , Mm          , Mm          , Mm          , Mm          , Mm          , Hh^Fds      , Hh^Fds      , Hh^Fds      , Gg          , Gg          , Gg          , Gg          , Ww          , Gg          , Ch          , Ch          , 2 Kh        , Ch          , Ch          , Rp          , Rp          , Rp          , Urb         , Urb         , Urb         , Xuc         , Xuc         , Xuc         
Hh^Fds      , Gg          , Rr          , Ww          , Gg          , Mm          , Hh^Fds      , Hh^Fds      , Ww          , Ww          , Hh^Fds      , Hh^Fds      , Hh^Fds      , Mm          , Mm          , Mm          , Mm          , Mm          , Hh^Fds      , Hh^Fds      , Gd^Vo       , Hh^Fds      , Gg          , Gg          , Rp          , Rp          , Rp          , Ww          , Gg          , Gg          , Ch          , Ch          , Rp          , Rp          , Mm          , Mm          , Mm^Xm       , Mm          , Xuc         , Xuc         , Xuc         , Xuc         , Xuc         
Hh^Fds      , Gg          , Rr          , Ww          , Ww          , Gg          , Ww          , Ww          , Gd^Vo       , Hh^Fds      , Hh^Fds      , Hh^Fds      , Mm          , Mm          , Mm          , Mm          , Mm          , Mm          , Hh^Fds      , Gg          , Gg          , Gg          , Rp          , Rp          , Gg          , Gg          , Gg          , Ww^Bw\      , Rp          , Rp          , Rp          , Rp          , Hh^Fds      , Hh^Fds      , Mm          , Mm          , Mm^Xm       , Mm^Xm       , Xuc         , Xuc         , Xuc         , Xuc         , Xuc         
Hh^Fds      , Gg          , Gg          , Rr          , Rr          , Ww          , Gg          , Gg          , Hh^Fds      , Hh^Fds      , Mm          , Mm          , Mm          , Mm          , Mm          , Mm          , Mm          , Hh^Fds      , Hh^Fds      , Gg          , Rp          , Rp          , Ww          , Gg          , Ww          , Ww          , Ww          , Ww          , Gg          , Gg          , Gg          , Gg          , Hh^Fds      , Mm          , Mm          , Mm^Xm       , Mm^Xm       , Xuc         , Xuc         , Xuc         , Xuc         , Xuc         , Xuc         
Hh^Fds      , Gg          , Gg          , Gg          , Rr          , Ww          , Gg          , Gg          , Mm          , Mm          , Mm          , Mm          , Mm          , Mm          , Mm          , Mm          , Mm          , Hh^Fds      , Hh^Fds      , Rp          , Ww          , Ww          , Hh^Fds      , Ww          , Hh^Fds      , Gg          , Gg          , Ww          , Gg          , Gg          , Gg          , Gd^Vo       , Hh^Fds      , Mm          , Mm          , Mm^Xm       , Mm^Xm       , Xuc         , Xuc         , Xuc         , Xuc         , Xuc         , Xuc         
Hh^Fds      , Hh^Fds      , Gd^Vo       , Gg          , Rr          , Ww          , Gg          , Mm          , Mm          , Mm          , Mm          , Mm          , Mm          , Mm          , Mm          , Mm          , Hh^Fds      , Hh^Fds      , Rp          , Ww          , Hh^Fds      , Hh^Fds      , Mm          , Mm          , Hh^Fds      , Gg          , Gg          , Ww          , Gg          , Gg          , Gg          , Hh^Fds      , Mm          , Mm          , Mm          , Mm^Xm       , Mm^Xm       , Xuc         , Xuc         , Xuc         , Xuc         , Xuc         , Xuc         
Hh^Fds      , Hh^Fds      , Gg          , Gg          , Rr          , Ww          , Mm          , Mm          , Mm          , Mm          , Mm          , Mm          , Mm          , Mm          , Hh^Fds      , Hh^Fds      , Rp          , Rp          , Ww          , Ww          , Gd^Vo       , Hh^Fds      , Mm          , Mm          , Hh^Fds      , Gg          , Gg          , Ww          , Ww          , Gg          , Gg          , Hh^Fds      , Mm          , Mm          , Mm^Xm       , Mm^Xm       , Mm^Xm       , Mm^Xm       , Xuc         , Xuc         , Xuc         , Xuc         , Xuc         
Hh^Fds      , Hh^Fds      , Gg          , Gg          , Rr          , Ww          , Mm          , Mm          , Mm          , Mm          , Mm          , Mm          , Hh^Fds      , Gd^Vo       , Rp          , Rp          , Ww          , Ww          , Hh^Fds      , Hh^Fds      , Mm          , Mm          , Mm          , Mm          , Hh^Fds      , Gg          , Gg          , Gg          , Ww          , Gg          , Hh^Fds      , Hh^Fds      , Mm          , Mm          , Mm^Xm       , Mm^Xm       , Mm^Xm       , Mm^Xm       , Mm^Xm       , Xuc         , Xuc         , Xuc         , Xuc         
Hh^Fds      , Hh^Fds      , Gg          , Gg          , Gg          , Ww^Bw\      , Ww^Bw\      , Mm          , Mm          , Mm          , Hh^Fds      , Hh^Fds      , Rp          , Rp          , Ww          , Ww          , Hh^Fds      , Hh^Fds      , Hh^Fds      , Mm          , Mm          , Mm          , Mm          , Hh^Fds      , Hh^Fds      , Gg          , Gg          , Gg          , Gg          , Ww          , Hh^Fds      , Mm          , Mm          , Mm          , Mm^Xm       , Mm^Xm       , Mm^Xm       , Mm^Xm       , Mm^Xm       , Xuc         , Xuc         , Xuc         , Xuc         
Hh^Fds      , Hh^Fds      , Hh^Fds      , Gg          , Gg          , Gg          , Ww          , Rr          , Rr          , Rr          , Rr          , Rp          , Ww          , Ww          , Gg          , Hh^Fds      , Hh^Fds      , Hh^Fds      , Mm          , Mm          , Mm          , Mm          , Mm          , Hh^Fds      , Hh^Fds      , Gd^Vo       , Gg          , Gg          , Gg          , Ww          , Ww          , Mm          , Mm          , Mm          , Mm^Xm       , Mm^Xm       , Mm^Xm       , Mm^Xm       , Mm^Xm       , Xuc         , Xuc         , Xuc         , Xuc         
Hh^Fds      , Hh^Fds      , Hh^Fds      , Hh^Fds      , Gg          , Gg          , Gg          , Ww          , Hh^Fds      , Hh^Fds      , Ww          , Ww^Bw\      , Rr          , Gg          , Gg          , Hh^Fds      , Hh^Fds      , Mm          , Mm          , Mm          , Mm          , Mm          , Hh^Fds      , Hh^Fds      , Hh^Fds      , Hh^Fds      , Hh^Fds      , Gg          , Gg          , Hh^Fds      , Mm          , Mm          , Mm          , Mm^Xm       , Mm^Xm       , Mm^Xm       , Mm^Xm       , Mm^Xm       , Mm^Xm       , Xuc         , Xuc         , Xuc         , Xuc         
