border_size=1
usage=map

Mm^Xm       , Mm^Xm       , Mm^Xm       , Mm^Xm       , Mm          , Mm          , Mm          , Mm          , Mm          , Mm          , Mm          , Mm          , Hh^Fds      , Hh^Fds      , Gg          , Rb          , Hh^Fds      , Hh^Fds      , Gg          , Gg          , Gs^Fds      , Ww          , Rr          , Gs^Fds      , Gg          , Hh^Fds      , Gs^Fds      , Hh^Fds      , Gs^Fds      , Hh^Fds      , Hh^Fds      , Hh^Fds      , Hh^Fds      , Hh^Fds      , Gs^Fds      , Hh^Fds      , Hh^Fds      , Hh^Fds      , Hh^Fds      , Hh^Fds      , Hh^Fds      , Mm          , Mm          , Mm          , Mm          , Mm^Xm       
Mm^Xm       , Mm^Xm       , Mm          , Mm          , Mm          , Mm          , Mm          , Mm          , Hh^Fds      , Mm          , Hh^Fds      , Hh^Fds      , Hh^Fms      , Hh^Fds      , Rb          , Rb          , Gg          , Gg          , Gs^Fds      , Gg          , Ww          , Ww          , Rr          , Gg          , Gs^Fds      , Gs^Fds      , Hh^Fds      , Gs^Fds      , Hh^Fds      , Gs^Fds      , Gs^Fds      , Gs^Fds      , Gs^Fds      , Gs^Fds      , Gs^Fds      , Hh^Fds      , Hh^Fds      , Hh^Fds      , Hh^Fds      , Hh^Fms      , Hh^Fds      , Mm          , Mm          , Mm          , Mm^Xm       , Mm^Xm       
Mm          , Mm^Xm       , Mm          , Mm          , Mm          , Mm          , Hh^Fds      , Hh^Fds      , Hh^Fds      , Hh^Fds      , Hh^Fds      , Hh^Fds      , Hh^Fds      , Hh^Fds      , Rb          , Gg          , Gs^Fds      , Gs^Vh       , Ww          , Ww          , Gs^Fds      , Gs^Fds      , Rr          , Hh^Fds      , Chr         , Gs^Fds      , Gs^Fds      , Hh^Fds      , Hh^Fds      , Hh^Fds      , Gg          , Hh^Fds      , Gs^Fds      , Gs^Fds      , Hh^Fds      , Hh^Fds      , Hh^Fds      , Hh^Fds      , Hh^Fds      , Hh^Fds      , Hh^Fds      , Hh^Fds      , Mm          , Mm          , Mm^Xm       , Mm^Xm       
Mm          , Mm          , Mm          , Mm          , Hh^Fds      , Hh^Fds      , Hh^Fds      , Hh^Fds      , Gs^Fds      , Hh^Fds      , Gs^Fds      , Hh^Fms      , Rb          , Rb          , Rb          , Gg          , Ww          , Ww          , Gg          , Gs^Fds      , Gs^Fds      , Rr          , Chr         , Chr         , 1 Khr       , Gs^Fds      , Hh^Fms      , Hh^Fds      , Gs^Fds      , Gs^Fds      , Gs^Vh       , Gs^Fds      , Hh^Fds      , Hh^Fds      , Hh^Fds      , Hh^Fds      , Hh^Fds      , Hh^Fds      , Hh^Fds      , Hh^Fds      , Hh^Fds      , Mm          , Mm          , Mm          , Mm^Xm       , Mm^Xm       
Mm          , Mm          , Mm          , Hh^Fds      , Hh^Fms      , Hh^Fds      , Hh^Fds      , Hh^Fds      , Gs^Fds      , Gs^Fds      , Hh^Fds      , Gg          , Rb          , Gs^Fds      , Gg          , Rb          , Ww^Bw\r     , Gg          , Gs^Fds      , Gs^Fds      , Rb          , Rr          , Rr          , Chr         , Chr         , Gs^Fds      , Gg          , Gg          , Gg          , Gg          , Gg          , Gs^Fds      , Hh^Fds      , Hh^Fds      , Gs^Fds      , Hh^Fds      , Hh^Fds      , Hh^Fds      , Hh^Fds      , Hh^Fds      , Mm          , Mm          , Mm          , Mm          , Mm^Xm       , Mm^Xm       
Mm          , Mm          , Hh^Fds      , Hh^Fds      , Hh^Fms      , Hh^Fds      , Hh^Fds      , Hh^Fds      , Hh^Fds      , Hh^Fds      , Hh^Fms      , Hh^Fds      , Rb          , Gg          , Gs^Fds      , Ww          , Gs^Fds      , Rb          , Rb          , Rb          , Gg          , Gg          , Rr          , Chr         , Hh^Fds      , Gg          , Gs^Fds      , Gs^Fds      , Hh^Fds      , Gs^Fds      , Gg          , Gs^Fds      , Gs^Fds      , Gs^Fds      , Gs^Fds      , Hh^Fds      , Hh^Fds      , Hh^Fds      , Hh^Fds      , Mm          , Mm          , Mm          , Mm          , Mm^Xm       , Mm^Xm       , Mm^Xm       
Mm          , Mm          , Hh^Fds      , Hh^Fds      , Hh^Fms      , Hh^Fms      , Hh^Fds      , Hh^Fds      , Hh^Fds      , Hh^Fds      , Gg          , Gs^Fds      , Rb          , Gs^Vh       , Ww          , Ww          , Gs^Fds      , Gs^Fds      , Gs^Fds      , Gs^Fds      , Gs^Vh       , Gg          , Rr          , Hh^Fds      , Hh^Fds      , Hh^Fds      , Hh^Fds      , Hh^Fds      , Gs^Fds      , Gg          , Gs^Fds      , Gs^Fds      , Hh^Fds      , Hh^Fds      , Hh^Fds      , Hh^Fds      , Hh^Fds      , Hh^Fds      , Mm          , Mm          , Mm          , Mm          , Mm^Xm       , Mm^Xm       , Mm^Xm       , Mm          
Mm^Xm       , Mm          , Mm          , Hh^Fds      , Hh^Fds      , Hh^Fms      , Hh^Fms      , Hh^Fds      , Gs^Fds      , Gs^Fds      , Gg          , Rb          , Gs^Fds      , Gs^Fds      , Ww          , Gg          , Gg          , Gs^Fds      , Hh^Fds      , Gg          , Gg          , Rr          , Gs^Fds      , Hh^Fms      , Gs^Fds      , Hh^Fds      , Gs^Fds      , Hh^Fds      , Gs^Fds      , Gs^Fds      , Hh^Fds      , Hh^Fds      , Hh^Fds      , Hh^Fds      , Hh^Fds      , Hh^Fds      , Mm          , Mm          , Mm          , Mm^Xm       , Mm^Xm       , Mm^Xm       , Mm^Xm       , Mm^Xm       , Mm^Xm       , Mm          
Mm^Xm       , Mm          , Mm          , Hh^Fds      , Hh^Fds      , Hh^Fds      , Hh^Fds      , Gs^Fds      , Hh^Fds      , Gs^Fds      , Hh^Fms      , Rb          , Gg          , Gs^Fds      , Ww          , Gg          , Gg          , Gs^Fds      , Hh^Fds      , Gg          , Gg          , Rr          , Hh^Fds      , Gs^Fds      , Gg          , Gg          , Hh^Fds      , Gs^Vh       , Hh^Fds      , Hh^Fms      , Hh^Fds      , Hh^Fds      , Hh^Fds      , Hh^Fds      , Mm          , Mm          , Mm          , Mm          , Mm          , Mm          , Mm          , Mm^Xm       , Mm          , Mm^Xm       , Mm^Xm       , Mm^Xm       
Mm^Xm       , Mm^Xm       , Mm          , Mm          , Mm          , Hh^Fds      , Hh^Fds      , Gs^Fds      , Gs^Fds      , Hh^Fds      , Gg          , Rb          , Gg          , Gg          , Gs^Fds      , Ww          , Gg          , Gg          , Gg          , Gg          , Gg          , Rr          , Hh^Fds      , Hh^Fds      , Hh^Fds      , Hh^Fds      , Hh^Fds      , Hh^Fds      , Hh^Fds      , Hh^Fds      , Hh^Fds      , Hh^Fds      , Hh^Fds      , Hh^Fds      , Mm          , Mm          , Hh^Fds      , Hh^Fds      , Hh^Fds      , Mm          , Rb          , Mm          , Mm          , Mm          , Mm          , Mm^Xm       
Mm^Xm       , Mm^Xm       , Mm          , Mm          , Mm          , Hh^Fds      , Hh^Fds      , Hh^Fds      , Hh^Fds      , Gs^Fds      , Gs^Fds      , Rb          , Gs^Fds      , Gg          , Gs^Vh       , Ww          , Ww          , Gg          , Gg          , Gg          , Rr          , Rr          , Gg          , Hh^Fds      , Hh^Fds      , Hh^Fds      , Gg          , Gg          , Hh^Fds      , Hh^Fds      , Hh^Fds      , Hh^Fds      , Mm          , Mm          , Mm          , Mm          , Hh^Fds      , Gs^Vh       , Rb          , Rb          , Gs^Vh       , Hh^Fds      , Wwg         , Wwg         , Mm          , Mm          
Mm^Xm       , Mm^Xm       , Mm^Xm       , Mm          , Mm          , Mm          , Mm          , Hh^Fds      , Hh^Fds      , Hh^Fds      , Hh^Fds      , Rb          , Rb          , Gg          , Gs^Fds      , Gg          , Ww          , Gs^Fds      , Gs^Fds      , Gs^Fds      , Rr          , Gg          , Gg          , Hh^Fds      , Hh^Fds      , Hh^Fds      , Gs^Vh       , Gs^Fds      , Hh^Fds      , Hh^Fds      , Hh^Fds      , Hh^Fds      , Hh^Fds      , Hh^Fds      , Hh^Fds      , Hh^Fds      , Hh^Fds      , Rb          , Gs^Fds      , Gs^Fds      , Wwg         , Wwg         , Hh^Fds      , Hh^Fds      , Mm          , Mm          
Mm^Xm       , Mm^Xm       , Mm^Xm       , Mm          , Mm          , Mm          , Mm          , Hh^Fds      , Hh^Fds      , Hh^Fds      , Hh^Fds      , Hh^Fds      , Gs^Fds      , Rb          , Hh^Fms      , Gs^Fds      , Gs^Fds      , Ww          , Gs^Fds      , Gs^Fds      , Rr          , Gs^Vh       , Gg          , Hh^Fds      , Gg          , Hh^Fds      , Gg          , Hh^Fms      , Hh^Fds      , Hh^Fds      , Hh^Fds      , Hh^Fds      , Gs^Fds      , Gs^Fds      , Gg          , Hh^Fds      , Rb          , Rb          , Wwg         , Wwg         , Hh^Fds      , Hh^Fds      , Mm          , Mm          , Mm          , Mm          
Mm^Xm       , Mm^Xm       , Mm^Xm       , Mm^Xm       , Mm^Xm       , Mm          , Mm          , Hh^Fds      , Hh^Fds      , Hh^Fds      , Hh^Fds      , Hh^Fds      , Gs^Fds      , Rb          , Gs^Fds      , Gg          , Gg          , Ww          , Ww          , Gg          , Gg          , Rr          , Gs^Fds      , Gg          , Gg          , Gs^Fds      , Hh^Fds      , Hh^Fds      , Hh^Fds      , Gs^Fds      , Gg          , Hh^Fds      , Rb          , Gs^Vh       , Rb          , Rb          , Wwg         , Gs^Fds      , Wwg         , Hh^Fds      , Hh^Fds      , Hh^Fds      , Mm          , Mm          , Mm          , Mm          
Mm^Xm       , Mm^Xm       , Mm^Xm       , Mm^Xm       , Mm^Xm       , Mm^Xm       , Mm          , Mm          , Mm          , Hh^Fds      , Hh^Fds      , Hh^Fds      , Gs^Fds      , Rb          , Rb          , Gg          , Gs^Fds      , Gg          , Gg          , Ww          , Gg          , Rr          , Gs^Fds      , Gg          , Gg          , Gs^Fds      , Hh^Fds      , Gs^Fds      , Gg          , Gg          , Rb          , Rb          , Gg          , Rb          , Wwg         , Wwg         , Gs^Fds      , Wwg         , Hh^Fds      , Hh^Fds      , Mm          , Mm          , Mm          , Mm          , Mm^Xm       , Mm^Xm       
Mm          , Mm^Xm       , Mm^Xm       , Mm          , Mm          , Mm^Xm       , Mm^Xm       , Mm          , Mm^Xm       , Mm          , Mm          , Hh^Fds      , Hh^Fds      , Gs^Fds      , Gs^Fds      , Rb          , Rb          , Gs^Vh       , Gg          , Ww          , Ww          , Rr          , Rr          , Gs^Fds      , Gg          , Gg          , Gg          , Gs^Fds      , Rb          , Rb          , Gg          , Gg          , Wwg         , Wwg         , Gg          , Gg          , Hh^Fds      , Hh^Fds      , Hh^Fds      , Mm          , Mm          , Mm          , Mm          , Mm          , Mm^Xm       , Mm^Xm       
Mm          , Mm          , Mm          , Mm          , Mm          , Mm          , Mm          , Mm^Xm       , Mm^Xm       , Mm          , Mm          , Mm          , Mm          , Hh^Fds      , Hh^Fds      , Gs^Fds      , Rb          , Gs^Fds      , Gs^Fds      , Gg          , Gg          , Ww          , Rr          , Rb          , Rb          , Gg          , Rb          , Rb          , Gg          , Gs^Fds      , Gs^Fds      , Gs^Fds      , Wwg         , Gg          , Gs^Fds      , Gs^Fds      , Hh^Fds      , Hh^Fds      , Mm          , Mm          , Mm          , Mm          , Mm          , Mm^Xm       , Mm^Xm       , Mm^Xm       
Mm          , Mm          , Mm          , Mm          , Mm          , Mm          , Mm          , Mm          , Mm^Xm       , Mm^Xm       , Mm^Xm       , Mm          , Mm          , Hh^Fds      , Hh^Fds      , Gs^Fds      , Rb          , Hh^Fds      , Hh^Fds      , Gg          , Rr          , Ww^Bw/r     , Gs^Fds      , Gg          , Gg          , Rb          , Gs^Fds      , Rb          , Wwg         , Wwg         , Wwg         , Wwg         , Gg          , Gs^Vh       , Hh^Fds      , Hh^Fds      , Hh^Fds      , Hh^Fds      , Mm          , Mm          , Mm          , Mm          , Mm^Xm       , Mm^Xm       , Mm^Xm       , Mm^Xm       
Mm          , Mm          , Mm          , Mm          , Hh^Fds      , Hh^Fds      , Wwg         , Mm^Xm       , Mm^Xm       , Mm^Xm       , Mm^Xm       , Mm          , Mm          , Mm          , Hh^Fds      , Hh^Fds      , Rb          , Hh^Fds      , Gg          , Gg          , Rr          , Ww          , Ww          , Gs^Fds      , Gg          , Hh^Fds      , Wwg         , Wwg^Bw|r    , Gg          , Gg          , Gg          , Gg          , Gg          , Hh^Fds      , Hh^Fds      , Hh^Fds      , Mm          , Mm          , Mm          , Mm          , Mm^Xm       , Mm^Xm       , Mm^Xm       , Mm^Xm       , Mm^Xm       , Mm^Xm       
Mm          , Mm          , Hh^Fds      , Hh^Fds      , Hh^Fds      , Gs^Fds      , Wwg         , Chr         , Chr         , Mm^Xm       , Mm^Xm       , Mm^Xm       , Mm^Xm       , Mm          , Mm          , Hh^Fds      , Hh^Fds      , Rb          , Gs^Vh       , Gg          , Rr          , Gs^Fds      , Ww          , Gg          , Wwg         , Wwg         , Rb          , Rb          , Hh^Fds      , Gs^Fds      , Hh^Fds      , Gs^Fds      , Hh^Fds      , Hh^Fds      , Mm          , Mm          , Mm          , Mm          , Mm^Xm       , Mm^Xm       , Mm^Xm       , Mm^Xm       , Mm^Xm       , Mm^Xm       , Mm^Xm       , Mm^Xm       
Md          , Mm          , Hh^Fds      , Hh^Fds      , Gs^Vh       , Gs^Fds      , Gs^Fds      , Wwg         , Chr         , 2 Khr       , Mm^Xm       , Mm^Xm       , Mm^Xm       , Mm          , Mm          , Hh^Fds      , Hh^Fds      , Rb          , Rb          , Gg          , Rr          , Gg          , Ww          , Wwg         , Gs^Fds      , Gg          , Rb          , Hh^Fds      , Hh^Fds      , Hh^Fds      , Mm          , Mm          , Mm          , Mm          , Mm          , Mm          , Mm^Xm       , Mm^Xm       , Mm^Xm       , Mm^Xm       , Mm^Xm       , Mm^Xm       , Mm^Xm       , Mm^Xm       , Mm^Xm       , Mm^Xm       
Md          , Md          , Hh^Fds      , Hh^Fds      , Rb          , Hh^Fds      , Gs^Fds      , Wwg         , Wwg         , Chr         , Hh^Fds      , Mm          , Mm          , Mm^Xm       , Mm          , Hh^Fds      , Hh^Fds      , Gg          , Gg          , Rr          , Hh^Fds      , Gg          , Ww          , Gs^Fds      , Gg          , Gg          , Rb          , Hh^Fds      , Hh^Fds      , Mm          , Mm          , Mm          , Mm          , Mm          , Mm          , Mm^Xm       , Mm          , Mm^Xm       , Mm          , Mm          , Mm          , Mm          , Mm          , Mm^Xm       , Mm^Xm       , Mm^Xm       
Md          , Md          , Hh^Fds      , Hh^Fds      , Gs^Vh       , Rb          , Rb          , Gs^Fds      , Wwg         , Chr         , Gs^Fds      , Hh^Fds      , Hh^Fds      , Mm          , Mm          , Mm          , Hh^Fds      , Hh^Fds      , Gg          , Rr          , Gg          , Hh^Fds      , Ww          , Gs^Fds      , Gg          , Gs^Vh       , Rb          , Gg          , Hh^Fds      , Hh^Fds      , Hh^Fds      , Mm          , Mm          , Mm          , Mm          , Mm          , Mm          , Mm          , Mm          , Mm          , Mm          , Mm          , Mm          , Mm          , Mm          , Mm^Xm       
Md          , Md          , Md          , Hh^Fds      , Hh^Fds      , Hh^Fms      , Gs^Fds      , Rb          , Gs^Fds      , Wwg         , Wwg         , Gs^Fds      , Hh^Fds      , Hh^Fds      , Mm          , Mm          , Hh^Fds      , Hh^Fds      , Gs^Fds      , Rr          , Hh^Fds      , Hh^Fds      , Ww          , Gg          , Gg          , Hh^Fms      , Rb          , Gg          , Hh^Fds      , Hh^Fds      , Hh^Fds      , Hh^Fds      , Hh^Fds      , Hh^Fds      , Hh^Fds      , Hh^Fds      , Hh^Fds      , Mm          , Hh^Fds      , Mm          , Hh^Fds      , Wwg         , Hh^Fds      , Mm          , Mm          , Mm^Xm       
Md          , Md          , Md          , Hh^Fds      , Hh^Fds      , Hh^Fds      , Gs^Fds      , Rb          , Rb          , Gs^Fds      , Wwg         , Gs^Fds      , Gs^Fds      , Hh^Fds      , Hh^Fds      , Mm          , Gs^Fds      , Hh^Fds      , Rr          , Rr          , Gs^Fds      , Gg          , Ww          , Hh^Fds      , Gg          , Rb          , Gg          , Hh^Fds      , Hh^Fds      , Hh^Fds      , Hh^Fds      , Hh^Fds      , Hh^Fds      , Hh^Fds      , Hh^Fds      , Hh^Fds      , Hh^Fds      , Hh^Fds      , Gs^Vh       , Hh^Fds      , Wwg         , Wwg         , Mm          , Mm          , Mm^Xm       , Mm^Xm       
Mm^Xm       , Md          , Md          , Md          , Md          , Hh^Fds      , Hh^Fds      , Gs^Fds      , Rb          , Gs^Fds      , Wwg         , Gs^Fds      , Wwg         , Gs^Fds      , Gs^Fds      , Gs^Fds      , Rb          , Hh^Fds      , Rr          , Gs^Vh       , Gg          , Gg          , Ww          , Gg          , Gg          , Rb          , Hh^Fms      , Hh^Fms      , Gs^Fds      , Hh^Fds      , Gs^Fds      , Hh^Fds      , Gs^Fds      , Hh^Fms      , Gs^Fds      , Gs^Fds      , Gs^Fds      , Gs^Fds      , Gg          , Wwg         , Gs^Fds      , Hh^Fds      , Hh^Fds      , Mm          , Mm          , Mm^Xm       
Mm^Xm       , Mm^Xm       , Mm^Xm       , Md          , Md          , Hh^Fds      , Hh^Fds      , Hh^Fds      , Gs^Vh       , Rb          , Rb          , Wwg         , Gs^Fds      , Wwg         , Wwg^Bw/r    , Rb          , Gs^Fds      , Rb          , Gg          , Rr          , Rr          , Ww          , Gs^Fds      , Gg          , Rb          , Rb          , Hh^Fds      , Hh^Fds      , Gg          , Hh^Fds      , Gs^Fds      , Gs^Fds      , Gg          , Gs^Fds      , Gg          , Gg          , Gg          , Gg          , Wwg         , Wwg         , Gs^Fds      , Hh^Fds      , Hh^Fds      , Md          , Md          , Mm          
Mm^Xm       , Mm^Xm       , Mm^Xm       , Mm^Xm       , Md          , Hh^Fds      , Md          , Hh^Fds      , Hh^Fds      , Gs^Fds      , Gs^Fds      , Rb          , Rb          , Rb          , Gs^Fds      , Wwg         , Wwg         , Gg          , Gg          , Gs^Fds      , Ww          , Ww^Bw\r     , Rr          , Rb          , Hh^Fds      , Hh^Fds      , Gg          , Gg          , Gg          , Gs^Fds      , Gg          , Gg          , Gs^Fds      , Gg          , Gg          , Gs^Vh       , Wwg         , Wwg         , Gg          , Gg          , Hh^Fds      , Hh^Fds      , Hh^Fds      , Md          , Md          , Md          
Mm^Xm       , Mm^Xm       , Md          , Md          , Md          , Md          , Hh^Fds      , Hh^Fds      , Hh^Fds      , Gs^Fds      , Gs^Fds      , Gs^Fds      , Rb          , Gs^Fds      , Wwg         , Gs^Fds      , Wwg         , Gs^Fds      , Wwg         , Wwg         , Ww          , Gs^Fds      , Gg          , Rr          , Rr          , Gg          , Gs^Vh       , Hh^Fds      , Gg          , Gs^Fds      , Wwg         , Wwg         , Wwg         , Gs^Fds      , Wwg         , Wwg         , Gg          , Gs^Fds      , Gg          , Gg          , Hh^Fds      , Hh^Fds      , Md          , Md          , Md          , Mm^Xm       
Mm^Xm       , Mm^Xm       , Md          , Md          , Md          , Md          , Hh^Fds      , Hh^Fds      , Gg          , Gs^Fds      , Wwg         , Wwg         , Wwg         , Wwg^Bw\r    , Rb          , Wwg         , Gg          , Wwg         , Gg          , Gg          , Ww          , Gg          , Gg          , Hh^Fms      , Rr          , Gs          , Gg          , Gg          , Wwg         , Wwg         , Gg          , Gs^Fds      , Gg          , Wwg         , Gs^Fds      , Gg          , Gs^Fds      , Gg          , Hh^Fds      , Hh^Fds      , Hh^Fds      , Hh^Fds      , Md          , Md          , Mm^Xm       , Mm^Xm       
Mm^Xm       , Md          , Md          , Md          , Md          , Hh^Fds      , Hh^Fds      , Gs^Fds      , Wwg         , Wwg         , Gg          , Gg          , Gs^Fds      , Gs^Fds      , Gs^Fds      , Rb          , Rb          , Gg          , Gs          , Gs^Vh       , Gg          , Ww          , Gg          , Hh^Fds      , Gg          , Rr          , Wwg^Bw\r    , Wwg         , Gg          , Gg          , Gs^Fds      , Gg          , Gs^Fds      , Gg          , Gs^Fds      , Gs^Fds      , Gs^Fds      , Gg          , Hh^Fds      , Hh^Fds      , Hh^Fds      , Md          , Md          , Md          , Md          , Mm^Xm       
Md          , Md          , Md          , Md          , Hh^Fds      , Hh^Fds      , Wwg         , Wwg         , Gs^Vh       , Gg          , Rb          , Rb          , Rb          , Gs^Fds      , Rb          , Hh^Fds      , Rb          , Gg          , Gg          , Gg          , Gg          , Ww          , Ww          , Gg          , Wwg         , Wwg         , Gg          , Rr          , Gs^Fds      , Gs^Fds      , Gs^Fds      , Hh^Fds      , Gg          , Gs^Fds      , Hh^Fds      , Gg          , Gs^Fds      , Gs^Fds      , Hh^Fms      , Hh^Fds      , Hh^Fds      , Hh^Fds      , Hh^Fds      , Md          , Md          , Md          
Md          , Md          , Md          , Hh^Fds      , Hh^Fds      , Hh^Fds      , Wwg         , Gs^Fds      , Gg          , Hh^Fds      , Rb          , Hh^Fms      , Hh^Fds      , Rb          , Hh^Fds      , Rb          , Hh^Fds      , Rb          , Rb          , Hh^Fds      , Gg          , Gg          , Ww          , Wwg         , Gg          , Gg          , Rb          , Rr          , Gs^Fds      , Gs^Fds      , Hh^Fds      , Gs^Fds      , Hh^Fds      , Gg          , Gs^Fds      , Hh^Fds      , Gs^Fds      , Hh^Fms      , Hh^Fds      , Hh^Fds      , Hh^Fds      , Hh^Fds      , Hh^Fds      , Md          , Md          , Md          
Md          , Md          , Hh^Fds      , Hh^Fds      , Hh^Fds      , Gs^Fds      , Wwg         , Gg          , Rb          , Rb          , Hh^Fds      , Md          , Md          , Md          , Hh^Fds      , Hh^Fds      , Hh^Fds      , Gs^Fds      , Rb          , Hh^Fds      , Hh^Fds      , Gg          , Gg          , Ww          , Ww          , Rb          , Hh^Fds      , Rr          , Hh^Fds      , Hh^Fms      , Hh^Fms      , Gs^Fds      , Gs^Fds      , Gg          , Gg          , Hh^Fds      , Hh^Fds      , Gs^Fds      , Hh^Fds      , Hh^Fds      , Hh^Fds      , Hh^Fds      , Hh^Fds      , Md          , Md          , Md          
Md          , Hh^Fds      , Hh^Fds      , Hh^Fds      , Gs^Fds      , Gg          , Wwg         , Rb          , Hh^Fds      , Gg          , Hh^Fds      , Md          , Md          , Md          , Hh^Fds      , Hh^Fds      , Hh^Fds      , Hh^Fds      , Gs^Fds      , Rb          , Gg          , Gg          , Gs          , Gg          , Ww^Bw/r     , Rb          , Gg          , Rr          , Rr          , Gg          , Gg          , Gs^Fds      , Gg          , Gs^Fds      , Hh^Fds      , Hh^Fds      , Hh^Fds      , Hh^Fds      , Hh^Fds      , Hh^Fds      , Hh^Fds      , Hh^Fds      , Hh^Fds      , Md          , Md          , Md          
Md          , Hh^Fds      , Hh^Fds      , Hh^Fds      , Wwg         , Wwg         , Gs^Fds      , Rb          , Gs^Vh       , Gg          , Md          , Md          , Md          , Md          , Hh^Fds      , Hh^Fds      , Hh^Fds      , Hh^Fds      , Gs^Fds      , Rb          , Gg          , Gs          , Rb          , Rb          , Gg          , Ww          , Gg          , Gg          , Gs          , Rr          , Gs          , Gg          , Gg          , Gs^Fds      , Hh^Fds      , Hh^Fds      , Hh^Fds      , Hh^Fds      , Hh^Fds      , Hh^Fds      , Hh^Fms      , Hh^Fds      , Hh^Fds      , Hh^Fds      , Hh^Fds      , Md          
Md          , Hh^Fds      , Hh^Fds      , Hh^Fds      , Wwg         , Gs^Fds      , Gg          , Rb          , Gg          , Hh^Fds      , Md          , Mm^Xm       , Md          , Md          , Hh^Fds      , Hh^Fds      , Hh^Fds      , Hh^Fds      , Gs^Fds      , Rb          , Rb          , Rb          , Gg          , Gg          , Chr         , Ww          , Ww          , Gs          , Gs          , Rr          , Gs          , Gs^Vh       , Gs          , Gg          , Gg          , Hh^Fds      , Gs^Fds      , Gs^Fds      , Hh^Fds      , Hh^Fds      , Hh^Fds      , Hh^Fds      , Hh^Fds      , Hh^Fds      , Hh^Fds      , Md          
Md          , Hh^Fds      , Hh^Fds      , Hh^Fds      , Wwg         , Gs^Fds      , Gs^Vh       , Rb          , Md          , Md          , Mm^Xm       , Mm^Xm       , Md          , Hh^Fds      , Hh^Fds      , Hh^Fds      , Hh^Fds      , Gs^Fds      , Gg          , Gg          , Rb          , Gs          , Gg          , Chr         , 3 Khr       , Chr         , Ww          , Gg          , Gg          , Rr          , Rr          , Gg          , Gg          , Gg          , Gg          , Gg          , Hh^Fds      , Hh^Fds      , Hh^Fds      , Hh^Fds      , Hh^Fms      , Hh^Fds      , Hh^Fds      , Hh^Fds      , Hh^Fds      , Hh^Fds      
Md          , Md          , Hh^Fds      , Hh^Fds      , Wwg         , Gs^Fds      , Hh^Fds      , Md          , Md          , Md          , Mm^Xm       , Md          , Md          , Hh^Fds      , Hh^Fds      , Hh^Fds      , Hh^Fds      , Hh^Fms      , Gg          , Gs^Vh       , Rb          , Gs          , Gg          , Chr         , Chr         , Chr         , Chr         , Ww          , Gg          , Gg          , Rr          , Gg          , Gg          , Gs          , Gs          , Gg          , Gg          , Hh^Fds      , Hh^Fds      , Hh^Fds      , Hh^Fds      , Hh^Fds      , Hh^Fds      , Hh^Fds      , Hh^Fds      , Hh^Fds      
Mm^Xm       , Md          , Md          , Md          , Md          , Md          , Md          , Md          , Mm^Xm       , Mm^Xm       , Mm^Xm       , Md          , Md          , Hh^Fds      , Hh^Fds      , Hh^Fds      , Hh^Fds      , Hh^Fds      , Gg          , Gg          , Gg          , Rb          , Gg          , Gg          , Gs          , Chr         , Gg          , Ww          , Ww          , Gg          , Rr          , Gg          , Gg          , Gs          , Gs          , Gs          , Gs          , Gg          , Gg          , Hh^Fds      , Hh^Fms      , Hh^Fds      , Hh^Fds      , Hh^Fds      , Hh^Fds      , Hh^Fds      
Mm^Xm       , Mm^Xm       , Mm^Xm       , Md          , Md          , Md          , Md          , Mm^Xm       , Mm^Xm       , Mm^Xm       , Mm^Xm       , Md          , Md          , Md          , Md          , Hh^Fds      , Hh^Fds      , Gs          , Gs          , Gs          , Gs          , Rb          , Gg          , Gs          , Gs          , Gs          , Gs          , Gs          , Ww          , Gs          , Gs          , Rr          , Gg          , Gs          , Gs          , Gs          , Gs          , Gs          , Gs          , Gs          , Gg          , Hh^Fds      , Hh^Fds      , Hh^Fds      , Hh^Fds      , Hh^Fds      
