border_size=1
usage=map

Md^Xm       , Md^Xm       , Md^Xm       , Md          , Md          , Md          , Md          , Hd          , Hd          , Dd          , Dd          , Dd          , Dd          , Dd          , Dd          , Dd          , Dd          , Dd          , Dd          , Gd          , Gd          , Ss          , Gd          , Hd          , Hd          , Hd          , Md          , Md^Xm       , Md^Xm       , Md^Xm       , Md          , Md          , Md          , Hd          , Hd          , Dd          , Hd          , Hd          , Hd          , Md          , Md          , Md          , Md          , Md          , Md          , Md^Xm       
Md^Xm       , Md          , Md          , Md          , Hd          , Md          , Hd          , Hd          , Dd          , Dd          , Dd          , Dd          , Hd          , Dd          , Rr^Vd       , Dd^Esd      , Dd          , Dd          , Hd          , Gd          , Ss          , Ss          , Gd          , Gd          , Hd          , Md          , Md          , Md^Xm       , Md          , Md          , Hd          , Md          , Hd          , Hd          , Hd          , Hd          , Chr         , Ch          , Chr         , Hd          , Hd          , Md          , Md          , Md          , Md          , Md          
Md^Xm       , Md          , Md          , Hd          , Hd          , Hd          , Hd          , Hd          , Dd          , Dd          , Dd          , Dd          , Hd          , Hd          , Hd          , Hd          , Hd          , Hd          , Gd          , Gd          , Ss          , Gd          , Hd          , Hd          , Hd          , Md          , Md^Xm       , Md^Xm       , Md          , Hd          , Hd          , Hd          , Hd          , Hd          , Rd^Esd      , Dd^Vdt      , Ch          , 2 Kh        , Ch          , Hd          , Dd          , Hd          , Hd          , Md          , Md          , Md          
Md^Xm       , Md          , Md          , Hd          , Hd          , Hd          , Dd          , Dd          , Dd          , Rr^Vd       , Ch          , Ch          , Ch          , Hd          , Rd          , Hd          , Rd          , Gd          , Gd          , Ss          , Gd          , Gd          , Hd          , Hd          , Md          , Md          , Md          , Md          , Hd          , Hd          , Rd          , Rd          , Rd          , Rd          , Rd          , Rd          , Rd          , Ch          , Chr         , Dd          , Dd          , Dd          , Hd          , Md          , Hd          , Md          
Md^Xm       , Hd          , Hd          , Hd          , Hd          , Dd          , Dd          , Dd          , Dd          , Dd          , Ch          , 3 Kh        , Ch          , Ch          , Rd          , Rr^Vd       , Gd          , Gd          , Ss          , Ss          , Dd^Vdt      , Hd          , Dd          , Hd          , Md          , Md^Xm       , Md^Xm       , Hd          , Dd          , Dd          , Rd          , Rd          , Rd          , Rd          , Rd          , Rd          , Rd          , Rd          , Rd          , Rd          , Rd^Esd      , Dd          , Dd          , Hd          , Hd          , Hd          
Hd          , Hd          , Hd          , Hd          , Dd          , Dd          , Rd          , Rd          , Rr^Vd       , Dd          , Rd          , Ch          , Ch          , Ch          , Rd          , Rd          , Gd          , Gd          , Ss          , Gd          , Dd          , Dd          , Dd          , Hd          , Hd          , Md          , Md^Xm       , Hd          , Dd          , Dd^Vdt      , Dd          , Rd          , Rd          , Rd          , Dd^Vdt      , Rd          , Rd          , Rd          , Rd          , Rd          , Rd          , Dd          , Dd^Vdt      , Dd          , Hd          , Hd          
Hd          , Hd          , Dd          , Dd          , Dd          , Rd          , Rd          , Rd          , Rd          , Rd          , Rd          , Rd          , Rr^Vd       , Rd          , Rd          , Rd          , Gd          , Gd          , Ss          , Gd          , Dd          , Dd          , Dd          , Hd          , Hd          , Md          , Md          , Hd          , Dd          , Dd          , Dd          , Rd          , Dd^Esd      , Dd          , Hd          , Hd          , Rd          , Rd          , Rd          , Rd          , Rd          , Rd          , Hd          , Dd          , Hd          , Hd          
Dd          , Dd          , Dd          , Dd          , Rd          , Rd          , Rd          , Rd          , Dd          , Rd          , Hd          , Rd          , Hd          , Hd          , Rd          , Rd          , Gd          , Gd          , Ss          , Gd          , Gd          , Dd          , Dd          , Hd          , Hd          , Md^Xm       , Md          , Hd          , Dd          , Dd          , Rd          , Dd          , Dd          , Dd          , Hd          , Hd          , Rd          , Rd          , Rd^Esd      , Rd          , Hd          , Hd          , Hd          , Dd          , Hd          , Hd          
Dd          , Dd          , Rd          , Rd          , Rd          , Rd          , Dd          , Dd          , Dd          , Dd          , Dd^Vdt      , Hd          , Hd          , Hd          , Hd          , Hd          , Hd          , Gd          , Ss          , Gd          , Gd          , Dd          , Dd          , Dd          , Hd          , Md^Xm       , Hd          , Hd          , Dd          , Dd          , Dd          , Dd          , Dd          , Hd          , Rd          , Rd          , Rd          , Rd          , Rd          , Rd          , Rd          , Hd          , Hd          , Hd          , Dd          , Hd          
Dd          , Dd          , Dd          , Rd          , Rd          , Dd          , Dd          , Dd          , Dd          , Dd          , Dd          , Hd          , Hd          , Hd          , Hd          , Hd          , Gd          , Gd          , Gd          , Ss          , Gd          , Dd          , Dd          , Hd          , Md^Xm       , Md^Xm       , Hd          , Dd          , Dd          , Dd          , Rd          , Dd          , Rd          , Rd          , Rd          , Rd          , Rd          , Rd          , Rd          , Rd          , Rd          , Hd          , Hd          , Hd          , Dd          , Dd          
Rd^Esd      , Dd^Esd      , Rd          , Rd          , Rd          , Dd          , Dd          , Dd^Esd      , Dd          , Dd^Esd      , Dd          , Dd          , Rd          , Rd          , Rd          , Gd          , Gd          , Gd          , Gd          , Ss          , Gd          , Dd          , Dd          , Hd          , Md^Xm       , Md          , Hd          , Dd          , Dd          , Rd          , Rd          , Rd          , Rd          , Rd          , Rd          , Rd          , Rd          , Rd          , Rd          , Rd          , Rd          , Rd          , Hd          , Dd^Vdt      , Dd          , Dd          
Dd          , Dd          , Rd          , Rd          , Rd          , Rd          , Rd          , Rd          , Rd          , Dd          , Dd          , Rd          , Rd          , Rd          , Hd          , Gd          , Gd          , Gd          , Ss          , Ss          , Dd          , Dd          , Dd          , Dd^Vdt      , Md          , Md          , Hd          , Dd          , Dd          , Rd          , Rd          , Rd          , Dd          , Dd          , Dd^Vdt      , Dd          , Dd          , Rd          , Rd          , Rd          , Rd          , Rd          , Rd          , Rd          , Dd          , Dd          
Rd          , Rd          , Rd          , Rd          , Rd          , Rd          , Rd          , Rd          , Dd          , Dd^Esd      , Dd          , Dd          , Dd          , Hd          , Hd          , Hd          , Gd          , Gd          , Ss          , Gd          , Dd          , Dd          , Hd          , Md^Xm       , Md          , Hd          , Dd          , Dd          , Rd          , Rd          , Dd          , Dd          , Dd^Esd      , Dd          , Dd          , Dd          , Dd          , Rd          , Rd          , Rd          , Rd^Esd      , Rd          , Rd          , Rd          , Rd          , Dd          
Rd          , Rd          , Rd^Esd      , Rd          , Rd^Esd      , Rd          , Rd          , Rd          , Dd          , Dd          , Dd          , Dd^Esd      , Dd          , Hd          , Hd          , Hd          , Gd          , Gd          , Ss          , Gd          , Dd          , Dd          , Hd          , Hd          , Hd          , Hd          , Dd          , Dd          , Rd          , Rd          , Dd          , Dd          , Hd          , Dd          , Hd          , Hd          , Rd          , Rd          , Rd          , Rd          , Rd          , Rd          , Rd          , Rd^Esd      , Rd          , Dd          
Rd          , Rd          , Rd          , Rd          , Rd          , Rd          , Rd          , Rd          , Dd^Vdt      , Dd          , Dd          , Dd          , Rd          , Dd          , Rd          , Hd          , Gd          , Gd          , Ss          , Gd          , Gd          , Dd          , Dd          , Dd          , Dd          , Dd          , Dd          , Dd          , Rd          , Rd          , Rd          , Hd          , Hd          , Hd          , Hd          , Hd          , Rd          , Rd          , Rd          , Rd          , Rd          , Rd          , Rd          , Rd          , Rd          , Rd          
Rd          , Rd          , Rd          , Rd          , Rd          , Rd          , Rd          , Rd          , Rd          , Rd          , Rd          , Rd          , Rd          , Rd          , Rd          , Rd          , Gd          , Gd          , Ss          , Gd          , Gd          , Gd          , Gd          , Dd          , Rd          , Dd          , Rd          , Dd          , Rd          , Rd          , Rd          , Hd          , Rd          , Rd          , Rd          , Rd          , Rd          , Rd          , Rd          , Rd          , Rd          , Rd          , Hd          , Dd          , Dd          , Dd          
Rd          , Rd          , Rd          , Rd          , Rd          , Rd          , Rd          , Rd          , Rd          , Rd          , Rd          , Rd          , Rd          , Rd          , Rd          , Rd          , Rd          , Gd          , Gd          , Ss          , Ss          , Gd          , Gd          , Rd          , Rd          , Rd          , Rd          , Rd          , Rd          , Rd          , Rd          , Rd          , Rd          , Rd          , Rd          , Rd          , Rd          , Rd          , Rd          , Rd          , Hd          , Hd          , Dd          , Dd^Esd      , Dd          , Dd          
Rd          , Rd          , Rd          , Rd          , Rd          , Rd          , Rd^Esd      , Rd          , Rd          , Rd          , Rd          , Hd          , Hd          , Hd          , Hd          , Rd          , Rd          , Rd          , Gd          , Gd          , Gd          , Ss          , Gd          , Rd          , Rd          , Rd          , Rd          , Rd          , Rd          , Rd          , Rd          , Rd          , Hd          , Rd          , Rd          , Rd          , Rd          , Rd          , Rd          , Rd          , Hd          , Hd          , Hd          , Dd          , Dd          , Dd          
Rd          , Rd          , Rd          , Rd          , Rd          , Rd          , Rd          , Rd^Esd      , Rd^Esd      , Rd          , Rd          , Hd          , Hd          , Hd          , Hd          , Dd          , Dd          , Dd          , Dd^Vdt      , Gd          , Gd          , Ss          , Gd          , Rd          , Rd          , Rd          , Rd          , Hd          , Hd          , Rd          , Hd          , Hd          , Dd          , Dd          , Dd          , Dd          , Dd          , Rd          , Rd          , Rd          , Hd          , Hd          , Dd          , Dd          , Dd          , Dd          
Rd          , Rd          , Rd          , Rd          , Rd          , Rd          , Rd          , Rd^Esd      , Rd          , Rd          , Rd          , Rd          , Hd          , Hd          , Dd          , Dd          , Dd          , Dd          , Dd          , Rd          , Gd          , Ss          , Ss          , Gd          , Gd          , Rd          , Rd          , Dd          , Hd          , Hd          , Dd          , Dd          , Dd          , Dd          , Dd^Esd      , Dd^Vdt      , Dd          , Rd          , Rd          , Rd          , Rd          , Hd          , Rd          , Dd^Vdt      , Rd          , Rd          
Rd          , Rd          , Rd          , Rd          , Rd^Esd      , Rd          , Rd          , Rd          , Rd          , Rd          , Rd          , Rd          , Rd          , Hd          , Rd          , Dd          , Rd          , Dd          , Rd          , Rd          , Gd          , Gd          , Gd          , Ss          , Gd          , Rd          , Dd^Vdt      , Dd          , Dd          , Hd          , Hd          , Hd          , Dd          , Dd          , Dd          , Dd          , Rd          , Rd          , Hd          , Rd          , Rd          , Rd          , Rd          , Rd^Esd      , Rd          , Rd          
Rd          , Rd          , Rd          , Rd          , Rd          , Rd          , Rd          , Rd          , Rd          , Rd          , Rd          , Rd          , Rd          , Rd          , Rd          , Rd          , Rd          , Rd          , Rd          , Rd          , Rd          , Gd          , Gd          , Ss          , Ss          , Gd          , Rd          , Rd          , Rd          , Dd          , Dd          , Dd          , Rd          , Rd          , Rd          , Rd          , Rd          , Rd          , Hd          , Rd          , Rd          , Rd          , Hd          , Rd          , Rd          , Rd          
Rd          , Rd          , Rd          , Rd          , Hd          , Rd          , Rd          , Rd          , Rd          , Rd          , Rd          , Rd          , Rd          , Rd          , Rd          , Rd          , Rd          , Rd          , Rd          , Rd          , Dd          , Rd          , Dd          , Gd          , Ss          , Gd          , Gd          , Rd          , Rd          , Rd          , Rd          , Rd          , Rd          , Rd          , Rd          , Rd          , Rd          , Rd          , Hd          , Hd          , Hd          , Hd          , Hd          , Rd          , Hd          , Rd          
Rd          , Rd          , Rd          , Rd          , Hd          , Hd          , Hd          , Hd          , Hd          , Rd          , Rd          , Rd          , Rd          , Rd          , Rd          , Rd          , Rd          , Rd          , Dd          , Dd          , Hd          , Hd          , Hd          , Hd          , Hd          , Ss          , Ss          , Gd          , Gd          , Rd          , Rd          , Rd          , Rd          , Rd          , Rd          , Rd^Esd      , Rd          , Rd          , Rd          , Rd          , Rd          , Hd          , Hd          , Hd          , Dd          , Dd          
Dd          , Dd          , Dd          , Dd          , Dd          , Hd          , Hd^Esd      , Hd          , Hd          , Rd          , Rd          , Rd          , Rd          , Rd          , Rd          , Rd^Esd      , Rd          , Rd          , Dd          , Dd          , Rd          , Dd          , Hd          , Hd          , Gd          , Gd          , Ss          , Gd          , Gd          , Rd          , Rd          , Rd          , Rd          , Rd          , Rd          , Rd          , Rd          , Rd          , Rd          , Rd          , Rd          , Rd          , Dd          , Dd          , Dd          , Rd          
Rd          , Rd          , Dd          , Dd          , Dd          , Dd          , Dd          , Dd          , Dd^Vdt      , Hd          , Rd          , Rd          , Rd          , Rd          , Rd          , Rd          , Rd          , Rd          , Rd          , Rd          , Rd          , Rd          , Rd          , Gd          , Gd          , Gd          , Ss          , Gd          , Rd^Esd      , Rd          , Rd          , Rd          , Rd          , Rd          , Hd          , Hd          , Hd          , Hd          , Rd          , Rd          , Rd          , Rd          , Dd          , Dd^Vdt      , Dd          , Dd          
Rd          , Rd          , Dd          , Dd^Esd      , Dd          , Dd          , Rd          , Dd          , Rd          , Rd          , Rd          , Rd          , Rd          , Rd          , Rd          , Rd          , Rd          , Rd          , Rd          , Rd          , Rd          , Rd          , Rd          , Gd          , Ss          , Ss          , Gd          , Gd          , Rd^Esd      , Rd          , Rd          , Rd          , Rd          , Rd          , Hd          , Hd          , Dd          , Hd          , Hd          , Rd          , Rd          , Rd          , Dd          , Dd          , Rd          , Dd          
Dd          , Dd          , Dd          , Dd          , Rd          , Rd          , Rd          , Rd          , Rd          , Rd          , Rd          , Rd          , Rd          , Rd          , Rd          , Rd          , Rd          , Rd          , Rd          , Rd          , Rd          , Rd          , Gd          , Gd          , Ss          , Gd          , Rd          , Rd          , Rd          , Hd          , Hd          , Hd          , Hd          , Hd          , Dd          , Dd          , Dd          , Hd          , Dd          , Rd          , Rd          , Rd          , Rd          , Rd^Esd      , Rd          , Rd          
Rd          , Rd          , Rd          , Rd          , Rd          , Rd          , Rd          , Rd          , Rd          , Rd          , Rd          , Rd          , Rd          , Rd          , Rd          , Rd          , Dd          , Dd          , Dd          , Hd          , Hd          , Rd          , Ss          , Ss          , Hd          , Hd          , Hd          , Hd          , Hd          , Hd          , Hd          , Hd          , Dd          , Dd          , Dd^Esd      , Dd          , Dd          , Dd          , Dd^Vdt      , Rd          , Rd          , Rd          , Rd          , Rd          , Rd          , Rd          
Rd          , Rd          , Rd          , Rd          , Rd          , Rd          , Rd          , Rd          , Rd^Esd      , Rd          , Rd          , Rd          , Rd          , Rd          , Rd          , Rd          , Dd          , Dd^Vdt      , Dd          , Hd          , Hd          , Hd          , Ss          , Gd          , Rd          , Hd          , Rd          , Hd          , Hd          , Hd          , Hd          , Hd          , Dd^Esd      , Dd          , Dd          , Dd          , Rd          , Dd          , Rd          , Rd          , Rd          , Rd          , Rd          , Rd^Esd      , Rd          , Rd          
Rd          , Rd          , Rd          , Rd          , Rd          , Rd          , Rd          , Rd          , Rd          , Rd          , Rd          , Rd          , Rd          , Rd          , Rd          , Dd          , Rd^Esd      , Dd          , Rd          , Hd          , Rd          , Gd          , Ss          , Gd          , Rd          , Rd          , Hd          , Hd          , Hd          , Hd          , Rd          , Dd          , Rd          , Dd          , Rd          , Rd          , Rd          , Rd          , Rd          , Rd          , Rd          , Rd          , Rd          , Rd          , Rd          , Rd          
Rd          , Rd          , Rd          , Rd          , Rd          , Rd          , Dd^Vdt      , Rd          , Rd          , Rd          , Rd          , Rd          , Cdr         , Rd          , Rd^Esd      , Rd          , Rd          , Rd          , Rd          , Rd          , Rd          , Gd          , Ss          , Gd          , Rd          , Rd          , Rd          , Rd          , Rd          , Rd          , Rd          , Rd          , Rd          , Rd          , Rd          , Rd          , Rd          , Rd          , Rd          , Rd          , Rd          , Rd          , Rd          , Rd          , Rd          , Rd          
Rd          , Rd^Esd      , Rd          , Rd          , Dd          , Dd          , Dd          , Dd          , Dd^Esd      , Dd          , Cdr         , Cdr         , 1 Kdr       , Cdr         , Cdr         , Rd          , Rd          , Rd          , Rd          , Rd          , Gd          , Gd          , Ss          , Gd          , Rd          , Rd          , Rd          , Rd          , Rd          , Rd          , Rd          , Rd          , Rd          , Rd          , Rd          , Rd          , Rd          , Hd          , Hd          , Hd          , Hd          , Hd          , Dd          , Dd          , Dd          , Dd          
Rd          , Rd          , Rd          , Rd          , Rd          , Dd          , Rd          , Dd          , Rd          , Rd          , Rd          , Cdr         , Cdr         , Cdr         , Cdr         , Rd          , Rd          , Rd          , Gd          , Gd          , Ss          , Ss          , Gd          , Gd          , Hd          , Rd          , Rd          , Rd^Esd      , Rd          , Rd          , Rd          , Dd^Vdt      , Rd          , Rd          , Rd          , Rd          , Hd          , Hd          , Hd          , Hd          , Dd          , Dd          , Dd          , Dd^Esd      , Dd          , Dd          
Rd          , Rd          , Rd          , Rd          , Rd          , Rd          , Rd          , Rd          , Rd          , Rd          , Rd          , Cdr         , Rd          , Cdr         , Rd          , Rd          , Rd          , Rd          , Gd          , Gd          , Ss          , Gd          , Hd          , Hd          , Hd          , Hd          , Rd          , Rd          , Rd          , Rd          , Rd          , Rd          , Rd          , Rd          , Rd          , Rd          , Rd          , Rd          , Dd          , Hd          , Dd          , Dd          , Dd          , Dd          , Dd          , Dd          
