border_size=1
usage=map

Xuc         , Xuc         , Xuc         , Xuc         , Xuc         , Xuc         , Xuc         , Xuc         , Xuc         , Xuc         , Xuc         , Xuc         , Xuc         , Xuc         , Xuc         , Xuc         , Xuc         , Xuc         , Xuc         , Xuc         , Xuc         , Xuc         , Xuc         , Xuc         , Xuc         , Xuc         , Xuc         , Xuc         , Xuc         , Xuc         , Xuc         , Xuc         , Xuc         , Xuc         , Xuc         , Xuc         , Xuc         , Uu          , Uu          , Uu          , Xuc         , Xuc         , Xuc         , Xuc         , Xuc         , Xuc         
Xuc         , Xuc         , Xuc         , Xuc         , Xuc         , Xuc         , Xuc         , Xuc         , Xuc         , Xuc         , Xuc         , Xuc         , Xuc         , Xuc         , Xuc         , Xuc         , Xuc         , Xuc         , Xuc         , Xuc         , Xuc         , Xuc         , Xuc         , Xuc         , Xuc         , Xuc         , Xuc         , Xuc         , Xuc         , Xuc         , Xuc         , Xuc         , Xuc         , Xuc         , Xuc         , Xuc         , Cud         , Cud         , Cud         , Uu          , Xuc         , Xuc         , Xuc         , Xuc         , Xuc         , Xuc         
Xuc         , Xuc         , Xuc         , Xuc         , Xuc         , Xuc         , Xuc         , Xuc         , Xuc         , Xuc         , Xuc         , Xuc         , Xuc         , Xuc         , Xuc         , Xuc         , Xuc         , Xuc         , Xuc         , Xuc         , Xuc         , Xuc         , Xuc         , Xuc         , Xuc         , Xuc         , Xuc         , Xuc         , Xuc         , Xuc         , Xuc         , Xuc         , Xuc         , Xuc         , Xuc         , Xuc         , Cud         , 3 Kud       , Cud         , Cud         , Xuc         , Xuc         , Xuc         , Xuc         , Xuc         , Xuc         
Xuc         , Xuc         , Xuc         , Xuc         , Xuc         , Xuc         , Xuc         , Xuc         , Xuc         , Xuc         , Xuc         , Xuc         , Xuc         , Xuc         , Xuc         , Xuc         , Xuc         , Xuc         , Xuc         , Xuc         , Xuc         , Xuc         , Xuc         , Xuc         , Xuc         , Xuc         , Xuc         , Uh          , Uh          , Xuc         , Xuc         , Xuc         , Xuc         , Xuc         , Xuc         , Xuc         , Uu          , Cud         , Ur          , Cud         , Uu          , Xuc         , Xuc         , Xuc         , Xuc         , Xuc         
Xuc         , Xuc         , Xuc         , Xuc         , Xuc         , Xuc         , Xuc         , Xuc         , Xuc         , Xuc         , Xuc         , Xuc         , Xuc         , Xuc         , Xuc         , Xuc         , Xuc         , Xuc         , Xuc         , Xuc         , Xuc         , Xuc         , Xuc         , Xuc         , Xuc         , Uh          , Uh          , Uh          , Uu^Uf       , Uu^Vud      , Uu^Uf       , Xuc         , Xuc         , Xuc         , Xuc         , Xuc         , Uh          , Uu          , Ur          , Ur          , Uh          , Uu^Vud      , Xuc         , Xuc         , Xuc         , Xuc         
Xuc         , Xuc         , Xuc         , Xuc         , Xuc         , Xuc         , Xuc         , Xuc         , Xuc         , Xuc         , Xuc         , Xuc         , Xuc         , Xuc         , Xuc         , Xuc         , Xuc         , Xuc         , Xuc         , Xuc         , Xuc         , Xuc         , Xuc         , Xuc         , Uu^Uf       , Uu^Uf       , Ur          , Ur          , Ur          , Ur          , Uh          , Xuc         , Xuc         , Xuc         , Xuc         , Xuc         , Xuc         , Ur          , Xuc         , Ur          , Uh          , Xuc         , Xuc         , Xuc         , Xuc         , Xuc         
Xuc         , Xuc         , Xuc         , Xuc         , Xuc         , Xuc         , Xuc         , Xuc         , Xuc         , Xuc         , Xuc         , Xuc         , Xuc         , Xuc         , Xuc         , Xuc         , Xuc         , Xuc         , Xuc         , Xuc         , Xuc         , Xuc         , Xuc         , Uu^Vud      , Uh          , Ur          , Ur          , Ur          , Ur          , Ur          , Zaw         , Xuc         , Xuc         , Xuc         , Xuc         , Xuc         , Cud         , Cud         , Xuc         , Ur          , Xuc         , Xuc         , Xuc         , Xuc         , Xuc         , Xuc         
Xuc         , Xuc         , Xuc         , Xuc         , Xuc         , Xuc         , Xuc         , Xuc         , Xuc         , Xuc         , Xuc         , Xuc         , Xuc         , Xuc         , Xuc         , Xuc         , Xuc         , Xuc         , Xuc         , Xuc         , Xuc         , Xuc         , Cud         , Xuc         , Uu          , Uu          , Uh          , Ur          , Ur          , Uu          , Xuc         , Cud         , Cud         , Uh          , Uu          , Xuc         , Ur          , Xuc         , Cud         , Cud         , Xuc         , Xuc         , Xuc         , Xuc         , Xuc         , Xuc         
Xuc         , Xuc         , Xuc         , Xuc         , Xuc         , Xuc         , Xuc         , Xuc         , Xuc         , Xuc         , Xuc         , Xuc         , Xuc         , Xuc         , Xuc         , Xuc         , Uu^Uf       , Xuc         , Xuc         , Xuc         , Uu^Vud      , Uh          , Xuc         , Cud         , Xuc         , Xuc         , Uu          , Ur          , Ur          , Ur          , Uu^Uf       , Cud         , Xuc         , Xuc         , Uu          , Ur          , Ur          , Ur          , Uh          , Xuc         , Xuc         , Xuc         , Xuc         , Xuc         , Xuc         , Xuc         
Xuc         , Xuc         , Xuc         , Xuc         , Xuc         , Xuc         , Xuc         , Xuc         , Xuc         , Xuc         , Xuc         , Xuc         , Xuc         , Xuc         , Xuc         , Xuc         , Uu^Uf       , Ur          , Ur          , Ur          , Ur          , Ur          , Ur          , Uu          , Cud         , Cud         , Uu^Dr       , Uu^Vud      , Uh          , Ur          , Ur          , Uu^Vud      , Uh          , Cud         , Xuc         , Uu^Vud      , Xuc         , Ur          , Ur          , Xuc         , Xuc         , Xuc         , Xuc         , Xuc         , Xuc         , Xuc         
Xuc         , Xuc         , Xuc         , Xuc         , Xuc         , Xuc         , Xuc         , Xuc         , Xuc         , Xuc         , Ur          , Xuc         , Uu          , Xuc         , Ur          , Xuc         , Cud         , Uu          , Ur          , Ur^Dr       , Ur          , Ur          , Uu^Dr       , Uu^Uf       , Xuc         , Cud         , Xuc         , Ur^Dr       , Uu          , Ur          , Ur          , Ur          , Ur          , Uh          , Xuc         , Xuc         , Cud         , Xuc         , Ur          , Xuc         , Xuc         , Xuc         , Xuc         , Xuc         , Xuc         , Xuc         
Xuc         , Xuc         , Xuc         , Xuc         , Xuc         , Xuc         , Xuc         , Xuc         , Uh^Dr       , Zaw         , Xuc         , Ur          , Xuc         , Ur          , Uu          , Cud         , Xuc         , Cud         , Xuc         , Uu^Vud      , Uu          , Ur          , Ur          , Xuc         , Ur          , Xuc         , Ur          , Ur          , Xuc         , Xuc         , Ur          , Ur^Dr       , Ur^Dr       , Ur          , Uu^Vud      , Uu          , Uu          , Uu          , Ur          , Xuc         , Uh          , Xuc         , Xuc         , Xuc         , Xuc         , Xuc         
Xuc         , Xuc         , Xuc         , Xuc         , Xuc         , Xuc         , Xuc         , Xuc         , Xuc         , Uu          , Uu^Vud      , Ur^Dr       , Ur          , Xuc         , Xuc         , Xuc         , Xuc         , Xuc         , Uu          , Cud         , Cud         , Uu          , Ur          , Ur          , Xuc         , Xuc         , Uu^Vud      , Ur          , Xuc         , Xuc         , Ur          , Ur          , Ur          , Ur^Dr       , Uu^Uf       , Uu^Dr       , Cud         , Xuc         , Zaw         , Ur          , Ur          , Xuc         , Xuc         , Xuc         , Xuc         , Xuc         
Xuc         , Xuc         , Xuc         , Xuc         , Xuc         , Xuc         , Xuc         , Xuc         , Xuc         , Xuc         , Ur          , Ur          , Uu          , Uh          , Uh          , Xuc         , Ur^Dr       , Ur          , Uh          , Cud         , Xuc         , Xuc         , Xuc         , Ur          , Uu^Vud      , Xuc         , Xuc         , Uu          , Cud         , Uu          , Uu          , Ur          , Ur          , Ur          , Uu^Uf       , Uu^Uf       , Xuc         , Cud         , Uu^Dr       , Ur          , Ur          , Uu^Vud      , Xuc         , Xuc         , Xuc         , Xuc         
Xuc         , Xuc         , Xuc         , Xuc         , Xuc         , Xuc         , Xuc         , Xuc         , Xuc         , Xuc         , Ur          , Ur          , Cud         , Cud         , Xuc         , Uh          , Ur          , Xuc         , Xuc         , Xuc         , Cud         , Xuc         , Xuc         , Xuc         , Cud         , Uu          , Xuc         , Xuc         , Cud         , Cud         , Xuc         , Uu^Dr       , Ur^Dr       , Ur          , Ur          , Xuc         , Xuc         , Uh          , Ur          , Ur          , Uu          , Uu^Uf       , Xuc         , Xuc         , Xuc         , Xuc         
Xuc         , Xuc         , Xuc         , Xuc         , Xuc         , Xuc         , Xuc         , Xuc         , Xuc         , Ur          , Uu^Vud      , Uu          , Uu          , Cud         , Uu^Vud      , Uu          , Uh          , Xuc         , Uu^Vud      , Uh          , Cud         , Cud         , Uu          , Uh          , Cud         , Cud         , Uu          , Uu          , Ur          , Xuc         , Uu^Uf       , Uu          , Uu^Dr       , Ur          , Ur          , Ur          , Ur          , Ur          , Ur          , Uu^Vud      , Xuc         , Uh          , Xuc         , Xuc         , Xuc         , Xuc         
Xuc         , Xuc         , Xuc         , Xuc         , Xuc         , Xuc         , Xuc         , Xuc         , Xuc         , Uh          , Ur          , Xuc         , Ur          , Ur          , Uu^Dr       , Ur          , Uu          , Xuc         , Cud         , Uu          , Uu          , Cud         , Uu^Uf       , Xuc         , Kud         , Cud         , Xuc         , Ur          , Ur          , Ur          , Uu          , Uu^Vud      , Uu^Uf       , Ur          , Ur          , Uu          , Xuc         , Uu^Uf       , Xuc         , Cud         , Cud         , Xuc         , Xuc         , Xuc         , Xuc         , Xuc         
Xuc         , Xuc         , Xuc         , Xuc         , Xuc         , Xuc         , Xuc         , Xuc         , Xuc         , Xuc         , Ur          , Uu          , Ur          , Uu          , Uu^Dr       , Ur^Dr       , Uu          , Cud         , 2 Kud       , 1 Cud       , Xuc         , Uu^Vud      , Uu          , Cud         , Cud         , Cud         , Uu^Vud      , Xuc         , Uu          , Ur          , Xuc         , Xuc         , Cud         , Xuc         , Uu          , Ur          , Xuc         , Ur          , Xuc         , Xuc         , Uu          , Xuc         , Xuc         , Xuc         , Xuc         , Xuc         
Xuc         , Xuc         , Xuc         , Xuc         , Xuc         , Xuc         , Xuc         , Xuc         , Xuc         , Uh          , Uh          , Ur          , Ur^Dr       , Ur          , Uu          , Zaw         , Uu          , Cud         , Cud         , Cud         , Ur          , Ur          , Xuc         , Uu^Vud      , Ur          , Ur          , Ur          , Ur          , Xuc         , Uu^Vud      , Uu^Dr       , Cud         , Cud         , Xuc         , Uh          , Ur          , Ur          , Uh          , Xuc         , Xuc         , Ur          , Ur          , Xuc         , Xuc         , Xuc         , Xuc         
Xuc         , Xuc         , Xuc         , Xuc         , Xuc         , Xuc         , Xuc         , Xuc         , Cud         , Cud         , Xuc         , Uu          , Uu          , Zaw         , Uu^Vud      , Xuc         , Xuc         , Xuc         , Uu          , Uu^Vud      , Ur          , Xuc         , Ur          , Ur          , Uu^Vud      , Ur          , Xuc         , Xuc         , Cud         , Uu^Dr       , Xuc         , Uu          , Uu          , Xuc         , Xuc         , Uu          , Ur          , Xuc         , Xuc         , Xuc         , Uu          , Uu^Vud      , Xuc         , Xuc         , Xuc         , Xuc         
Xuc         , Xuc         , Xuc         , Xuc         , Xuc         , Xuc         , Xuc         , Xuc         , Uh          , Xuc         , Uu          , Cud         , Xuc         , Zaw         , Uu          , Ur          , Cud         , Cud         , Cud         , Ur          , Xuc         , Ur          , Xuc         , Xuc         , Xuc         , Xuc         , Uu^Uf       , Cud         , Xuc         , Xuc         , Ur          , Uu^Uf       , Xuc         , Ur          , Uh          , Xuc         , Xuc         , Uh          , Xuc         , Xuc         , Cud         , Xuc         , Xuc         , Xuc         , Xuc         , Xuc         
Xuc         , Xuc         , Xuc         , Xuc         , Xuc         , Xuc         , Uh          , Zaw         , Uu^Vud      , Zaw         , Uh          , Zaw         , Uu^Vud      , Xuc         , Xuc         , Zaw         , Uu          , Cud         , Uu          , Xuc         , Uh          , Xuc         , Xuc         , Xuc         , Ur          , Ur          , Uu          , Uu          , Ur          , Ur          , Ur          , Ur          , Ur          , Ur          , Uu^Vud      , Xuc         , Cud         , Xuc         , Xuc         , Xuc         , Cud         , Xuc         , Xuc         , Xuc         , Xuc         , Xuc         
Xuc         , Xuc         , Xuc         , Xuc         , Cud         , Uu^Uf       , Zaw         , Zaw         , Zaw         , Zaw         , Uu          , Zaw         , Zaw         , Ur          , Zaw         , Uh          , Uu          , Uu          , Zaw         , Ur          , Ur          , Uh          , Zaw         , Ur          , Ur          , Ur          , Xuc         , Ur          , Uu^Uf       , Ur          , Xuc         , Xuc         , Xuc         , Ur          , Cud         , Cud         , Cud         , Uu          , Ur          , Ur          , Xuc         , Xuc         , Xuc         , Xuc         , Xuc         , Xuc         
Uu          , Xuc         , Uu          , Cud         , Cud         , Cud         , Uu          , Xuc         , Zaw         , Xuc         , Zaw         , Zaw         , Uu^Uf       , Xuc         , Ur          , Zaw         , Uu^Uf       , Xuc         , Uu^Vud      , Ur          , Ur          , Ur^Dr       , Ur          , Zaw         , Uu          , Ur          , Ur          , Xuc         , Xuc         , Uu          , Xuc         , Uu^Dr       , Ur^Dr       , Xuc         , Uu          , Cud         , Uu          , Ur          , Xuc         , Ur          , Uu^Vud      , Xuc         , Xuc         , Xuc         , Xuc         , Xuc         
Uu          , Uu          , Uu          , Cud         , 5 Kud       , Cud         , Zaw         , Zaw         , Zaw         , Zaw         , Zaw         , Zaw         , Zaw         , Ur          , Xuc         , Ur          , Ur          , Uu          , Cud         , Uu          , Xuc         , Zaw         , Ur          , Ur          , Uu          , Uu^Vud      , Uh          , Uh          , Xuc         , Xuc         , Uh          , Uh          , Ur          , Ur          , Uu          , Xuc         , Uu          , Uu          , Xuc         , Uu          , Ur          , Xuc         , Xuc         , Xuc         , Xuc         , Xuc         
Xuc         , Uu          , Uu          , Cud         , Cud         , Cud         , Uu^Vud      , Zaw         , Uu^Uf       , Zaw         , Zaw         , Uu^Dr       , Xuc         , Xuc         , Xuc         , Uu          , Xuc         , Xuc         , Cud         , Xuc         , Xuc         , Xuc         , Xuc         , Ur          , Xuc         , Xuc         , Cud         , Xuc         , Xuc         , Xuc         , Uh          , Uu^Vud      , Zaw         , Ur          , Ur          , Zaw         , Xuc         , Xuc         , Xuc         , Xuc         , Uu          , Ur          , Xuc         , Xuc         , Xuc         , Xuc         
Xuc         , Xuc         , Xuc         , Xuc         , Xuc         , Cud         , Zaw         , Zaw         , Uu          , Zaw         , Uu          , Zaw         , Cud         , Xuc         , Xuc         , Xuc         , Xuc         , Cud         , Xuc         , Xuc         , Xuc         , Xuc         , Cud         , Uu          , Cud         , Kud         , Cud         , Xuc         , Xuc         , Xuc         , Zaw^Dr      , Zaw^Dr      , Zaw         , Zaw         , Uh          , Ur          , Ur          , Xuc         , Xuc         , Uu^Uf       , Zaw         , Uh^Dr       , Xuc         , Xuc         , Xuc         , Xuc         
Xuc         , Xuc         , Xuc         , Xuc         , Xuc         , Xuc         , Xuc         , Uu^Dr       , Uu          , Uu          , Uu^Vud      , Uu          , Cud         , Cud         , Uu          , Xuc         , Zaw         , Uu^Uf       , Uh          , Uu^Vud      , Uu^Uf       , Cud         , Cud         , Cud         , Xuc         , Cud         , Xuc         , Xuc         , Cud         , Xuc         , Uu          , Zaw         , Zaw         , Uu          , Xuc         , Uu          , Uu          , Ur          , Ur          , Ur          , Ur^Dr       , Xuc         , Xuc         , Xuc         , Xuc         , Xuc         
Xuc         , Xuc         , Xuc         , Xuc         , Xuc         , Xuc         , Xuc         , Xuc         , Uu^Uf       , Uu          , Xuc         , Xuc         , Uu          , Uu          , Zaw         , Ur          , Ur          , Ur          , Xuc         , Xuc         , Xuc         , Uu          , Ur          , Xuc         , Ur          , Uu          , Uu          , Xuc         , Cud         , Xuc         , Uu          , Xuc         , Xuc         , Xuc         , Uh          , Uh          , Xuc         , Uu^Vud      , Xuc         , Uh          , Xuc         , Xuc         , Xuc         , Xuc         , Xuc         , Xuc         
Xuc         , Xuc         , Xuc         , Xuc         , Xuc         , Xuc         , Xuc         , Uu^Uf       , Xuc         , Cud         , Uu          , Zaw         , Uu^Vud      , Zaw         , Uu          , Ur          , Zaw         , Ur          , Ur          , Ur          , Ur          , Ur          , Uu^Dr       , Uu^Vud      , Ur          , Zaw         , Uu          , Cud         , Cud         , Cud         , Uu^Vud      , Ur          , Uu          , Uh          , Xuc         , Xuc         , Xuc         , Xuc         , Xuc         , Xuc         , Xuc         , Xuc         , Xuc         , Xuc         , Xuc         , Xuc         
Xuc         , Xuc         , Xuc         , Xuc         , Xuc         , Xuc         , Xuc         , Xuc         , Zaw         , Zaw         , Xuc         , Xuc         , Uu          , Uu^Uf       , Xuc         , Uu^Uf       , Uu^Uf       , Ur          , Zaw         , Zaw         , Xuc         , Xuc         , Xuc         , Zaw         , Uh          , Ur          , Ur          , Zaw         , Xuc         , Xuc         , Xuc         , Xuc         , Xuc         , Xuc         , Xuc         , Xuc         , Xuc         , Xuc         , Xuc         , Xuc         , Xuc         , Xuc         , Xuc         , Xuc         , Xuc         , Xuc         
Xuc         , Xuc         , Xuc         , Xuc         , Xuc         , Xuc         , Xuc         , Uu          , Uh          , Zaw         , Zaw         , Zaw         , Zaw         , Xuc         , Cud         , Xuc         , Uu^Uf       , Uu^Vud      , Cud         , Cud         , Cud         , Cud         , Xuc         , Uh          , Xuc         , Xuc         , Xuc         , Xuc         , Xuc         , Xuc         , Xuc         , Xuc         , Xuc         , Xuc         , Xuc         , Xuc         , Xuc         , Xuc         , Xuc         , Xuc         , Xuc         , Xuc         , Xuc         , Xuc         , Xuc         , Xuc         
Xuc         , Xuc         , Xuc         , Xuc         , Xuc         , Xuc         , Xuc         , Uh          , Xuc         , Uu^Vud      , Uh          , Uu          , Xuc         , Uu          , Xuc         , Cud         , Xuc         , Uu^Dr       , Cud         , 4 Kud       , Cud         , Cud         , Xuc         , Xuc         , Xuc         , Xuc         , Xuc         , Xuc         , Xuc         , Xuc         , Xuc         , Xuc         , Xuc         , Xuc         , Xuc         , Xuc         , Xuc         , Xuc         , Xuc         , Xuc         , Xuc         , Xuc         , Xuc         , Xuc         , Xuc         , Xuc         
Xuc         , Xuc         , Xuc         , Xuc         , Xuc         , Xuc         , Xuc         , Xuc         , Xuc         , Xuc         , Uh          , Uh          , Uh          , Zaw         , Uh          , Xuc         , Xuc         , Cud         , Uu          , Cud         , Cud         , Xuc         , Xuc         , Xuc         , Xuc         , Xuc         , Xuc         , Xuc         , Xuc         , Xuc         , Xuc         , Xuc         , Xuc         , Xuc         , Xuc         , Xuc         , Xuc         , Xuc         , Xuc         , Xuc         , Xuc         , Xuc         , Xuc         , Xuc         , Xuc         , Xuc         
Xuc         , Xuc         , Xuc         , Xuc         , Xuc         , Xuc         , Xuc         , Xuc         , Xuc         , Xuc         , Xuc         , Xuc         , Xuc         , Xuc         , Xuc         , Xuc         , Xuc         , Xuc         , Xuc         , Uu          , Uu          , Uu          , Uu          , Xuc         , Xuc         , Xuc         , Xuc         , Xuc         , Xuc         , Xuc         , Xuc         , Xuc         , Xuc         , Xuc         , Xuc         , Xuc         , Xuc         , Xuc         , Xuc         , Xuc         , Xuc         , Xuc         , Xuc         , Xuc         , Xuc         , Xuc         
