border_size=1
usage=map

Xv          , Xv          , Xv          , Xu          , Xu          , Xu          , Qxua        , Qxua        , Uu^Dr       , Qxua        , Qxua        , Qxua        , Qxua        , Qxua        , Qxua        , Xu          , Xu          , Xu          , Xu          , Xu          , Xv          , Xv          , Xv          , Xv          , Xv          , Xv          , Xv          , Xv          , Xv          , Xv          , Xv          , Xv          , Xv          
Xv          , Xv          , Xv          , Xu          , Qxua        , Xu          , Qxua        , Qxua        , Iwr^Es      , Uu^Dr       , Uu^Es       , Qxua        , Uu^Es       , Uu^Dr       , Uu^Es       , Uu^Dr       , Qlf         , Xu          , Xu          , Xu          , Xu          , Xv          , Xv          , Xv          , Xv          , Xv          , Ql          , Xv          , Xv          , Xv          , Xv          , Xv          , Xv          
Xu          , Xv          , Qxua        , Qxua        , Qxua        , Qxua        , Qxua        , Qxua        , Iwr^Es      , Iwr^Es      , Iwr^Dr      , Uu^Dr       , Iwr^Es      , Iwr^Es      , Iwr^Dr      , Xu          , Qlf         , Qlf         , Qlf         , Xu          , Uu^Dr       , Xu          , Xu          , Xv          , Ql          , Ql          , Ql          , Ql          , Ql          , Uu^Es       , Uu^Dr       , Xv          , Xv          
Qxua        , Xu          , Qxua        , Qxua        , Qxua        , Qxua        , Iwr^Dr      , Iwr^Es      , Iwr^Dr      , Iwr^Dr      , Iwr^Es      , Xu          , Iwr^Dr      , Iwr^Es      , Iwr^Dr      , Iwr^Es      , Xu          , Qlf         , Qlf         , Qlf         , Uu^Dr       , Uu^Es       , Uu^Es       , Uu^Dr       , Ql          , Ql          , Ql          , Xu          , Uu^Dr       , Ql          , Ql          , Ql          , Xv          
Qxua        , Qxua        , Qxua        , Qxua        , Qxua        , Iwr^Es      , Iwr^Es      , Iwr^Es      , Xu          , Iwr^Es      , Iwr^Es      , Iwr^Dr      , Iwr^Es      , Iwr^Dr      , Iwr^Dr      , Iwr^Dr      , Iwr^Es      , Iwr^Dr      , Iwr^Es      , Iwr^Es      , Iwr^Es      , Uu^Dr       , Uu^Es       , Xu          , Xu          , Ql          , Ql          , Ql          , Ql          , Xu          , Ql          , Ql          , Ql          
Qxua        , Qxua        , Qxua        , Qxua        , Iwr^Dr      , Iwr^Dr      , Iwr^Es      , Iwr^Dr      , Iwr^Es      , Iwr^Dr      , Iwr^Dr      , 3 Iwr^Es    , Iwr^Es      , Xu          , Iwr^Es      , Iwr^Dr      , Iwr^Dr      , Iwr^Dr      , Iwr^Es      , Iwr^Dr      , Iwr^Es      , Uu^Es       , Xos         , Xu          , Xu          , Ql          , Ql          , Ql          , Ql          , Ql          , Ql          , Ql          , Xu          
Xu          , Xu          , Xu          , Xol         , Xol         , Iwr^Es      , Xu          , Iwr^Dr      , Xu          , Iwr^Es      , Xu          , Iwr^Dr      , Iwr^Dr      , Iwr^Dr      , Iwr^Dr      , Iwr^Dr      , Iwr^Es      , Xu          , Xu          , Iwr^Es      , Iwr^Es      , Xos         , Xu          , Xu          , Xu          , Xos         , Uu^Es       , Ql          , Ql          , Ql          , Xu          , Xu          , Xu          
Xue         , Xu          , Xue         , Xu          , Xu          , Xu          , Xu          , Xu          , Xu          , Iwr^Es      , Iwr^Es      , Iwr^Dr      , Xu          , Iwr^Dr      , Iwr^Es      , Iwr^Dr      , Iwr^Es      , Xu          , Xu          , Xu          , Xol         , Xos         , Xu          , Xu          , Xu          , Xol         , Iwr^Es      , Uu^Dr       , Uu^Es       , Uu^Es       , Xos         , Xu          , Xu          
Xue         , Xue         , Xue         , Xue         , Xue         , Xu          , Ql          , Ql          , Uu^Es       , Iwr^Es      , Iwr^Es      , Iwr^Dr      , Iwr^Es      , Iwr^Es      , Xol         , Iwr^Dr      , Xu          , Xu          , Xu          , Xu          , Xu          , Iwr^Dr      , Iwr^Dr      , Xu          , Iwr^Es      , Iwr^Es      , Iwr^Dr      , Uu^Dr       , Iwr^Es      , Uu^Dr       , Xos         , Xu          , Xu          
Xue         , Xue         , Xue         , Xue         , Ql          , Ql          , Ql          , Uu^Dr       , Uu^Es       , Uu^Dr       , Uu^Es       , Iwr^Es      , Xu          , Xol         , Iwr^Es      , Iwr^Es      , Xu          , Xu          , Xu          , Xu          , Iwr^Dr      , Iwr^Es      , Iwr^Dr      , Iwr^Dr      , Iwr^Es      , Iwr^Dr      , Iwr^Es      , Iwr^Es      , Iwr^Dr      , Xos         , Xu          , Xu          , Xue         
Xue         , Xue         , Xue         , Ql          , Ql          , Ql          , Xu          , Ql          , Ql          , Uu^Es       , Uu^Dr       , Xu          , Xu          , Xu          , Xu          , Iwr^Es      , Iwr^Es      , Xu          , Iwr^Dr      , Iwr^Es      , Iwr^Dr      , Iwr^Dr      , Iwr^Es      , Xu          , Iwr^Dr      , Iwr^Dr      , Iwr^Es      , Xu          , Xu          , Xu          , Xu          , Xue         , Xue         
Xue         , Xue         , Xue         , Ql          , Ql          , Ql          , Ql          , Ql          , Ql          , Ql          , Ql          , Xu          , Xu          , Xu          , Xu          , Iwr^Dr      , Iwr^Dr      , Iwr^Es      , Iwr^Dr      , Iwr^Es      , Xol         , Iwr^Es      , Iwr^Dr      , Iwr^Dr      , Iwr^Es      , Iwr^Es      , Xos         , Xu          , Xu          , Xu          , Xue         , Xue         , Xue         
Xue         , Xue         , Ql          , Ql          , Ql          , Ql          , Ql          , Ql          , Xu          , Ql          , Ql          , Ql          , Xu          , Xu          , Xol         , Iwr^Dr      , Xol         , Xol         , Xol         , Xol         , Xu          , Xos         , Xu          , Iwr^Es      , Iwr^Es      , Xos         , Ql          , Xos         , Xu          , Xu          , Xue         , Xue         , Xue         
Xue         , Xue         , Xu          , Xu          , Xu          , Xu          , Ql          , Ql          , Xu          , Xu          , Uu^Dr       , Uu^Es       , Xu          , Xol         , Xu          , Xol         , Xu          , Xu          , Xu          , Xu          , Xu          , Xu          , Xu          , Uu^Dr       , Ql          , Ql          , Ql          , Ql          , Xu          , Xu          , Xue         , Xue         , Xue         
Xv          , Ql          , Ql          , Xu          , Xu          , Xu          , Uu^Es       , Uu^Dr       , Xu          , Xu          , Ql          , Ql          , Xu          , Xu          , Xu          , Xu          , Xu          , Xu          , Xu          , Xu          , Xu          , Xu          , Uu^Es       , Uu^Es       , Uu^Dr       , Ql          , Ql          , Xue         , Xue         , Xue         , Xue         , Xue         , Xue         
Xv          , Xu          , Ql          , Ql          , Ql          , Xu          , Ql          , Uu^Es       , Ql          , Ql          , Ql          , Xu          , Xu          , Xu          , Uu^Es       , Xu          , Xu          , Xu          , Xu          , Xu          , Xu          , Xu          , Xu          , Xu          , Uu^Es       , Iwr^Dr      , Iwr^Es      , Xue         , Xue         , Xue         , Xu          , Xu          , Xue         
Xv          , Xv          , Xu          , Ql          , Ql          , Ql          , Ql          , Ql          , Ql          , Ql          , Ql          , Xu          , Ql          , Xu          , Uu^Es       , Uu^Dr       , Ql          , Ql          , Xu          , Xu          , Xu          , Xu          , Xol         , Xu          , Iwr^Dr      , Iwr^Es      , Iwr^Dr      , Iwr^Es      , Xue         , Xu          , Xue         , Xue         , Xue         
Xv          , Xv          , Ql          , Ql          , Ql          , Ql          , Ql          , Ql          , Ql          , Xu          , Ql          , Ql          , Ql          , Uu^Dr       , Ql          , Ql          , Ql          , Ql          , Ql          , Xu          , Uu^Dr       , Xol         , Iwr^Dr      , Iwr^Es      , Iwr^Es      , Ql          , Ql          , Iwr^Es      , Xue^Dr      , Xue         , Xol         , Xue         , Xue         
Xv          , Xv          , Xv          , Uu^Dr       , Ql          , Ql          , Ql          , Ql          , Ql          , Uu^Dr       , Xu          , Xu          , Ql          , Ql          , Ql          , Ql          , Ql          , Ql          , Ql          , Uu^Es       , Uu^Dr       , Uu^Dr       , Iwr^Es      , Iwr^Es      , Ql          , Ql          , Ql          , Ql          , Ql          , Rrc         , Xol         , Xue         , Xue         
Xv          , Xv          , Xv          , Xv          , Xv          , Xu          , Uu^Dr       , Ql          , Ql          , Ql          , Ql          , Ql          , Ql          , Ql          , Ql          , Uu^Dr       , Xu          , Ql          , Ql          , Xu          , Xu          , Xol         , Xol         , Iwr^Es      , Iwr^Es      , Ql          , Ql          , Ql          , Ql          , Rrc         , Xol         , Xue         , Xue         
Xv          , Xv          , Xv          , Xv          , Xv          , Xv          , Xv          , Xu          , Ql          , Ql          , Xu          , Xu          , Ql          , Xu          , Ql          , Ql          , Ql          , Ql          , Ql          , Xu          , Xu          , Xu          , Xol         , Iwr^Dr      , Iwr^Dr      , Ql          , Iwr^Es      , Ql          , Rrc^Es      , Rrc^Dr      , Xue         , Xue         , Xu          
Xv          , Xv          , Xv          , Xv          , Xv          , Xv          , Xv          , Xv          , Xv          , Ql          , Ql          , Ql          , Ql          , Ql          , Ql          , Ql          , Ql          , Ql          , Ql          , Xu          , Xu          , Xu          , Xol         , Xol         , Iwr^Es      , Iwr^Es      , 1 Iwr       , Iwr^Dr      , Iwr^Es      , Xue         , Xue         , Xue         , Xu          
Xv          , Xv          , Xv          , Xv          , Xv          , Xv          , Xv          , Xv          , Xv          , Xv          , Xv          , Ql          , Xv          , Ql          , Xu          , Xu          , Xu          , Xu          , Xu          , Xu          , Xu          , Xu          , Xol         , Iwr^Es      , Iwr^Dr      , Iwr^Es      , Iwr^Es      , Iwr^Es      , Iwr^Es      , Iwr^Es      , Iwr^Es      , Xue         , Xue         
Xv          , Xv          , Xv          , Xv          , Xv          , Xv          , Xv          , Xv          , Xv          , Xv          , Xv          , Xv          , Xv          , Xv          , Xv          , Xu          , Xu          , Xu          , Xu          , Xu          , Xu          , Xu          , Xol         , Iwr^Es      , Iwr^Es      , Iwr^Es      , Iwr^Es      , Iwr^Es      , Iwr^Es      , Iwr^Es      , Iwr^Es      , Xue         , Xu          
