border_size=1
usage=map

Gg          , Gs^Fp       , Gs^Fp       , Gg          , Gs^Fp       , Gg          , Gg          , Gg          , Gg          , Gg          , Gg          , Gg          , Gg          , Gg          , Gg          , Gg          , Gg          , Gg          , Gg          , Gg          , Gg          , Gg          , Gs^Fdf      , Gs^Fdf      , Gg          , Gg          , Gs^Fdf      , Gg          , Gs^Fp       , Gg          , Gg          , Gg          , Gs^Fdf      , Gs^Fmf      , Gg          , Gg          , Gs^Fdf      , Gg          
Gg          , Gg          , Gg          , Gs^Fp       , Gs^Fp       , Gs^Fp       , Gs^Fp       , Gs^Fp       , Gs^Fdf      , Gs^Fdf      , Gs^Fdf      , Gs^Fdf      , Gs^Fdf      , Gg          , Gs^Fp       , Gg          , Gs^Fp       , Gs^Fp       , Gs^Fp       , Gs^Fp       , Gg          , Gg          , Gs^Fmf      , Gg          , Gs^Fmf      , Gg          , Gg          , Gg          , Gs^Fp       , Gs^Fp       , Gs^Fmf      , Gs^Fmf      , Gs^Fmf      , Gs^Fmf      , Gg          , Gg          , Gg          , Gs^Fmf      
Gs^Fp       , Gg          , Gs^Fp       , Gg          , Gs^Fp       , Gs^Fp       , Gs^Fp       , Gg          , Gg          , Gs^Fdf      , Gs^Fdf      , Gs^Fdf      , Gg          , Gs^Fdf      , Gs^Fp       , Gs^Fp       , Gs^Fp       , Gs^Fdf      , Gs^Fdf      , Gg          , Gs^Fp       , Gs^Fmf      , Gg^Vo       , Gs^Fmf      , Gs^Fmf      , Gs^Fmf      , Gs^Fmf      , Gs^Fmf      , Gg          , Gs^Fmf      , Gs^Fmf      , Gg^Vo       , Gs^Fp       , Gs^Fmf      , Gs^Fmf      , Gs^Fmf      , Gg          , Gg          
Gs^Fdf      , Gs^Fp       , Gg          , Gs^Fp       , Gg          , Gg          , Gs^Fdf      , Gg^Vo       , Gs^Fdf      , Gs^Fdf      , Gg          , Gg          , Gg          , Gg          , Gg          , Gs^Fp       , Gs^Fdf      , Gg          , Gs^Fp       , Gs^Fdf      , Gg          , Gg          , Gg          , Gs^Fmf      , Gg          , Gs^Fp       , Gs^Fmf      , Gs^Fdf      , Gs^Fp       , Gg          , Gs^Fmf      , Gs^Fmf      , Gg          , Gg          , Gg^Vo       , Gg^Vo       , Rd          , Rd          
Gs^Fp       , Gg          , Gs^Fp       , Gs^Fp       , Gg          , Gg          , Gg          , Gs^Fdf      , Gs^Fdf      , Gs^Fdf      , Gs^Fp       , Gs^Fdf      , Gs^Fp       , Gs^Fp       , Gg          , Gg          , Gs^Fp       , Gs^Fp       , Gg          , Gg          , Gs^Fp       , Gs^Fdf      , Gs^Fmf      , Gs^Fmf      , Gg          , Gg          , Gs^Fmf      , Gs^Fp       , Gs^Fmf      , Gs^Fp       , Gs^Fmf      , Gs^Fmf      , Gs^Fmf      , Gs^Fp       , Rd          , Rd          , Gg^Vo       , Gg          
Gs^Fp       , Gs^Fp       , Gs^Fp       , Gs^Fp       , Gg          , Gg          , Gg          , Gs^Fp       , Gs^Fp       , Gs^Fp       , Gs^Fp       , Gs^Fp       , Gs^Fmf      , Gs^Fmf      , Gs^Fp       , Gs^Fp       , Gg^Vo       , Gg          , Gg          , Gg          , Gg          , Gs^Fp       , Gs^Fmf      , Gs^Fmf      , Gg          , Gg          , Gs^Fmf      , Gg          , Gs^Fmf      , Gg^Vo       , Gs^Fp       , Gs^Fdf      , Rd          , Rd          , Gs^Fdf      , Gg^Vo       , Gg          , Gg          
Gg          , Gs^Fp       , Gg          , Gs^Fp       , Gs^Fdf      , Gg          , Gg          , Gg          , Gs^Fmf      , Gs^Fmf      , Gs^Fmf      , Gs^Fmf      , Gs^Fmf      , Gg          , Gs^Fmf      , Gs^Fp       , Gs^Fdf      , Gg          , Gs^Fdf      , Gs^Fdf      , Gs^Fmf      , Gs^Fmf      , Gs^Fmf      , Gs^Fmf      , Gs^Fdf      , Gs^Fms      , Gs^Fms      , Gs^Fdf      , Gs^Fp       , Gs^Fp       , Gs^Fms      , Gs^Fp       , Rd          , Gs^Fdf      , Gs^Fp       , Gs^Fp       , Gs^Fdf      , Gg          
Gg          , Gg          , Gg          , Gs^Fp       , Gg          , Gs^Fp       , Gs^Fmf      , Gs^Fmf      , Gs^Fmf      , Gs^Fmf      , Gs^Fdf      , Gg^Vo       , Gs^Fmf      , Gs^Fmf      , Gs^Fmf      , Gs^Fmf      , Gs^Fmf      , Gs^Fmf      , Gs^Fdf      , Gg          , Gg          , Gs^Fmf      , Gs^Fmf      , Gs^Fp       , Gg          , Gs^Fp       , Gg          , Gs^Fms      , Gs^Fms      , Gs^Fms      , Gs^Fdf      , Rd          , Gs^Fmf      , Gs^Fdf      , Gs^Fmf      , Gs^Fp       , Gg          , Gg          
Gg          , Gg          , Gs^Fp       , Gg          , Gs^Fp       , Gs^Fp       , Gs^Fp       , Gs^Fmf      , Gs^Fmf      , Gs^Fp       , Gs^Fdf      , Gg          , Gs^Fp       , Gg          , Gs^Fdf      , Gs^Fdf      , Gs^Fp       , Gs^Fmf      , Gs^Fdf      , Gs^Fdf      , Gs^Fdf      , Gg          , Gg          , Gs^Fmf      , Gs^Fmf      , Gg^Vo       , Gs^Fmf      , Gs^Fmf      , Gs^Fp       , Gs^Fms      , Rd          , Rd          , Gs^Fmf      , Gs^Fmf      , Gg^Vo       , Gg          , Gs^Fp       , Gg          
Gg          , Gs^Fp       , Gs^Fp       , Gs^Fp       , Gg          , Gs^Fdf      , Gg          , Gs^Fms      , Gs^Fms      , Gs^Fmf      , Gs^Fmf      , Gs^Fdf      , Gs^Fms      , Gs^Fms      , Gs^Fms      , Gg          , Gs^Fp       , Gg          , Gg          , Gs^Fdf      , Gg          , Gg^Vo       , Gs^Fmf      , Gg          , Gs^Fdf      , Gg          , Gs^Fmf      , Hh^Fmf      , Rd          , Rd          , Gs^Fdf      , Gg          , Gs^Fdf      , Gg          , Gs^Fdf      , Gs^Fmf      , Gg          , Gg          
Gg          , Gg          , Gg          , Gg          , Gg          , Gs^Fdf      , Gg          , Gs^Fdf      , Gs^Fdf      , Gs^Fmf      , Gg^Vo       , Gs^Fms      , Gg          , Gs^Fp       , Gg          , Gs^Fdf      , Gs^Fp       , Gs^Fp       , Gs^Fmf      , Gg          , Gs^Fdf      , Gs^Fmf      , Gs^Fdf      , Gs^Fmf      , Gg          , Gs^Fmf      , Gs^Fms      , Gg          , Rd          , Gs^Fmf      , Gs^Fmf      , Hh^Fmf      , Hh^Fmf      , Gs^Fmf      , Gs^Fmf      , Hh^Fmf      , Gg          , Gg          
Gg          , Gg          , Gs^Fmf      , Gg^Vo       , Gs^Fmf      , Gs^Fmf      , Gs^Fmf      , Gs^Fmf      , Gs^Fp       , Gs^Fp       , Gs^Fp       , Gg          , Gg          , Gg          , Gs^Fmf      , Gg          , Gg          , Gg          , Gs^Fp       , Gs^Fmf      , Gg          , Gs^Fmf      , Gs^Fmf      , Gs^Fmf      , Gs^Fmf      , Gg          , Hh^Fmf      , Gs^Fms      , Gs^Fmf      , Rd          , Rd          , Gs^Fdf      , Gs^Fdf      , Gs^Fmf      , Gs^Fmf      , Gs^Fmf      , Gs^Fmf      , Gg          
Gg          , Gs^Fp       , Gs^Fp       , Gg          , Gs^Fdf      , Gg          , Gg          , Gg          , Gg          , Gs^Fp       , Gg          , Gg          , Gs^Fp       , Gs^Fmf      , Gs^Fms      , Gs^Fdf      , Gs^Fdf      , Gs^Fdf      , Gs^Fdf      , Gg          , Gs^Fdf      , Gg          , Gg          , Gg          , Gg          , Gs^Fmf      , Hh^Fmf      , Gg^Vo       , Hh^Fmf      , Gs^Fmf      , Rd          , Gs^Fdf      , Gs^Fmf      , Gs^Fmf      , Gg          , Gg          , Gg          , Gg          
Gg          , Gg          , Gg          , Gg          , Gs^Fp       , Gs^Fdf      , Gg          , Gg          , Gs^Fmf      , Gs^Fdf      , Gs^Fmf      , Gs^Fdf      , Gs^Fdf      , Gs^Fms      , Gg          , Gs^Fms      , Gs^Fms      , Gs^Fdf      , Gs^Fp       , Gs^Fdf      , Gs^Fdf      , Gg          , Rd          , Gg^Vo       , Gs^Fmf      , Gs^Fmf      , Gs^Fmf      , Gs^Fms      , Gs^Fmf      , Gs^Fmf      , Gs^Fp       , Rd          , Gs^Fmf      , Gs^Fmf      , Gs^Fmf      , Gs^Fmf      , Gs^Fmf      , Gg          
Gg          , Gg          , Gs^Fp       , Gs^Fp       , Gs^Fp       , Gg          , Gg          , Gs^Fmf      , Gg          , Gs^Fmf      , Gg          , Gs^Fdf      , Gs^Fdf      , Gg          , Gg          , Gs^Fdf      , Gs^Fms      , Gs^Fdf      , Gs^Fdf      , Gs^Fdf      , Rd          , Rd          , Gs^Fmf      , Rd          , Rd          , Gs^Fmf      , Gs^Fmf      , Gs^Fms      , Rd          , Gs^Fp       , Rd          , Rd          , Gs^Fp       , Gg^Vo       , Gs^Fmf      , Gs^Fmf      , Gs^Fmf      , Gs^Fmf      
Gg          , Gs^Fp       , Gs^Fp       , Gg          , Gs^Fp       , Gs^Fp       , Gs^Fdf      , Gs^Fdf      , Gs^Fdf      , Gg^Vo       , Gg          , Gg          , Gg          , Gs^Fdf      , Gs^Fdf      , Gg          , Gs^Fms      , Gs^Fms      , Rd          , Rd          , Gs^Fmf      , Gs^Fp       , Gs^Fmf      , Gs^Fmf      , Gs^Fdf      , Rd          , Rd          , Rd          , Gs^Fp       , Rd          , Gs^Fdf      , Gs^Fp       , Gs^Fdf      , Gs^Fdf      , Gs^Fdf      , Gs^Fmf      , Gs^Fmf      , Gs^Fmf      
Gs^Fdf      , Gs^Fp       , Gg          , Gg          , Hh^Vo       , Gs^Fp       , Gg          , Gs^Fdf      , Gg          , Gg          , Gs^Fdf      , Gg          , Gg          , Gs^Fdf      , Rd          , Rd          , Rd          , Rd          , Gs^Fmf      , Gs^Fmf      , Gs^Fmf      , Gs^Fdf      , Gs^Fdf      , Gs^Fdf      , Gg          , Gs^Fp       , Gs^Fmf      , Gs^Fdf      , Gs^Fp       , Gs^Fdf      , Gs^Fp       , Gs^Fdf      , Gs^Fmf      , Gs^Fmf      , Gs^Fdf      , Gs^Fmf      , Gs^Fmf      , Gs^Fmf      
Hh^Fmf      , Hh^Fmf      , Hh^Fmf      , Hh          , Hh^Fmf      , Gg          , Gs^Fdf      , Gs^Fp       , Gs^Fdf      , Gs^Fdf      , Gg          , Gs^Fdf      , Rd          , Rd          , Gs^Fdf      , Gg          , Gs^Fdf      , Gg^Vo       , Gs^Fmf      , Gs^Fmf      , Gs^Fmf      , Gs^Fmf      , Gs^Fdf      , Gs^Fmf      , Gs^Fmf      , Gs^Fdf      , Gs^Fmf      , Gs^Fp       , Gg^Vo       , Gg          , Gs^Fmf      , Gs^Fmf      , Gs^Fmf      , Gs^Fmf      , Gs^Fmf      , Gs^Fmf      , Gs^Fdf      , Gs^Fmf      
Mm          , Gs^Fp       , Hh^Fdf      , Hh^Fmf      , Hh^Vo       , Hh^Fmf      , Hh^Fmf      , Gg          , Gs^Fp       , Gg          , Rd          , Rd          , Gs^Fp       , Gs^Fdf      , Gg          , Gs^Fdf      , Gg          , Gs^Fdf      , Gs^Fmf      , Gs^Fdf      , Gg          , Gs^Fmf      , Gs^Fdf      , Gs^Fdf      , Gs^Fmf      , Gs^Fmf      , Gg          , Gs^Fmf      , Gs^Fdf      , Gs^Fmf      , Gg          , Gs^Fdf      , Gs^Fdf      , Gs^Fdf      , Gg          , Gg          , Gs^Fmf      , Gs^Fmf      
Mm          , Mm          , Hh^Fmf      , Hh^Fmf      , Hh^Fdf      , Hh^Fmf      , Hh^Fmf      , Gs^Fdf      , Hh          , Rd          , Gs^Fp       , Gs^Fp       , Gs^Fp       , Gg          , Gg          , Gg          , Gg          , Gg          , Gs^Fmf      , Gs^Fdf      , Gs^Fdf      , Gs^Fmf      , Gs^Fmf      , Gg^Vo       , Gs^Fp       , Gs^Fdf      , Gs^Fdf      , Gs^Fdf      , Gs^Fdf      , Gs^Fdf      , Gs^Fmf      , Gg          , Gg          , Gg          , Gs^Fmf      , Gg          , Gs^Fmf      , Gs^Fmf      
Mm^Xm       , Mm          , Hh^Fdf      , Hh^Fmf      , Hh          , Hh^Fmf      , Hh^Fdf      , Gs^Fdf      , Rd          , Rd          , Hh          , Hh^Fmf      , Gg          , Gg          , Gs^Fdf      , Gg          , Gs^Fp       , Gg          , Gs^Fdf      , Gs^Fdf      , Gs^Fp       , Gs^Fmf      , Gs^Fp       , Gg          , Gs^Fp       , Gg          , Gg          , Gg          , Gg          , Gs^Fp       , Gs^Fp       , Gs^Fmf      , Gs^Fdf      , Gg          , Gs^Fdf      , Gs^Fmf      , Gs^Fmf      , Gs^Fmf      
Mm^Xm       , Mm^Xm       , Mm          , Hh^Fdf      , Gg          , Gg          , Rd          , Rd          , Hh^Fmf      , Gg          , Hh^Fdf      , Hh          , Gg          , Gs^Fdf      , Hh          , Gs^Fdf      , Gg          , Gs^Fmf      , Gs^Fdf      , Gs^Fp       , Gs^Fp       , Gg          , Gg          , Gs^Fp       , Gg          , Gs^Fp       , Gs^Fp       , Gs^Fp       , Gs^Fp       , Gg          , Gs^Fp       , Gs^Fdf      , Gs^Fmf      , Gs^Fp       , Gs^Fdf      , Gg          , Gs^Fmf      , Gs^Fmf      
Mm          , Mm          , 1 Khr       , Chr         , Rd          , Rd          , Chr         , Gs^Fp       , Gs^Fp       , Hh^Fmw      , Hh^Fmf      , Gs^Fdf      , Hh^Fmf      , Hh          , Hh^Fmf      , Gg          , Gg          , Gs^Fmf      , Gs^Fmf      , Gg^Vo       , Gs^Fp       , Gg          , Gs^Fmf      , Gs^Fmf      , Gs^Fdf      , Gs^Fmf      , Gs^Fdf      , Gs^Fmf      , Gs^Fmf      , Gs^Fp       , Gs^Fmf      , Gs^Fp       , Gs^Fp       , Gs^Fmf      , Gs^Fmf      , Gs^Fdf      , Gs^Fdf      , Gs^Fdf      
Mm^Xm       , Mm          , Mm          , Chr         , Rd          , Chr         , Khr         , Ch          , Chr         , Gs^Fdf      , Gg          , Hh^Fdf      , Gs^Fp       , Gg          , Gg          , Hh^Vo       , Hh^Fdf      , Gs^Fp       , Gs^Fmf      , Gs^Fmf      , Gs^Fp       , Gs^Fmf      , Gs^Fdf      , Gs^Fdf      , Gs^Fmf      , Gg          , Gs^Fmf      , Gs^Fdf      , Gs^Fmf      , Gg          , Gs^Fmf      , Gg^Vo       , Gs^Fmf      , Gs^Fmf      , Gs^Fmf      , Gs^Fmf      , Gs^Fmf      , Gs^Fmf      
Mm^Xm       , Mm^Xm       , Rd          , Rd          , Mm          , Mm          , Mm          , Mm          , Mm          , Mm          , Mm          , Mm          , Mm          , Gs^Fp       , Hh^Fdf      , Hh^Fdf      , Gg          , Gs^Fp       , Gs^Fmf      , Gs^Fp       , Gs^Fmf      , Gs^Fdf      , Gs^Fmf      , Gs^Fmf      , Gs^Fmf      , Gs^Fmf      , Gg          , Gg          , Gs^Fmf      , Gs^Fmf      , Gs^Fmf      , Gs^Fdf      , Gs^Fdf      , Gs^Fp       , Gg          , Gs^Fp       , Gg          , Gs^Fmf      
Rd          , Rd          , Mm          , Mm          , Mm^Xm       , Mm^Xm       , Mm^Xm       , Mm^Xm       , Mm          , Mm          , Mm^Xm       , Mm          , Hh^Fdf      , Mm          , Hh^Fdf      , Hh^Fdf      , Gg          , Gg          , Gg          , Gs^Fmf      , Gs^Fmf      , Gs^Fmf      , Gs^Fmf      , Gs^Fmf      , Gs^Fmf      , Gs^Fmf      , Gs^Fmf      , Gs^Fmf      , Gs^Fmf      , Gs^Fmf      , Gs^Fmf      , Gs^Fmf      , Gs^Fmf      , Gs^Fmf      , Gs^Fmf      , Gs^Fmf      , Gs^Fmf      , Gs^Fmf      
