border_size=1
usage=map

Xu          , Xu          , Xu          , Xu          , Xu          , Xu          , Xu          , Xu          , Xu          , Xu          , Md^Xm       , Md^Xm       , Md^Xm       , Md^Xm       , Md^Xm       , Md^Xm       , Md^Xm       , Md^Xm       , Md^Xm       , Md^Xm       , Md^Xm       , Md^Xm       , Md^Xm       , Md^Xm       , Md^Xm       , Md^Xm       , Md^Xm       , Md^Xm       , Md^Xm       , Md^Xm       , Md^Xm       , Md^Xm       , Md          , Md          , Uh          , Uh          , Uu          , Uu          , Zwsl        , Zwsl        , Zvw         , Zwsl        , Zvw         , Zvw         , Qlf         , Qlf         
Xu          , Xu          , Xu          , Xu          , Xu          , Xu          , Ur          , Xu          , Xu          , Xu          , Md^Xm       , Md^Xm       , Md^Xm       , Md^Xm       , Md^Xm       , Md^Xm       , Md          , Md^Xm       , Md          , Md^Xm       , Md^Xm       , Md^Xm       , Md^Xm       , Md^Xm       , Md^Xm       , Md^Xm       , Md^Xm       , Md^Xm       , Md^Xm       , Md^Xm       , Md          , Md^Xm       , Md          , Md          , Uh          , Uh          , Uu          , Uu          , Zwsl        , Zwsl        , Zvw         , Zwsl        , Zvw         , Zvw         , Qlf         , Qlf         
Xu          , Xu          , Xu          , Uu^Uf       , Uu          , Uu          , Uu          , Ur          , Xu          , Xu          , Md^Xm       , Md^Xm       , Md^Xm       , Md^Xm       , Md^Xm       , Md^Xm       , Md^Xm       , Md          , Md          , Md^Xm       , Md          , Md^Xm       , Md          , Md^Xm       , Md          , Md          , Md          , Md          , Md          , Md          , Md          , Md          , Md          , Uh          , Uu          , Uu          , Zwsl        , Zwsl        , Zwsl        , Zwsl        , Zvw         , Zvw         , Zvw         , Qlf         , Qlf         , Qlf         
Xu          , Xu          , Ur          , Uu          , Xu          , Xu          , Xu          , Uh          , Xu          , Xu          , Md^Xm       , Md^Xm       , Md^Xm       , Md^Xm       , Md^Xm       , Md^Xm       , Md          , Md          , Md          , Md          , Md          , Md          , Md          , Md          , Uh          , Md          , Uh          , Uh          , Uh          , Uh          , Uh          , Uh          , Uh          , Uh          , Uu          , Zwsl        , Zwsl        , Zwsl        , Zwsl^Vzps    , Zvw         , Zvw         , Zvw         , Zvw         , Qlf         , Qlf         , Qlf         
Xu          , Xu          , Ur          , Uu          , Xu          , Xu          , Uu^Uf       , Xu          , Xu          , Xu          , Md^Xm       , Md^Xm       , Md^Xm       , Md^Xm       , Md^Xm       , Md          , Md          , Md          , Md          , Md          , Uh          , Uh          , Uh          , Uh          , Uh          , Uh          , Uh          , Uh          , Uh          , Uh          , Uu          , Uh          , Uh          , Uu          , Zwsl        , Zwsl        , Zwsl        , Zwsl        , Zwsl        , Zvw         , Zvw         , Zvw         , Qlf         , Qlf         , Qlf         , Qlf         
Xu          , Xu          , Ur          , Ur          , Ur          , Xu          , Uu^Uf       , Uu^Uf       , Xu          , Xu          , Md^Xm       , Md^Xm       , Md^Xm       , Md^Xm       , Md          , Md          , Md          , Md          , Uh          , Uh          , Uh          , Uh          , Uu          , Uu          , Uu          , Uu          , Uu          , Uu          , Uu          , Uu          , Uu          , Uu          , Uu          , Uu          , Zvw         , Zwsl        , Zwsl        , Zwsl        , Zwsl        , Zvw         , Zvw         , Zvw         , Qlf         , Qlf         , Qlf         , Qlf         
Xu          , Xu          , Xu          , Uu          , Uu          , Xu          , Uu          , Xu          , Xu          , Xu          , Md^Xm       , Md^Xm       , Md^Xm       , Md^Xm       , Md          , Md          , Md          , Md          , Uh          , Uh          , Uu          , Uu          , Uu          , Uu          , Zwsl        , Uu          , Zvw         , Uu          , Zvw         , Zvw         , Zwsl        , Zwsl        , Zwsl        , Zwsl        , Zwsl        , Zwsl        , Zwsl        , Zwsl        , Zvw         , Zvw         , Zvw         , Zvw         , Qlf         , Qlf         , Qlf         , Qlf         
Xu          , Xu          , Xu          , Ur          , Xu          , Uu          , Ur          , Xu          , Xu          , Xu          , Md^Xm       , Md^Xm       , Md^Xm       , Md          , Md          , Md          , Uh          , Uh          , Uh          , Uu          , Uu          , Zwsl        , Zwsl^Vzps    , Zwsl        , Zwsl        , Zvw         , Zwsl        , Zwsl        , Zvw         , Zwsl        , Zwsl        , Zwsl        , Zvw         , Zvw         , Zwsl        , Zwsl        , Zwsl        , Zwsl        , Zwsl        , Zvw         , Zvw         , Zvw         , Qlf         , Qlf         , Qlf         , Qlf         
Xu          , Xu          , Xu          , Xu          , Xu          , Uu          , Uu          , Xu          , Xu          , Xu          , Md^Xm       , Md^Xm       , Md^Xm       , Md          , Md          , Md          , Uh          , Uh          , Uu          , Uu          , Zwsl        , Zwsl        , Zwsl        , Zwsl        , Zwsl        , Zwsl        , Zwsl        , Zvw         , Zwsl        , Zvw         , Zvw         , Zvw         , Zwsl        , Zwsl        , Zwsl        , Zwsl        , Zwsl        , Zwsl        , Zvw         , Zwsl        , Zvw         , Zvw         , Qlf         , Qlf         , Qlf         , Qlf         
Xu          , Xu          , Xu          , Xu          , Xu          , Xu          , Uu          , Xu          , Xu          , Xu          , Md^Xm       , Md^Xm       , Md          , Md          , Uh          , Uh          , Uh          , Uh          , Uu          , Zwsl        , Zwsl        , Zwsl        , Zwsl        , Zwsl        , Zwsl        , Zwsl        , Zwsl        , Zwsl        , Zwsl        , Zvw         , Zvw         , Zwsl        , Zvw         , Zwsl        , Zwsl        , Zwsl        , Zwsl        , Zwsl        , Zvw         , Zvw         , Zvw         , Qlf         , Qlf         , Qlf         , Qlf         , Qlf         
Md^Xm       , Md^Xm       , Md^Xm       , Md^Xm       , Md^Xm       , Md^Xm       , Zwsl        , Md^Xm       , Md^Xm       , Md^Xm       , Md          , Md          , Md          , Uh          , Uh          , Uh          , Uu          , Uu          , Uu          , Zwsl        , Zwsl        , Zwsl        , Zvw         , Zvw         , Zvw         , Zvw         , Zvw         , Zvw         , Zvw         , Zvw         , Zwsl        , Zvw         , Zwsl        , Zwsl        , Zwsl        , Zwsl        , Zwsl        , Zwsl        , Zvw         , Zvw         , Qlf         , Qlf         , Qlf         , Qlf         , Qlf         , Qlf         
Md^Xm       , Md^Xm       , Md^Xm       , Md^Xm       , Md^Xm       , Md          , Md          , Zwsl        , Zwsl        , Md          , Zwsl        , Uh          , Uh          , Uh          , Zwsl        , Uu          , Uu          , Uu          , Zwsl        , Zwsl        , Zwsl        , Zwsl        , Zvw         , Zwsl        , Zwsl        , Zwsl        , Zwsl        , Zwsl        , Zwsl        , Zwsl        , Zwsl        , Zwsl^Vzps    , Zwsl        , Zwsl        , Zwsl        , Zwsl        , Zwsl        , Zwsl        , Zvw         , Zvw         , Qlf         , Qlf         , Qlf         , Qlf         , Qlf         , Qlf         
Md^Xm       , Md^Xm       , Md^Xm       , Md^Xm       , Md^Xm       , Md^Xm       , Md          , Md          , Md          , Zwsl        , Uh          , Zwsl        , Zwsl        , Zwsl        , Zwsl        , Zwsl        , Zwsl        , Zwsl        , Zwsl        , Zwsl        , Zwsl        , Zwsl        , Zwsl        , Zvw         , Zwsl        , Zwsl        , Zwsl        , Zwsl        , Zwsl        , Zwsl        , Zwsl        , Zwsl        , Zwsl        , Zwsl        , Zwsl        , Zwsl        , Zwsl        , Zvw         , Zvw         , Zvw         , Qlf^Bs\     , Zvw         , Zvw         , Qlf         , Qlf         , Qlf         
Md^Xm       , Md^Xm       , Md^Xm       , Md^Xm       , Md^Xm       , Md^Xm       , Md^Xm       , Md          , Md          , Md          , Uh          , Zwsl        , Zwsl        , Zwsl        , Zvw         , Zwsl        , Zwsl        , Zwsl        , Zwsl        , Zvw         , Zvw         , Zwsl        , Zvw         , Zvw         , Zvw         , Zwsl        , Zwsl        , Zwsl        , Zwsl        , Zwsl        , Zwsl        , Zwsl        , Zvw         , Zvw         , Zwsl        , Zwsl        , Zwsl        , Zvw         , Zvw         , Qlf         , Zvw         , Zvw         , Qlf         , Qlf         , Qlf         , Qlf         
Md^Xm       , Md^Xm       , Md^Xm       , Md^Xm       , Md^Xm       , Md^Xm       , Md^Xm       , Md          , Md          , Md          , Uh          , Uu          , Zwsl        , Zwsl        , Zwsl        , Zvw         , Zwsl^Vzps    , Zwsl        , Zwsl        , Zwsl        , Zwsl        , Zvw         , Chr         , Chr         , Chr         , Chr         , Zwsl        , Zwsl        , Zwsl        , Zwsl        , Zvw         , Zvw         , Zwsl        , Zwsl        , Zwsl        , Zwsl        , Zvw         , Zwsl        , Zvw         , Qlf         , Zvw         , Zvw         , Qlf         , Qlf         , Qlf         , Qlf         
Md^Xm       , Md^Xm       , Md^Xm       , Md^Xm       , Md^Xm       , Md^Xm       , Md^Xm       , Md^Xm       , Md          , Md          , Uh          , Uu          , Zwsl        , Zwsl        , Zwsl        , Zwsl        , Zwsl        , Zvw         , Zwsl        , Zwsl        , Zvw         , Zwsl        , Chr         , Chr         , 2 Khr       , Chr         , Zwsl        , Zwsl        , Zvw         , Zvw         , Zwsl        , Zwsl        , Zwsl        , Zwsl        , Zwsl        , Zwsl        , Zvw         , Zvw         , Zvw         , Qlf         , Qlf^Bs/     , Zvw         , Qlf         , Qlf         , Qlf         , Qlf         
Md^Xm       , Md^Xm       , Md^Xm       , Md^Xm       , Md^Xm       , Md^Xm       , Md^Xm       , Md^Xm       , Md          , Md          , Uh          , Uu          , Zwsl        , Zwsl        , Zvw         , Zwsl        , Zwsl        , Zwsl        , Zvw         , Zwsl        , Zvw         , Zvw         , Zvw         , Chr         , Chr         , Chr         , Zvw         , Zvw         , Zwsl        , Zwsl        , Zvw         , Zwsl        , Zwsl        , Zwsl        , Zwsl        , Zwsl        , Zvw         , Zvw         , Zvw         , Zvw         , Qlf         , Qlf         , Qlf         , Qlf         , Qlf         , Qlf         
Md^Xm       , Md^Xm       , Md^Xm       , Md^Xm       , Md^Xm       , Md^Xm       , Md^Xm       , Md^Xm       , Md          , Md          , Uh          , Uh          , Zwsl        , Zwsl        , Zwsl        , Zvw         , Zvw         , Zwsl        , Zvw         , Zwsl        , Zwsl        , Zvw         , Zwsl        , Zwsl        , Zwsl        , Zvw         , Zwsl        , Zvw         , Zwsl        , Zvw         , Zwsl        , Zwsl        , Zwsl        , Zwsl        , Zwsl        , Zwsl        , Zvw         , Zvw         , Zvw         , Zvw         , Qlf         , Qlf         , Qlf         , Qlf         , Qlf         , Ql          
Md^Xm       , Md^Xm       , Md^Xm       , Md^Xm       , Md^Xm       , Md^Xm       , Md^Xm       , Md          , Md          , Md          , Uh          , Uh          , Zwsl        , Zwsl        , Zwsl        , Zwsl        , Zwsl        , Zwsl        , Zvw         , Zwsl        , Zwsl        , Zwsl        , Zwsl        , Zwsl        , Zwsl        , Zwsl        , Zwsl        , Zwsl        , Zwsl        , Zwsl        , Zwsl        , Zwsl        , Zwsl        , Zwsl        , Zwsl        , Zwsl        , Zvw         , Zvw         , Qlf^Bs\     , Qlf         , Zvw         , Qlf         , Qlf         , Qlf         , Ql          , Ql          
Md^Xm       , Md^Xm       , Md^Xm       , Md^Xm       , Md^Xm       , Md^Xm       , Md          , Md          , Md          , Uh          , Uh          , Uh          , Uu          , Uu          , Zwsl        , Zwsl        , Zwsl        , Zwsl        , Zvw         , Zwsl        , Zwsl        , Zwsl        , Zwsl        , Zwsl        , Zwsl        , Zwsl        , Zwsl        , Zwsl^Vzps    , Zwsl        , Zwsl        , Zwsl        , Zwsl        , Zwsl        , Zwsl        , Zvw         , Zvw         , Zvw         , Qlf         , Qlf         , Zvw         , Zvw^Vzps     , Qlf         , Qlf         , Ql          , Ql          , Ql          
Md^Xm       , Md^Xm       , Md^Xm       , Md^Xm       , Md^Xm       , Md^Xm       , Md          , Md          , Uh          , Uh          , Uu          , Uu          , Zwsl        , Zwsl        , Zwsl        , Zwsl        , Zwsl        , Zvw         , Zvw^Vzps     , Zwsl        , Zwsl        , Zwsl        , Zwsl        , Zwsl        , Zwsl        , Zwsl        , Zwsl        , Zwsl        , Zvw         , Zwsl        , Zwsl        , Zwsl        , Zwsl        , Zvw         , Zvw         , Zvw         , Qlf         , Qlf         , Zvw         , Zvw         , Qlf         , Qlf         , Ql          , Ql          , Ql          , Ql          
Md^Xm       , Md^Xm       , Md^Xm       , Md^Xm       , Md^Xm       , Md          , Md          , Md          , Uh          , Uh          , Uu          , Uu          , Zwsl        , Zwsl        , Zwsl        , Zwsl        , Zvw         , Zvw         , Zvw         , Zwsl        , Zvw         , Zvw         , Zvw         , Zwsl        , Zvw         , Zvw         , Zvw         , Zvw         , Zwsl        , Zvw         , Zwsl        , Zwsl        , Zvw         , Zvw         , Qlf         , Qlf^Bs\     , Zvw         , Qlf         , Qlf         , Qlf^Bs\     , Zvw         , Zvw         , Ql          , Ql          , Ql          , Ql          
Md^Xm       , Md^Xm       , Md          , Md          , Md          , Md          , Uh          , Uh          , Uh          , Uu          , Zwsl        , Zwsl        , Zwsl        , Zwsl        , Zwsl        , Zwsl        , Zvw         , Zvw         , Zwsl        , Zvw         , Zwsl        , Zwsl        , Zwsl        , Zvw         , Zvw         , Zwsl        , Zwsl        , Zwsl        , Zwsl        , Zwsl        , Zvw         , Zvw         , Zvw         , Zvw         , Qlf         , Qlf         , Zvw         , Qlf         , Ql          , Zvw         , Zvw         , Ql          , Ql          , Ql          , Ql          , Ql          
Md^Xm       , Md^Xm       , Md          , Md          , Md          , Md          , Uu          , Uh          , Uu          , Uu          , Zwsl        , Zwsl        , Zwsl        , Zwsl        , Zvw         , Zvw         , Zwsl        , Zwsl        , Zvw         , Zwsl        , Zwsl        , Zwsl        , Zwsl        , Zwsl        , Zwsl        , Zvw         , Zwsl        , Zwsl        , Zwsl        , Zwsl        , Zvw         , Zvw         , Qlf^Bs\     , Qlf         , Zvw         , Qlf^Bs/     , Qlf         , Qlf^Bs\     , Zvw         , Ql^Bs/      , Ql          , Ql^Bs\      , Ql^Bs\      , Ql          , Ql          , Ql          
Md          , Md          , Md          , Md          , Md          , Uh          , Uh          , Uu          , Uu          , Zwsl        , Zwsl        , Zwsl        , Zvw         , Zvw         , Zwsl        , Zwsl        , Zvw         , Zwsl        , Zvw         , Zwsl        , Zwsl        , Zwsl        , Zwsl        , Zvw         , Zvw         , Zvw         , Zvw         , Zwsl        , Zwsl        , Zvw         , Zvw         , Qlf         , Zvw         , Zvw         , Qlf         , Qlf         , Qlf         , Zvw         , Zvw         , Ql          , Ql          , Ql          , Ql          , Ql^Bs\      , Zvw         , Zvw         
Md          , Md          , Md          , Md          , Uh          , Uh          , Uu          , Uu          , Zwsl        , Zwsl        , Zvw         , Zvw         , Zvw         , Zwsl        , Zwsl^Vzps    , Zvw         , Zwsl        , Zwsl        , Zwsl        , Zwsl        , Zwsl        , Zwsl        , Zwsl        , Zvw         , Zwsl        , Zwsl        , Zwsl        , Zwsl        , Zwsl        , Zvw         , Zwsl        , Qlf         , Qlf         , Qlf         , Qlf         , Qlf         , Zvw         , Zvw^Vzps     , Ql          , Ql^Bs\      , Ql^Bs\      , Ql          , Ql          , Zvw         , Zvw         , Zvw         
Md          , Md          , Uh          , Uh          , Uh          , Uu          , Uu          , Zwsl        , Zvw         , Zvw         , Zvw         , Zvw         , Zwsl        , Zwsl        , Zwsl        , Zwsl        , Zwsl        , Zwsl        , Zwsl        , Zwsl        , Uh          , Zwsl        , Uh          , Zwsl        , Zwsl        , Zwsl        , Zwsl^Vzps    , Zwsl        , Zwsl        , Zvw         , Zvw         , Qlf         , Zvw         , Qlf         , Qlf         , Zvw         , Ql          , Ql          , Ql          , Ql          , Ql          , Ql^Bs\      , Ql^Bs\      , Zvw         , Zvw         , Zvw         
Uh          , Uh          , Uh          , Uh          , Zwsl        , Uu          , Zvw         , Zvw         , Zvw         , Zvw         , Zvw         , Zvw         , Zwsl        , Zwsl        , Uh          , Zwsl        , Uh          , Zwsl        , Uh          , Uh          , Uh          , Uh          , Uh          , Uh          , Uh          , Uh          , Zwsl        , Zwsl        , Zwsl        , Zvw         , Zvw         , Qlf^Bs\     , Zvw         , Qlf         , Qlf         , Ql^Bs|      , Ql          , Ql          , Ql          , Ql          , Ql          , Ql          , Zvw         , Zvw         , Zvw         , Zvw         
Uh          , Uh          , Zwsl        , Zwsl        , Zvw         , Zvw         , Zvw         , Zvw         , Zwsl        , Zvw         , Zwsl        , Zwsl        , Uh          , Uh          , Uh          , Uh          , Uh          , Uh          , Md          , Md          , Md          , Md          , Md          , Uh          , Md          , Uh          , Uh          , Zwsl        , Zvw         , Zvw         , Qlf         , Qlf         , Zvw         , Qlf         , Zvw         , Zvw         , Ql          , Ql          , Ql          , Ql          , Zvw         , Zvw         , Zvw         , Zvw         , Zvw         , Zvw         
Zwsl        , Zwsl        , Zvw         , Zvw         , Zwsl        , Zvw         , Zwsl        , Zwsl        , Uh          , Uh          , Uh          , Uh          , Uh          , Uh          , Md          , Md          , Md          , Md          , Md          , Md          , Md^Xm       , Md          , Md          , Md          , Md          , Md          , Md          , Uh          , Zvw         , Zvw         , Qlf^Bs\     , Qlf         , Qlf         , Qlf^Bs\     , Zvw         , Zvw         , Ql^Bs\      , Ql          , Ql          , Zvw         , Zvw         , 1 Zvw       , Zvw         , Zvw         , Zvw         , Zvw         
Zwsl        , Zvw         , Zwsl        , Zwsl        , Uh          , Zwsl        , Uh          , Uh          , Md          , Md          , Md          , Md          , Md          , Md          , Md          , Md          , Md          , Md          , Md^Xm       , Md^Xm       , Md^Xm       , Md^Xm       , Md^Xm       , Md^Xm       , Md^Xm       , Md^Xm       , Md^Xm       , Uh          , Md^Xm       , Zvw         , Qlf         , Zvw         , Qlf^Bs/     , Zvw         , Qlf         , Ql          , Ql          , Ql^Bs\      , Ql^Bs\      , Zvw         , Zvw         , Zvw         , Zvw         , Zvw         , Zvw         , Zvw         
Uh          , Zwsl        , Uh          , Uh          , Uh          , Uh          , Md          , Md          , Md          , Md          , Md^Xm       , Md          , Md^Xm       , Md          , Md^Xm       , Md^Xm       , Md^Xm       , Md^Xm       , Md          , Md^Xm       , Md          , Md^Xm       , Md          , Md^Xm       , Md^Xm       , Md^Xm       , Md^Xm       , Md^Xm       , Md^Xm       , Uh          , Qlf         , Zvw         , Qlf^Bs\     , Qlf         , Zvw         , Ql          , Ql          , Ql          , Ql          , Zvw         , Md          , Md          , Md          , Zvw         , Md          , Zvw         
Md          , Uh          , Md          , Md          , Md          , Md          , Md          , Md          , Md^Xm       , Md^Xm       , Md^Xm       , Md^Xm       , Md^Xm       , Md^Xm       , Md^Xm       , Md^Xm       , Md          , Md          , Md          , Md          , Md          , Md          , Md          , Md          , Md          , Md          , Md^Xm       , Md^Xm       , Qxua        , Md^Xm       , Qxua        , Qlf         , Zvw         , Zvw         , Qxua        , Qxua        , Qxua        , Ql          , Ql          , Md          , Md^Xm       , Md^Xm       , Md          , Md          , Md          , Md          
Md          , Md          , Md          , Md          , Md^Xm       , Md          , Md^Xm       , Md^Xm       , Md^Xm       , Md^Xm       , Md^Xm       , Md^Xm       , Md^Xm       , Md^Xm       , Md          , Md          , Zwsl        , Md          , Md          , Md          , Md          , Md          , Qxua        , Md          , Qxua        , Qxua        , Qxua        , Qxua        , Qxua        , Qxua        , Qxua        , Qxua        , Qxua        , Zvw         , Qxua        , Qxua        , Qxua        , Qxua        , Qxua        , Md^Xm       , Qxua        , Md^Xm       , Md^Xm       , Md          , Md^Xm       , Md^Xm       
Md^Xm       , Md^Xm       , Md^Xm       , Md^Xm       , Md^Xm       , Md^Xm       , Md^Xm       , Md^Xm       , Md^Xm       , Md^Xm       , Md^Xm       , Md^Xm       , Md          , Md          , Md          , Md          , Qxua        , Qxua        , Qxua        , Qxua        , Qxua        , Qxua        , Qxua        , Qxua        , Qxua        , Qxua        , Qxua        , Qxua        , Qxua        , Qxua        , Qxua        , Qxua        , Qxua        , Qxua        , Qxua        , Qxua        , Qxua        , Qxua        , Qxua        , Qxua        , Qxua        , Qxua        , Qxua        , Qxua        , Qxua        , Qxua        
