Xu, Xu, Xu, Xu, Xu, Xu, Xu, Xu, Xu, Xu, Xu, Xu, Xu, Xu, Xu, Xu, Xu, Xu, Xu, Xu, Xu, Xu, Xu, Xu, Xu, Xu, Xu, Xu, Xu, Xu, Xu, Xu, Xu, Xu, Xu, Xu, Xu, Xu, Xu, Xu, Xu, Xu, Xu, Xu, Xu, Xu, Xu, Xu, Xu, Xu, Xu, Xu, Xu, Xu, Qxu, Qxu, Xu, Xu, Xu, Qxu, Qxu, Xu, Xu, Xu, Xu, Xu, Qxu, Qxu, Qxu, Xu, Xu, Qxu, Xu, Xu, Uu, Qxu, Qxu, Xu, Xu, Qxu, Qxu, Xu, Qxu, Qxu, Qxu, Xu, Xu, Xu, Xu, Xu, Xu, Qxu, Qxu
Xu, Xu, Xu, Xu, Xu, Xu, Xu, Xu, Xu, Xu, Xu, Xu, Xu, Xu, Xu, Xu, Xu, Xu, Xu, Xu, Xu, Xu, Xu, Xu, Xu, Xu, Xu, Xu, Xu, Xu, Xu, Xu, Xu, Xu, Xu, Xu, Xu, Xu, Uh, Xu, Uh, Xu, Xu, Xu, Xu, Xu, Xu, Xu, Xu, Xu, Uh, Xu, Xu, Qxu, Qxu, Qxu, Uu, Xu, Uu, Qxu, Qxu, Xu, Qxu, Uu^Vu, Ur, Uu, Qxu, Qxu, Qxu, Xu, Qxu, Qxu, Qxu, Qxu, Xu, Uu, Qxu, Xu, Qxu, Qxu, Ur, Qxu, Uu, Uu, Ur^Cov, Xu, Xu, Xu, Qxu, Xu, Qxu, Qxu, Qxu
Xu, Xu, Xu, Xu, Xu, Xu, Xu, Xu, Xu, Xu, Xu, Xu, Xu, Xu, Xu, Xu, Xu, Uh, Uh, Uu^Uf, Xu, Uu, Uu, Xu, Xu, Xu, Xu, Xu, Xu, Xu, Xu, Xu, Xu, Xu, Uu^Uf, Xu, Uu^Uf, Uu^Uf, Uu^Uf, Uh, Uu^Uf, Uh, Uh, Xu, Xu, Xu, Xu, Xu, Uu, Uu^Uf, Uu^Uf, Uu^Uf, Ur, Ur, Ur, Qxu^Bs/, Qxu, Uu, Uu, Qxu, Qxu, Qxu, Qxu, Uu, Ur, Qxu, Qxu, Qxu, Qxu, Qxu, Xu, Qxu, Qxu, Qxu, Qxu, Qxu, Qxu, Qxu, Qxu, Qxu, Qxu^Bs/, Ur, Ur, Ur^Cov, 7 Ur^Kov, Qxu, Ur^Cov, Cud, Kud, Qxu, Qxu, Qxu, Qxu
Xu, Xu, Xu, Xu, Xu, Xu, Xu, Xu, Xu, Xu, Xu, Xu, Xu, Xu, Xu, Xu, Uh, Uh, Uu^Uf, Xu, Cud, Cud, Cud, Uu, Uu, Xu, Xu, Xu, Xu, Xu, Xu, Uh, Uu^Uf, Uu^Uf, Uu, Uu^Uf, Xu, Uu^Uf, Uu, Uu^Uf, Uh, Uh, Uu, Xu, Uu, Uu^Vu, Uu, Uu, Ur, Ur, Ur, Ur, Qxu, Qxu, Qxu, Qxu, Qxu, Xu, Qxu, Ur, Qxu^Bs\, Qxu, Ur, Qxu^Bs/, Qxu, Qxu, Qxu, Qxu, Uu^Vu, Ur, Uu, Xu, Qxu, Qxu, Qxu, Xu, Xu, Xu, Ur, Uu, Qxu, Qxu, Qxu, Ur^Cov, Ur^Cov, Ur^Cov, Ur, Cud, Qxu, Qxu, Qxu, Qxu, Uu
Xu, Xu, Xu, Xu, Ww, Xu, Xu, Xu, Xu, Xu, Xu, Xu, Xu, Xu, Uu, Uh, Xu, Xu, Uu, 8 Kud, Cud, Cud, Cud, Ur, Ur, Xu, Ur, Uu^Vu, Uu, Uu, Uu, Uu^Uf, Xu, Uu^Vu, Xu, Xu, Uu, Uu^Vu, Xu, Uu, Uu, Uu, Xu, Uu, Xu, Uu, Ur, Ur, Uu^Uf, Uu^Uf, Xu, Xu, Qxu, Qxu, Qxu, Qxu, Qxu, Qxu, Qxu, Qxu, Qxu, Ur, Uu, Uu, Qxu^Bs\, Qxu, Ur, Qxu^Bs/, Qxu, Ur, Qxu, Qxu, Qxu, Qxu, Qxu, Qxu, Uu^Vu, Ur, Uu, Qxu, Qxu, Qxu, Xu, Qxu, Qxu^Bs/, Ur, Xu, Qxu, Qxu, Qxu, Qxu, Qxu, Uu
Xu, Xu, Xu, Xu, Ww, Ww, Wo, Xu, Xu, Xu, Xu, Xu, Uu^Vu, Uu, Uu, Uu, Uu, Uu, Ur, Cud, Cud, Cud, Uu^Uf, Uu, Uu, Ur, Uu, Ur, Ur, Ur, Ur, Xu, Ur, Ur, Ur, Uu, Uu, Uu, Xu, Uu, Xu, Xu, Uh, Xu, Uu, Ur, Uu^Uf, Uu^Uf, Uh, Uh, Xu, Xu, Qxu, Qxu, Qxu, Qxu, Xu, Xu, Uu, Qxu, Qxu^Bs/, Ur, Xu, Uu^Vu, Xu, Ur, Qxu^Bs\, Qxu, Qxu, Qxu, Qxu, Qxu, Xu, Xu, Qxu^Bs/, Ur, Qxu, Qxu, Ur, Qxu, Qxu, Qxu, Uu, Uu, Qxu, Qxu, Xu, Xu, Qxu, Qxu, Qxu, Qxu, Qxu
Xu, Xu, Ww, Wo, Wo, Wo, Wo, Wo, Wo, Wo, Ww, Xu, Ur, Uu, Ur, Ur, Ur, Ur, Uu, Uu, Uu^Uf, Uu^Uf, Uh, Uu^Uf, Uh, Uu^Uf, Xu, Uu, Xu, Xu, Xu, Ur, Xu, Xu, Ur, Xu, Ur, Ur, Ur, Uu, Xu, Xu, Uu^Uf, Uu^Uf, Ur, Uu^Uf, Uh, Uh, Xu, Xu, Xu, Xu, Xu, Qxu, Qxu, Qxu, Qxu, Uu^Vu, Ur, Ur, Qxu^Bs\, Qxu, Qxu, Xu, Qxu, Xu, Qxu, Ur, Uu, Qxu, Qxu, Qxu, Xu, Uu, Qxu, Qxu, Qxu, Qxu, Qxu, Qxu^Bs\, Ur, Qxu^Bs/, Qxu, Ur, Xu, Xu, Qxu, Qxu, Qxu, Qxu, Qxu, Qxu, Qxu
Xu, Xu, Ww, Wo, Wo, Wo, Wo, Ww, Wo, Wo, Ww^Bw/, Ur, Uu^Vu, Ur, Uh, Uu, Xu, Uu, Xu, Uu, Xu, Uh, Xu, Xu, Xu, Xu, Xu, Xu, Xu, Xu, Xu, Uh, Uh, Xu, Ur, Ur, Xu, Uu, Uu, Ur, Uu, Uu, Ur, Ur, Uu, Uu^Uf, Uh, Uh, Xu, Xu, Xu, Xu, Xu, Uu, Qxu, Qxu, Qxu, Uu, Uu, Uu, Qxu, Uu, Uu, Qxu, Qxu, Qxu, Qxu, Qxu, Ur, Ur, Qxu, Qxu, Qxu^Bs/, Ur, Uu, Qxu, Qxu, Qxu, Uu^Vu, Qxu^Bs/, Qxu, Qxu, Qxu, Ur, Qxu^Bs\, Qxu, Qxu, Qxu, Xu, Qxu, Qxu, Qxu, Qxu
Xu, Xu, Wo, Wo, Ww, Ww, Uu, Wo, Wo^Bw/, Wo^Bw/, Wo, Ww, Ww, Xu, Xu, Xu, Xu, Xu, Xu, Xu, Xu, Xu, Xu, Xu, Xu, Xu, Xu, Xu, Xu, Xu, Xu, Xu, Ur, Ur, Xu, Xu, Xu, Uu^Uf, Xu, Uu, Uu, Ur, Uu, Uu, Uh, Xu, Xu, Xu, Xu, Xu, Xu, Xu, Xu, Ur, Uu, Qxu, Qxu, Qxu^Bs|, Qxu, Qxu, Qxu, Uu^Vu, Xu, Xu, Qxu, Qxu, Qxu^Bs/, Ur, Qxu, Xu, Qxu, Ur, Qxu, Qxu, Qxu, Qxu, Qxu, Qxu, Qxu, Ur, Xu, Xu, Uu, Qxu, Qxu^Bs/, Ur, Ur, Qxu, Uu, Qxu, Qxu, Qxu, Qxu
Xu, Xu, Wo, Wo, Ww, Uu, Ur, Ur, Ww, Wo, Wo, Wo, Ww, Ww, Ww, Xu, Xu, Xu, Xu, Xu, Xu, Xu, Xu, Xu, Xu, Xu, Xu, Xu, Xu, Xu, Xu, Xu, Ur, Uu, Xu, Xu, Xu, Uh, Uh, Uu^Uf, Uh, Uu^Uf, Uu^Vu, Uu^Uf, Uh, Uh, Xu, Xu, Xu, Xu, Xu, Xu, Xu, Uu, Ur, Ur, Qxu^Bs\, Ur, Xu, Qxu, Qxu, Uu, Xu, Qxu, Qxu, Ur, Ur, Qxu, Ur, Qxu, Qxu, Qxu^Bs|, Qxu, Qxu, Xu, Xu, Qxu, Qxu, Qxu, Qxu, Qxu, Xu, Uu, Ur, Qxu, Qxu, Uu, Ur, Uu, Uu^Vu, Qxu, Qxu, Qxu
Xu, Xu, Xu, Wo, Uu, Uu^Vu, Uu, Uu, Ww, Wo, Wo, Wo, Wo, Wo, Wo, Ww, Ww, Xu, Xu, Xu, Xu, Xu, Xu, Xu, Xu, Xu, Xu, Xu, Xu, Xu, Xu, Ur, Xu, Uu^Vu, Xu, Xu, Xu, Xu, Xu, Uh, Xu, Uh, Xu, Uu^Uf, Uh, Xu, Xu, Xu, Xu, Xu, Xu, Xu, Xu, Xu, Uu^Vu, Ur, Qxu, Ur, Uu^Vu, Xu, Qxu, Qxu, Qxu, Qxu, Qxu, Qxu, Qxu^Bs/, Uu^Vu, Xu, Qxu^Bs\, Uu, Uu, Uu, Ur, Uu^Vu, Uu, Uu, Qxu, Qxu, Qxu, Qxu, Xu, Qxu, Ur, Qxu, Qxu, Xu, Uu, Uu, Uu, Xu, Qxu, Qxu
Xu, Xu, Xu, Wo, Wo, Uu, Ur, Wo, Wo, Wo, Wo, Wo, Ww, Wo, Wo, Wo, Ww, Xu, Xu, Xu, Xu, Xu, Xu, Xu, Xu, Xu, Xu, Xu, Xu, Xu, Xu, Ur, Uu, Uu, Uu, Xu, Xu, Xu, Xu, Xu, Xu, Xu, Xu, Xu, Xu, Xu, Xu, Xu, Xu, Xu, Xu, Xu, Xu, Xu, Ur, Qxu, Qxu, Qxu, Qxu^Bs|, Qxu, Qxu, Xu, Uu, Qxu, Ur, Uu, Qxu, Qxu, Qxu, Qxu, Qxu, Ur, Uu, Ur, Qxu, Uu, Qxu, Qxu^Bs\, Ur, Uu^Vu, Uu, Qxu, Qxu^Bs/, Ur, Qxu, Qxu, Qxu, Xu, Xu, Qxu, Qxu, Qxu, Qxu
Xu, Xu, Xu, Xu, Wo, Ww, Ww, Wo^Bw\, Wo^Bw\, Wo, Wo, Wo, Wo, Ww, Wo, Wo, Wo, Ww, Ww, Xu, Xu, Xu, Xu, Xu, Xu, Xu, Xu, Xu, Xu, Xu, Uu^Uf, Ur, Ur, Xu, Xu, Uh, Uh, Xu, Xu, Xu, Xu, Xu, Xu, Xu, Xu, Xu, Xu, Xu, Xu, Xu, Xu, Xu, Xu, Xu, Uu, Qxu, Qxu, Qxu, Uu, Qxu, Qxu, Xu, Qxu, Uu, Ur, Uu, Xu, Qxu, Qxu, Qxu, Qxu, Uu, Qxu, Qxu, Qxu, Qxu, Qxu, Qxu, Uu, Ur, Ur, Ur, Uu, Qxu, Qxu, Qxu, Qxu, Qxu, Qxu, Qxu, Qxu, Qxu, Qxu
Xu, Xu, Xu, Xu, Xu, Wo, Wo, Wo, Wo, Wo^Bw\, Wo^Bw\, Wo, Wo, Ww, Wo, Wo, Wo, Wo, Ww, Xu, Xu, Xu, Xu, Xu, Xu, Xu, Xu, Xu, Uu^Uf, Uu^Uf, Uu^Uf, Uu, Xu, Ur, Ur, Uu, Uu^Uf, Xu, Xu, Xu, Xu, Xu, Xu, Xu, Xu, Xu, Xu, Xu, Xu, Xu, Xu, Xu, Xu, Xu, Ur, Qxu, Ur, Qxu, Uu, Ur, Ur, Qxu, Qxu^Bs/, Uu, Xu, Xu, Qxu, Qxu, Qxu, Qxu, Qxu, Ur, Qxu, Qxu, Qxu, Qxu, Qxu, Qxu, Xu, Xu, Xu, Uu, Qxu, Qxu, Qxu, Qxu, Qxu, Qxu, Qxu, Qxu, Qxu, Qxu, Qxu
Xu, Xu, Xu, Xu, Ww, Ww, Wo, Wo, Wo, Wo, Wo^Bw|, Wo, Wo, Wo, Wo, Wo, Wo, Wo, Ww, Xu, Xu, Xu, Xu, Xu, Xu, Xu, Uu, Uh, Uh, Uu^Uf, Uu, Uu, Uu, Uu, Uu, Ur, Uu, Uu^Vu, Xu, Xu, Xu, Xu, Xu, Xu, Xu, Xu, Xu, Xu, Xu, Xu, Xu, Xu, Xu, Xu, Xu, Uu, Qxu, Qxu^Bs\, Ur, Ur, Xu, Ur, Ur, Qxu, Xu, Xu, Qxu, Qxu, Qxu, Qxu, Qxu, Qxu^Bs|, Qxu, Qxu, Xu, Qxu, Qxu, Qxu, Qxu, Qxu, Qxu, Qxu, Qxu, Qxu, Qxu, Qxu, Qxu, Qxu, Qxu, Qxu, Ur, Qxu, Xu
Xu, Xu, Xu, Xu, Ww, Ww, Wo, Wo, Uu, Uu, Ur, Wo, Ww, Wo, Wo, Wo, Wo, Ww, Xu, Xu, Xu, Xu, Xu, Xu, Uh, Xu, Uu^Vu, Uu, Uu, Uh, Uh, Uu, Xu, Uu, Uu, Ur, Xu, Uu, Xu, Xu, Xu, Xu, Xu, Xu, Xu, Xu, Xu, Xu, Xu, Xu, Xu, Xu, Xu, Xu, Xu, Uu^Vu, Qxu, Qxu, Xu, Ur, Ur, Uu^Vu, Qxu, Xu, Qxu, Qxu, Qxu, Qxu, Xu, Xu, Ur, Ur, Ur, Uu, Xu, Xu, Qxu, Qxu, Qxu, Qxu, Ur, Qxu, Ur, Qxu, Ur, Ur, Ur, Ur, Ur, Ur, Xu, Xu, Xu
Xu, Xu, Xu, Wo, Wo, Wo, Wo, Wo, Ww, Uu, Ur, Uu, Ww, Ww, Ww, Ww, Ww, Ww, Xu, Xu, Xu, Xu, Xu, Xu, Uh, Uu, Uu^Uf, Uu, Uu, Uh, Uh, Uu, Uu, Uu, Uu, Ur, Uu, Uu, Xu, Xu, Xu, Xu, Xu, Xu, Xu, Xu, Xu, Xu, Xu, Xu, Xu, Xu, Xu, Xu, Xu, Ur, Ur, Qxu, Qxu, Xu, Qxu, Ur, Qxu^Bs\, Qxu, Qxu, Qxu, Qxu, Qxu, Xu, Uu, Uu, Ur, Qxu, Qxu, Xu, Xu, Qxu, Qxu, Ur, Ur, Ur, Ur, Ur, Ur, Xu, Ur, Xu, Xu, Xu, Xu, Xu, Xu, Xu
Xu, Xu, Xu, Wo, Wo, Wo, Ww, Ww, Uu, Uu^Vu, Ur, Uu, Wo, Wo, Wo, Ww, Ww, Xu, Xu, Xu, Xu, Xu, Xu, Uh, Xu, Uh, Xu, Xu, Xu, Uu^Uf, Xu, Uu, Xu, Uu, Xu, Ur, Xu, Uu, Uu, Xu, Xu, Xu, Xu, Xu, Xu, Xu, Xu, Xu, Xu, Xu, Xu, Xu, Xu, Xu, Xu, Uu, Qxu, Qxu, Qxu, Qxu, Qxu, Qxu, Qxu, Uu, Uu, Qxu, Qxu, Qxu, Qxu, Uu, Qxu^Bs\, Qxu, Qxu, Qxu, Qxu, Qxu, Qxu, Qxu, Xu, Xu, Xu, Xu, Xu, Xu, Xu, Xu, Xu, Xu, Xu, Xu, Xu, Xu, Xu
Xu, Xu, Xu, Wo, Ww, Ww, Wo, Wo, Ww, Ur, Wo, Uu, Wo, Wo, Wo, Wo, Wo, Xu, Xu, Xu, Xu, Xu, Xu, Xu, Xu, Xu, Xu, Uh, Uh, Uu^Uf, Xu, Uu, Xu, Xu, Xu, Ur, Ur, Uu, Xu, Xu, Xu, Xu, Xu, Xu, Xu, Xu, Xu, Xu, Xu, Xu, Xu, Xu, Xu, Xu, Xu, Xu, Qxu, Qxu, Qxu, Qxu, Qxu, Qxu, Uu, Uu, Ur, Xu, Qxu, Qxu, Qxu, Qxu, Uu, Ur, Qxu, Qxu, Qxu, Qxu, Xu, Xu, Xu, Xu, Xu, Xu, Xu, Xu, Xu, Xu, Xu, Xu, Xu, Xu, Xu, Xu, Xu
Xu, Xu, Xu, Wo, Ww, Wo, Wo, Wo, Wo, Ww^Bw|, Wo, Wo, Wo, Wo, Wo, Wo, Wo, Xu, Xu, Xu, Xu, Xu, Xu, Xu, Xu, Xu, Uh, Uh, Uu^Uf, Xu, Xu, Uu, Xu, Xu, Xu, Xu, Ur, Uu, Uu, Xu, Xu, Xu, Xu, Xu, Xu, Xu, Xu, Xu, Xu, Xu, Xu, Xu, Xu, Xu, Xu, Xu, Xu, Qxu, Qxu, Qxu, Qxu, Qxu, Qxu, Uu, Ur, Xu, Qxu, Qxu, Xu, Qxu, Qxu^Bs|, Xu, Qxu, Qxu, Qxu, Xu, Xu, Xu, Xu, Xu, Xu, Xu, Xu, Xu, Xu, Xu, Xu, Xu, Xu, Xu, Xu, Xu, Xu
Xu, Xu, Xu, Ww, Wo, Wo, Wo, Wo, Wo^Bw/, Wo^Bw|, Wo, Wo, Wo, Wo, Ww, Ww, Xu, Xu, Xu, Xu, Xu, Xu, Xu, Xu, Xu, Uh, Xu, Uh, Uu^Uf, Xu, Xu, Uu^Vu, Uu, Xu, Ur, Ur, Uu^Vu, Xu, Xu, Xu, Xu, Xu, Xu, Xu, Xu, Xu, Xu, Xu, Xu, Xu, Xu, Xu, Xu, Xu, Xu, Xu, Xu, Qxu, Qxu, Qxu, Ur, Qxu, Ur, Qxu^Bs/, Qxu, Qxu, Qxu, Xu, Xu, Qxu, Ur, Qxu, Qxu, Qxu, Xu, Xu, Xu, Xu, Xu, Xu, Xu, Xu, Xu, Xu, Xu, Xu, Xu, Xu, Xu, Xu, Xu, Xu, Xu
Xu, Xu, Xu, Ww, Ww, Wo, Ww, Wo^Bw/, Ww, Wo, Wo, Wo, Wo, Ww, Xu, Xu, Xu, Xu, Xu, Xu, Xu, Xu, Xu, Xu, Xu, Xu, Xu, Uu^Uf, Uu^Uf, Xu, Uu, Uu, Ur, Ur, Xu, Uu^Uf, Xu, Xu, Xu, Xu, Xu, Xu, Xu, Xu, Xu, Xu, Xu, Xu, Xu, Xu, Xu, Xu, Xu, Xu, Xu, Xu, Xu, Xu, Xu, Xu, Xu, Ur, Qxu, Qxu^Bs\, Ur, Qxu, Qxu, Xu, Ur, Uu, Xu, Qxu, Xu, Xu, Xu, Xu, Xu, Xu, Xu, Xu, Xu, Xu, Xu, Xu, Xu, Xu, Xu, Xu, Xu, Xu, Xu, Xu, Xu
Xu, Xu, Xu, Xu, Xu, Ww, Uu, Ww^Bw|, Uu, Ww, Xu, Xu, Xu, Xu, Xu, Xu, Xu, Xu, Xu, Xu, Xu, Xu, Xu, Xu, Xu, Xu, Xu, Uu^Uf, Uu, Uu, Ur, Ur, Uh, Xu, Uh, Uh, Xu, Xu, Xu, Xu, Xu, Xu, Xu, Xu, Xu, Xu, Xu, Xu, Xu, Xu, Xu, Xu, Xu, Xu, Xu, Xu, Xu, Xu, Xu, Xu, Xu, Xu, Ur, Qxu^Bs/, Qxu, Qxu, Qxu, Ur, Xu, Xu, Xu, Xu, Xu, Xu, Xu, Xu, Xu, Xu, Xu, Xu, Xu, Xu, Xu, Xu, Uu, Uu, Uu, Uu, Uu, Uu, Uu, Uu, Uu
Xu, Xu, Xu, Xu, Xu, Xu, Uu, Ur, Xu, Uh, Xu, Xu, Xu, Xu, Xu, Xu, Xu, Xu, Xu, Xu, Xu, Xu, Xu, Xu, Xu, Xu, Uu^Vu, Uu, Ur, Ur, Uu^Uf, Uu^Uf, Uh, Uh, Xu, Xu, Xu, Xu, Xu, Xu, Xu, Xu, Xu, Xu, Xu, Xu, Xu, Xu, Xu, Xu, Xu, Xu, Xu, Xu, Xu, Xu, Xu, Xu, Xu, Xu, Xu, Uu, Ur, Uu, Uu, Uu, Ur, Uu, Xu, Xu, Xu, Xu, Xu, Xu, Xu, Xu, Xu, Xu, Xu, Xu, Xu, Xu, Xu, Uu, Uu^Vu, Uu, Uu, Uu, Uu, Uu, Uu, Uu, Uu
Xu, Xu, Xu, Xu, Xu, Uu^Vu, Uu, Ur, Uu^Uf, Xu, Xu, Xu, Xu, Xu, Xu, Xu, Xu, Xu, Xu, Xu, Xu, Xu, Xu, Xu, Uh, Uh, Uu^Uf, Uu, Ur, Xu, Uh, Xu, Xu, Uh, Xu, Xu, Xu, Xu, Xu, Xu, Xu, Xu, Xu, Xu, Xu, Xu, Xu, Xu, Xu, Xu, Xu, Xu, Xu, Xu, Xu, Xu, Xu, Xu, Xu, Xu, Xu, Uh, Ur, Xu, Xu, Uu, Xu, Xu, Xu, Xu, Xu, Xu, Xu, Xu, Xu, Xu, Xu, Xu, Xu, Xu, Xu, Xu, Uu, Uu, Uu, Uu, Uu, Uu, Uu, Uu, Uu, Uu, Ur
Xu, Xu, Xu, Xu, Xu, Uu, Xu, Ur, Xu, Uh, Xu, Xu, Xu, Xu, Xu, Xu, Xu, Xu, Xu, Xu, Xu, Xu, Xu, Uu, Uh, Uu^Uf, Xu, Ur, Xu, Xu, Uh, Xu, Xu, Xu, Xu, Xu, Xu, Xu, Xu, Xu, Xu, Xu, Xu, Xu, Xu, Xu, Xu, Xu, Xu, Xu, Xu, Xu, Xu, Xu, Xu, Xu, Xu, Xu, Xu, Xu, Uu^Uf, Uh, Xu, Ur, Xu, Uu^Vu, Xu, Xu, Xu, Xu, Xu, Xu, Xu, Xu, Xu, Xu, Xu, Xu, Xu, Xu, Xu, Xu, Uu, Uu, Uu, Uu, Uu, Uu, 1 Uu, Uu, Ur, Ur, Uu
Xu, Xu, Xu, Xu, Uu^Uf, Uu^Uf, Xu, Ur, Xu, Uh, Uh, Xu, Xu, Xu, Xu, Xu, Xu, Xu, Xu, Xu, Xu, Xu, Xu, Uu^Uf, Uh, Xu, Ur, Ur, Uu^Uf, Uh, Xu, Xu, Xu, Xu, Xu, Xu, Xu, Xu, Xu, Xu, Xu, Xu, Xu, Xu, Xu, Xu, Xu, Xu, Xu, Xu, Xu, Xu, Xu, Xu, Xu, Xu, Xu, Xu, Xu, Xu, Uu^Uf, Xu, Uh, Ur, Ur, Uh, Xu, Xu, Xu, Xu, Xu, Xu, Xu, Xu, Xu, Xu, Xu, Xu, Xu, Xu, Xu, Xu, Xu, Uu, Ur, Uu, Ur, Ur, Ur, Ur, Uu, Uu, Uu
Xu, Xu, Xu, Xu, Uu^Uf, Uu^Uf, Xu, Ur, Uu, Xu, Xu, Uh, Xu, Xu, Xu, Xu, Xu, Xu, Xu, Xu, Xu, Xu, Xu, Uh, Uh, Xu, Ur, Xu, Uu^Uf, Xu, Xu, Xu, Xu, Xu, Xu, Xu, Xu, Xu, Xu, Xu, Xu, Xu, Xu, Xu, Xu, Xu, Xu, Xu, Xu, Xu, Xu, Xu, Xu, Xu, Xu, Xu, Xu, Xu, Uu^Uf, Uu^Uf, Uu, Uh, Xu, Uu, Ur, Uh, Xu, Xu, Xu, Xu, Xu, Xu, Xu, Xu, Xu, Xu, Xu, Xu, Uu, Xu, Xu, Xu, Ur, Ur, Uu, Ur, Uu, Uu, Uu, Uu, Uu, Uu, Uu
Xu, Xu, Xu, Xu, Xu, Uu^Uf, Xu, Ur, Xu, Uu, Uh, Uu, Xu, Xu, Xu, Xu, Xu, Xu, Xu, Xu, Xu, Xu, Xu, Uh, Xu, Ur, Xu, Uu^Uf, Xu, Xu, Xu, Xu, Xu, Xu, Xu, Xu, Xu, Xu, Xu, Xu, Xu, Xu, Xu, Xu, Xu, Xu, Xu, Xu, Uh, Xu, Xu, Xu, Xu, Xu, Uu, Uu, Uu, Uu^Uf, Xu, Uu, Xu, Xu, Xu, Xu, Ur, Uh, Xu, Xu, Xu, Xu, Xu, Xu, Uh, Uu, Uu, Uu^Vu, Ur, Ur, Ur, Uu, Ur, Ur, Uu, Uu, Uu, Uu, Uu, Uu, Uu, Uu, Uu^Vu, Uu, Xu
Xu, Xu, Xu, Xu, Xu, Uu^Vu, Uu, Ur, Ur, Uu^Uf, Uu^Uf, Xu, Xu, Xu, Xu, Xu, Xu, Xu, Xu, Xu, Xu, Xu, Xu, Uu, Uu, Ur, Xu, Uh, Xu, Xu, Xu, Xu, Xu, Xu, Xu, Xu, Xu, Xu, Xu, Xu, Xu, Xu, Xu, Xu, Uu^Uf, Uu^Vu, Uu^Uf, Uh, Uh, Uh, Uu, Uu^Vu, Uu, Uu, Xu, Xu, Ur, Xu, Uh, Uh, Xu, Xu, Ur, Xu, Ur, Uu, Xu, Xu, Xu, Xu, Uh, Uh, Xu, Xu, Ur, Ur, Uu, Uu, Uu, Ur, Uu, Uu, Xu, Xu, Xu, Uu, Uu, Uu, Uu, Uu, Uu, Uu, Xu
Xu, Xu, Xu, Xu, Xu, Xu, Uh, Uu, Ur, Uu, Uu^Uf, Uu^Uf, Xu, Xu, Xu, Xu, Xu, Xu, Xu, Xu, Xu, Xu, Xu, Uu^Vu, Uu, Ur, Xu, Uh, Xu, Xu, Xu, Xu, Xu, Xu, Xu, Xu, Xu, Xu, Xu, Xu, Xu, Xu, Uu^Uf, Uu^Uf, Xu, Xu, Ur, Ur, Ur, Ur, Ur, Uu, Uu, Ur, Ur, Ur, Xu, Ur, Ur, Xu, Ur, Ur, Xu, Ur, Uu, Ur, Ur, Xu, Uu^Vu, Uu, Uu, Xu, Ur, Ur, Uu, Uu^Uf, Uu^Uf, Xu, Xu, Uu^Vu, Xu, Xu, Xu, Xu, Xu, Xu, Xu, Xu, Xu, Uu, Xu, Xu, Xu
Xu, Xu, Xu, Xu, Uh, Uh, Uh, Uu, Ur, Uu, Uu^Vu, Xu, Xu, Xu, Xu, Xu, Xu, Xu, Xu, Xu, Xu, Xu, Uu^Uf, Uu, Xu, Ur, Uu^Uf, Uu^Uf, Xu, Xu, Xu, Xu, Xu, Xu, Xu, Xu, Xu, Xu, Uu, Xu, Xu, Uu^Uf, Xu, Uu^Uf, Ur, Ur, Xu, Xu, Uu^Uf, Xu, Xu, Ur, Uu, Xu, Xu, Uh, Uh, Xu, Uu, Ur, Xu, Xu, Uu, Uu, Uu, Uu, Uu, Ur, Ur, Ur, Ur, Ur, Uu, Uu, Xu, Xu, Xu, Xu, Xu, Xu, Xu, Xu, Xu, Xu, Xu, Xu, Xu, Xu, Xu, Xu, Xu, Xu, Xu
Xu, Xu, Xu, Xu, Uh, Uh, Uu^Uf, Uu, Ur, Uh, Uh, Xu, Xu, Xu, Xu, Xu, Xu, Xu, Xu, Xu, Xu, Xu, Uu^Uf, Xu, Xu, Ur, Xu, Uu^Uf, Xu, Xu, Xu, Xu, Xu, Xu, Xu, Xu, Uu, Uu, Xu, Uu, Xu, Uu, Ur, Ur, Uu, Xu, Xu, Uu^Uf, Uh, Xu, Xu, Xu, Uh, Xu, Uh, Uh, Uh, Uu^Uf, Uu^Uf, Uu, Uu, Uu, Xu, Xu, Xu, Xu, Xu, Ur, Uu, Uu, Uh, Uu, Xu, Uh, Xu, Xu, Xu, Xu, Xu, Xu, Xu, Xu, Xu, Xu, Xu, Xu, Xu, Xu, Xu, Xu, Xu, Xu, Xu
Xu, Xu, Xu, Xu, Uu^Uf, Uu^Uf, Uu^Uf, Uu, Ur, Uu^Uf, Xu, Xu, Xu, Xu, Xu, Xu, Xu, Xu, Xu, Xu, Xu, Xu, Uu, Xu, Xu, Ur, Xu, Uu^Uf, Xu, Xu, Xu, Xu, Xu, Xu, Uu^Vu, Uu, Xu, Xu, Cud, Cud, 6 Kud, Ur, Uu, Uu, Uu, Uu, Uu^Uf, Uh, Uh, Uh, Uh, Uh, Xu, Xu, Xu, Xu, Xu, Xu, Uu^Uf, Uu^Vu, Xu, Xu, Xu, Xu, Xu, Xu, Ur, Ur, Ur, Uh, Xu, Xu, Xu, Xu, Xu, Xu, Xu, Xu, Xu, Xu, Xu, Xu, Xu, Xu, Xu, Xu, Xu, Xu, Xu, Xu, Xu, Xu, Xu
Xu, Xu, Xu, Xu, Xu, Xu, Uu^Vu, Uu, Ur, Uu^Uf, Uu^Uf, Xu, Xu, Xu, Xu, Xu, Xu, Xu, Xu, Xu, Xu, Xu, Uu^Vu, Uu, Xu, Ur, Uu^Uf, Uu^Uf, Xu, Xu, Xu, Xu, Xu, Xu, Uu, Uu, Xu, Ur, Xu, Cud, Cud, Uu, Uu, Uu, Uu, Xu, Xu, Xu, Xu, Xu, Xu, Xu, Xu, Xu, Xu, Xu, Xu, Xu, Uu^Uf, Xu, Xu, Xu, Xu, Xu, Xu, Ur, Uu, Uu, Ur, Uh, Uh, Xu, Xu, Xu, Xu, Xu, Xu, Xu, Xu, Xu, Xu, Xu, Xu, Xu, Xu, Xu, Xu, Xu, Xu, Xu, Xu, Xu, Xu
Xu, Xu, Uu^Vu, Xu, Xu, Xu, Uu, Ur, Uu, Uu^Uf, Uu^Uf, Xu, Xu, Xu, Xu, Xu, Xu, Xu, Xu, Xu, Xu, Xu, Xu, Uu, Uu, Ur, Uu, Uu^Uf, Xu, Xu, Xu, Xu, Xu, Uu, Ur, Uu, Ur, Ur, Uu, Xu, Uu, Cud, Uu, Xu, Uu^Uf, Xu, Xu, Xu, Xu, Xu, Xu, Xu, Xu, Xu, Xu, Xu, Xu, Uu^Uf, Uh, Uu^Uf, Uh, Uu, Uu, Xu, Ur, Ur, Uu, Uu^Vu, Uh, Ur, Uu, Xu, Xu, Xu, Xu, Xu, Xu, Xu, Xu, Xu, Xu, Xu, Xu, Xu, Xu, Xu, Xu, Xu, Xu, Xu, Xu, Xu, Xu
Xu, Uh, Uu^Uf, Uu, Uu, Uu, Uu, Ur, Uu, Xu, Xu, Xu, Xu, Xu, Xu, Xu, Xu, Xu, Xu, Xu, Xu, Xu, Xu, Uu, Ur, Ur, Uh, Xu, Xu, Xu, Ur, Ur, Ur, Ur, Uu, Uu, Uu^Uf, Xu, Uu^Uf, Uu, Uu, Uu, Xu, Uu, Xu, Uh, Uu, Xu, Xu, Xu, Xu, Xu, Xu, Xu, Xu, Xu, Xu, Xu, Xu, Xu, Uh, Uu, Ur, Ur, Xu, Xu, Xu, Uu^Uf, Xu, Ur, Ur, Uu^Uf, Uh, Xu, Xu, Xu, Xu, Xu, Xu, Xu, Xu, Xu, Xu, Xu, Xu, Xu, Xu, Xu, Xu, Xu, Xu, Xu, Xu
Uu, Uu, Ur, Ur, Uu^Uf, Ur, Ur, Ur, Uu, Uu^Uf, Uu^Uf, Xu, Xu, Xu, Xu, Xu, Xu, Xu, Xu, Xu, Xu, Xu, Xu, Xu, Ur, Uu^Uf, Uh, Xu, Uu, Uu, Ur, Uu, Xu, Uu, Uh, Uh, Uh, Uh, Uh, Uu^Uf, Xu, Uu, Xu, Uu^Uf, Xu, Uh, Ur, Uu, Xu, Xu, Xu, Xu, Xu, Xu, Xu, Xu, Xu, Xu, Xu, Xu, Uu, Ur, Uu^Vu, Uu, Xu, Xu, Xu, Xu, Xu, Uu^Uf, Uu, Ur, Uu^Uf, Xu, Xu, Xu, Xu, Xu, Xu, Xu, Xu, Xu, Xu, Xu, Xu, Xu, Xu, Xu, Xu, Xu, Xu, Xu, Xu
Ur, Ur, Xu, Uu^Uf, Uh, Xu, Xu, Ur, Ur, Xu, Uu^Uf, Uu^Uf, Uu^Uf, Xu, Xu, Xu, Xu, Xu, Xu, Xu, Xu, Xu, Uh, Uu^Uf, Ur, Uu^Uf, Uh, Xu, Uu, Ur, Uu, Uu, Uu^Vu, Xu, Xu, Xu, Xu, Xu, Xu, Uu^Uf, Uu^Vu, Uu, Uu^Uf, Uu^Uf, Xu, Uu, Ur, Uu, Uu, Xu, Xu, Xu, Xu, Xu, Xu, Xu, Xu, Xu, Xu, Uu, Ur, Ur, Uu, Xu, Xu, Xu, Xu, Xu, Xu, Uh, Uu^Uf, Ur, Uu, Uh, Xu, Xu, Xu, Xu, Xu, Xu, Xu, Xu, Xu, Xu, Xu, Xu, Xu, Xu, Xu, Xu, Xu, Xu, Xu
Xu, Uu, Uu, Uu, Xu, Uh, Uh, Xu, Ur, Xu, Uu, Xu, Xu, Xu, Xu, Xu, Xu, Xu, Xu, Xu, Xu, Xu, Uh, Uu^Uf, Uu^Uf, Ur, Ur, Uu, Ur, Ur, Xu, Xu, Xu, Xu, Xu, Xu, Xu, Xu, Xu, Xu, Xu, Xu, Xu, Xu, Xu, Uu, Uu, Ur, Uu, Xu, Xu, Xu, Uu^Uf, Xu, Uh, Xu, Xu, Xu, Uu^Uf, Uh, Ur, Xu, Xu, Xu, Xu, Xu, Xu, Xu, Uh, Xu, Xu, Ur, Ur, Xu, Xu, Xu, Xu, Xu, Xu, Xu, Xu, Xu, Xu, Xu, Xu, Xu, Xu, Xu, Xu, Xu, Xu, Xu, Xu
Uu, Uu, Uu, Uu, Xu, Uh, Xu, Uu^Uf, Uu, Ur, Uu, Uu^Vu, Xu, Xu, Xu, Xu, Xu, Xu, Xu, Xu, Xu, Xu, Xu, Uh, Uh, Uh, Uu, Ur, Ur, Uu, Uu^Uf, Xu, Xu, Xu, Xu, Xu, Xu, Xu, Xu, Xu, Xu, Xu, Xu, Xu, Xu, Xu, Xu, Ur, Uh, Uh, Uh, Uh, Uu, Uu, Cud, Uh, Cud, Uh, Ur, Ur, Uu^Uf, Xu, Xu, Xu, Xu, Xu, Uh, Uh, Uu^Uf, Uh, Xu, Uu^Uf, Ur, Uu, Uh, Xu, Uu, Uu, Uu, Xu, Uu, Xu, Xu, Xu, Uu, Uu, Uu, Uu, Uu, Xu, Xu, Xu, Xu
Xu, Xu, Xu, Xu, Xu, Xu, Xu, Xu, Xu, Ur, Uu, Xu, Xu, Xu, Xu, Xu, Xu, Xu, Xu, Xu, Xu, Xu, Xu, Xu, Xu, Xu, Uu^Uf, Xu, Ur, Xu, Uu^Uf, Uu^Uf, Xu, Xu, Xu, Xu, Xu, Xu, Xu, Xu, Xu, Xu, Xu, Xu, Xu, Xu, Xu, Ur, Uh, Uu^Uf, Uu, Uu^Uf, Uu, Uu, Cud, Cud, 3 Kud, Ur, Xu, Uu^Uf, Xu, Xu, Xu, Xu, Xu, Xu, Uu, Uu^Uf, Xu, Uu^Uf, Uu^Vu, Uu^Uf, Ur, Uh, Ur, Uu, Ur, Uu, Uu, Uu, Uu, Uu, Uu, Uu, Uu, Uu, Uu, Uu, Uu, Uu, Xu, Xu, Xu
Xu, Xu, Xu, Xu, Xu, Xu, Uh, Uh, Ur, Ur, Uu, Xu, Xu, Xu, Xu, Xu, Xu, Xu, Xu, Xu, Xu, Xu, Xu, Xu, Xu, Xu, Uh, Uu^Uf, Uh, Ur, Ur, Uu^Uf, Uu^Uf, Xu, Uu, Xu, Uu^Vu, Xu, Xu, Xu, Xu, Xu, Xu, Xu, Uh, Xu, Xu, Ur, Uu, Uu^Uf, Uu, Uu, Uu, Xu, Cud, Cud, Cud, Cud, Xu, Xu, Xu, Xu, Xu, Xu, Xu, Uu^Uf, Uu^Uf, Xu, Xu, Xu, Uu, Uu, Ur, Ur, Uu, Ur, Uu, Ur, Ur, Uu, Ur, Uu, Uu, Uu, Uu, Uu, Uu^Vu, Uu, Uu, Uu, Uu, Xu, Xu
Xu, Xu, Xu, Xu, Xu, Xu, Xu, Uu, Ur, Uu, Xu, Xu, Xu, Xu, Xu, Xu, Xu, Xu, Xu, Xu, Xu, Xu, Xu, Xu, Xu, Xu, Xu, Uh, Xu, Uu, Uu^Uf, Ur, Ur, Uu, Uu, Uu, Uh, Xu, Xu, Xu, Xu, Xu, Uu^Uf, Xu, Uh, Uh, Xu, Ur, Ur, Uu, Ur, Ur, Ur, Ur, Uh, Cud, Uh, Uh, Xu, Xu, Xu, Xu, Xu, Xu, Xu, Uh, Xu, Uh, Uh, Uu^Uf, Ur, Ur, Uh, Uh, Xu, Uu, Uu, Uu, Uu, Ur, Uu, Ur, Ur, Uu, Uu, Uu, Uu, Uu, Uu, Uu, Uu, Uu, Uu
Xu, Xu, Xu, Xu, Xu, Xu, Xu, Uu^Vu, Ur, Uu, Xu, Xu, Xu, Xu, Xu, Xu, Xu, Xu, Xu, Xu, Xu, Xu, Xu, Xu, Xu, Xu, Xu, Uu^Vu, Uu, Uh, Uu, Uu^Uf, Ur, Uu, Uu, Uu, Uh, Uh, Xu, Xu, Xu, Xu, Uu^Uf, Uu^Uf, Ur, Ur, Xu, Uu, Uu^Vu, Ur, Uu, Uu, Uu, Uh, Uh, Xu, Xu, Xu, Xu, Xu, Xu, Xu, Xu, Xu, Xu, Uh, Xu, Xu, Xu, Uu, Ur, Xu, Xu, Xu, Xu, Uu, Uu, Uu^Vu, Uu, Uu, Uu, Uu, Uu, Ur, Ur, Uu, Uu, Uu, Uu, Uu, Uu, Uu, Ur
Xu, Xu, Xu, Xu, Xu, Xu, Xu, Xu, Ur, Uu, Xu, Xu, Xu, Xu, Xu, Xu, Xu, Xu, Xu, Xu, Xu, Xu, Xu, Xu, Xu, Xu, Uh, Uh, Ur, Ur, Ur, Ur, Uu, Ur, Ur, Ur, Ur, Uu, Uu, Xu, Uu, Uu^Uf, Uu, Uu^Vu, Ur, Xu, Xu, Uh, Uh, Xu, Uu^Uf, Xu, Xu, Xu, Xu, Xu, Xu, Xu, Xu, Xu, Xu, Xu, Xu, Xu, Xu, Uh, Uu, Xu, Uu, Uu, Ur, Xu, Xu, Xu, Xu, Xu, Xu, Uu, Uu, Uu, Uu, Uu, Uu, Uu, Uu, Ur, Ur, Ur, Ur, Uu, Ur, Ur, Uu
Xu, Xu, Xu, Xu, Xu, Xu, Xu, Uu^Uf, Xu, Ur, Uh, Xu, Xu, Xu, Xu, Xu, Xu, Xu, Xu, Xu, Uh, Uh, Uu^Uf, Uu^Vu, Uu, Uu, Ur, Ur, Uu, Uu, Uu^Uf, Uu, Uu, Uu, Uu, Uu, Uu, Ur, Ur, Ur, Ur, Uu, Ur, Ur, Uu, Xu, Xu, Uh, Uu^Uf, Uu^Uf, Xu, Xu, Xu, Xu, Xu, Xu, Xu, Xu, Xu, Xu, Xu, Xu, Xu, Xu, Xu, Xu, Uu, Uh, Xu, Xu, Uu^Vu, Ur, Uu, Xu, Xu, Xu, Xu, Xu, Xu, Xu, Xu, Uu, Uu, Uu, Uu, Uu, Uu, Uu, Uu, Ur, Uu, Uu, Xu
Xu, Xu, Xu, Xu, Xu, Xu, Xu, Uu^Uf, Ur, Ur, Uh, Xu, Xu, Xu, Xu, Xu, Xu, Xu, Xu, Uh, Uu, Uu^Uf, Uu, Uu, Ur, Ur, Uu, Uu, Uu^Uf, Uu^Uf, Uu^Uf, Uu, Xu, Uu^Vu, Xu, Uh, Uh, Uu, Uh, Uu, Uh, Ur, Uu, Ur, Uu, Uu, Xu, Uh, Xu, Xu, Xu, Xu, Xu, Xu, Xu, Xu, Xu, Xu, Xu, Xu, Xu, Xu, Xu, Xu, Xu, Uu^Uf, Xu, Xu, Xu, Xu, Uu, Ur, Uu, Uh, Uh, Xu, Xu, Xu, Xu, Xu, Xu, Uu, Uu^Vu, Uu, Uu, Uu, Uu, Uu, Uu, Uu, Uu, Xu, Xu
Xu, Xu, Xu, Xu, Xu, Xu, Xu, Uu^Uf, Ur, Uu, Uu, Xu, Xu, Xu, Xu, Xu, Uh, Uh, Uu, Uu, Ur, Uu, Ur, Ur, Uu, Uu, Xu, Uu^Uf, Xu, Xu, Xu, Xu, Xu, Xu, Xu, Xu, Xu, Xu, Xu, Xu, Xu, Uu^Uf, Uu^Uf, Ur, Ur, Uu, Uu, Xu, Xu, Xu, Xu, Xu, Xu, Xu, Xu, Xu, Xu, Xu, Xu, Xu, Xu, Xu, Xu, Xu, Xu, Uu, Uu, Uu, Ur, Xu, Ur, Ur, Xu, Uu^Uf, Uu, Xu, Xu, Xu, Xu, Xu, Xu, Xu, Xu, Uu, Uu, Uu, Uu, Uu, Uu, Uu, Uu, Xu, Xu
Xu, Xu, Xu, Xu, Xu, Xu, Uu^Uf, Uu^Uf, Uu, Ur, Uu^Uf, Uu^Vu, Xu, Xu, Uh, Uh, Uu, Uu, Ur, Ur, Uu, Ur, Uu, Uu, Xu, Uu^Uf, Uh, Xu, Xu, Xu, Xu, Xu, Xu, Xu, Xu, Xu, Xu, Xu, Xu, Xu, Xu, Xu, Xu, Uu^Uf, Uu^Vu, Ur, Ur, Uu^Uf, Uh, Uu^Uf, Uu^Uf, Uh, Xu, Xu, Xu, Xu, Xu, Xu, Xu, Xu, Xu, Xu, Xu, Xu, Uh, Uh, Ur, Ur, Uu, Ur, Uu, Uu, Xu, Xu, Uu^Uf, Xu, Xu, Xu, Xu, Xu, Xu, Xu, Xu, Xu, Xu, Uu, Xu, Uu, Xu, Uu, Xu, Xu, Xu
Xu, Xu, Xu, Xu, Xu, Xu, Xu, Uu^Uf, Uu, Ur, Uu, Uu^Uf, Uh, Uu^Uf, Uu^Uf, Uu, Ur, Ur, Uu, Uu, Uu^Uf, Xu, Xu, Uu^Vu, Uh, Uh, Xu, Xu, Xu, Xu, Xu, Xu, Xu, Xu, Xu, Xu, Xu, Xu, Xu, Xu, Xu, Xu, Xu, Xu, Uu, Uu, Ur, Uu, Uu, Uh, Ur, Uu^Uf, Uh, Xu, Xu, Xu, Ur, Xu, Ql, Xu, Ql, Xu, Xu, Xu, Uu^Uf, Uh, Ur, Uu, Uu^Uf, Xu, Xu, Xu, Xu, Uu^Uf, Xu, Xu, Xu, Xu, Xu, Xu, Xu, Xu, Xu, Xu, Xu, Xu, Xu, Xu, Xu, Xu, Xu, Xu, Xu
Xu, Xu, Xu, Xu, Xu, Xu, Xu, Uh, Uu, Ur, Uu, Uu^Uf, Uh, Xu, Uu, Ur, Uu, Uu, Uu^Vu, Uu^Uf, Uu^Uf, Xu, Uu^Uf, Uu, Uu, Uh, Xu, Xu, Xu, Xu, Xu, Xu, Xu, Xu, Xu, Xu, Xu, Xu, Xu, Xu, Xu, Xu, Uh, Uh, Uu, Ur, Uu, Ur, Ur, Ur, Xu, Ur, Ur, Xu, Uu, Xu, Ur, Ur, Ql, Ql, Ql, Ql, Ql, Uu, Ur, Ur, Uu, Uu, Uh, Xu, Xu, Uh, Uh, Uu^Uf, Xu, Xu, Xu, Xu, Xu, Xu, Xu, Xu, Xu, Xu, Xu, Xu, Xu, Xu, Xu, Xu, Xu, Xu, Xu
Xu, Xu, Xu, Xu, Xu, Xu, Xu, Xu, Xu, Ur, Ur, Uu^Uf, Uh, Xu, Xu, Ur, Xu, Uu, Uu, Xu, Xu, Uu^Uf, Xu, Xu, Uu, Uh, Uu^Uf, Xu, Xu, Xu, Xu, Xu, Xu, Xu, Xu, Xu, Xu, Xu, Xu, Xu, Uh, Xu, Uu^Uf, Uu, Ur, Ur, Uu, Xu, Xu, Xu, Xu, Xu, Xu, Ur, Ql, Ql, Ql, Ql, Ql, Ql, Uu, Uu, Ur, Ql^Bs/, Ql, Uu, Uu, Uu, Uu, Uh, Uu^Vu, Uu, Xu, Xu, Xu, Xu, Xu, Xu, Xu, Xu, Xu, Xu, Xu, Xu, Xu, Xu, Xu, Xu, Xu, Xu, Xu, Xu, Xu
Xu, Xu, Xu, Xu, Xu, Xu, Uu^Vu, Xu, Ur, Ur, Uh, Ur, Ur, Uh, Xu, Ur, Xu, Xu, Uh, Xu, Uh, Xu, Xu, Xu, Uu, Ur, Xu, Xu, Xu, Xu, Xu, Xu, Xu, Xu, Xu, Xu, Xu, Xu, Uh, Uh, Uu^Uf, Uu^Uf, Uu^Uf, Xu, Ur, Uu, Uu, Xu, Xu, Xu, Xu, Xu, Ql, Ql^Bs|, Ql, Ql, Ql, Ql, Ur, Ql, Ur, Ur, Uu, Ql, Ql^Bs/, Uu, Ql, Uu, Ql^Bs\, Ql, Xu, Xu, Xu, Xu, Xu, Xu, Xu, Xu, Xu, Xu, Xu, Xu, Xu, Xu, Xu, Xu, Uh, Uh, Uh, Xu, Xu, Xu, Xu
Xu, Xu, Xu, Xu, Xu, Xu, Uu, Ur, Uu, Xu, Xu, Uh, Uh, Ur, Ur, Ur, Xu, Xu, Uh, Xu, Uu^Uf, Xu, Uu^Uf, Xu, Uu^Vu, Ur, Xu, Xu, Xu, Xu, Xu, Xu, Xu, Xu, Xu, Xu, Xu, Uh, Uh, Uu^Uf, Uu^Uf, Uu^Uf, Uu^Uf, Uu, Uu^Uf, Ur, Ur, Xu, Ur, Xu, Xu, Xu, Ql, Uu, Uu, Ql, Xu, Uu^Vu, Ql, Ql^Bs\, Uu, Uu, Ur, Uu, Ql, Ql, Ql, Ql, Ql, Ur, Uu, Xu, Xu, Xu, Xu, Xu, Xu, Xu, Xu, Xu, Xu, Xu, Xu, Xu, Uh, Uh, Uh, Uh, Uu, Uh, Uh, Xu, Xu
Xu, Xu, Xu, Xu, Xu, Xu, Uu^Uf, Ur, Uu, Xu, Xu, Xu, Uh, Xu, Uh, Uh, Uh, Uh, Uu, Uu, Xu, Uu^Uf, Uu^Uf, Uu, Uh, Ur, Xu, Xu, Xu, Xu, Xu, Xu, Xu, Xu, Xu, Xu, Uh^Dr, Uh^Dr, Uh, Uh, Uh, Uh, Xu, Xu, Xu, Uh, Uh, Ur, Uu, Ur, Uu, Ur, Ql^Bs/, Ur, Ql^Bs\, Ql, Xu, Xu, Ql, Ql, Ql, Ql, Ql, Ql^Bs\, Ur, Ql, Ql, Ql, Ql, Ql, Ql, Ur, Xu, Xu, Xu, Xu, Xu, Xu, Xu, Xu, Xu, Xu, Uu^Uf, Xu, Ur, Uu, Ur, Uu^Ii, Uu, Uh, Uh, Xu, Xu
Xu, Xu, Xu, Xu, Xu, Uh, Uh, Ur, Ur, Xu, Uu, Xu, Xu, Xu, Xu, Xu, Xu, Xu, Uu, Uu, Xu, Xu, Xu, Uu, Uh, Ur, Xu, Xu, Xu, Xu, Xu, Xu, Uh, Uh, Ur, Ur, Uh, Uh^Dr, Xu, Uh, Xu, Xu, Xu, Xu, Xu, Xu, Xu, Uu^Uf, Xu, Uu^Vu, Ur, Uu, Ql, Ql, Ql, Ur, Uu, Ur, Ql, Ql, Ql, Ql, Xu, Ql, Ql^Bs/, Uu, Xu, Ql, Uu^Vu, Ql, Ql, Uu, Xu, Xu, Xu, Xu, Xu, Xu, Xu, Xu, Uu^Vu, Uu^Uf, Ur, Uu, Xu, Ur, Uu, Uu, Uu, Uh, Xu, Xu, Xu
Xu, Xu, Xu, Xu, Xu, Xu, Uh, Uu, Ur, Uu, Uu^Vu, Xu, Xu, Xu, Xu, Xu, Xu, Xu, Uu^Uf, Uu^Vu, Xu, Xu, Xu, Xu, Uu, Ur, Xu, Xu, Xu, Xu, Xu, Uh, Xu, Uu, Ur, Uh, Xu, Xu, Xu, Xu, Xu, Xu, Xu, Xu, Xu, Xu, Xu, Xu, Xu, Ql, Ql^Bs|, Ql, Ql, Ql, Ql, Ql, Ql, Ql^Bs\, Uu, Ql, Uu, Xu, Xu, Ur, Ql, Xu, Xu, Xu, Ql, Ql^Bs\, Uu, Ur, Uu^Vu, Xu, Xu, Xu, Xu, Xu, Xu, Xu, Uu, Ur, Uu, Xu, Xu, Uu, Uu^Uf, Uu^Uf, Uh, Uh, Xu, Xu, Xu
Xu, Xu, Xu, Xu, Xu, Xu, Uh, Uu^Uf, Uu^Uf, Ur, Uu, Xu, Xu, Xu, Xu, Xu, Xu, Uh, Uu^Uf, Uu, Uu, Xu, Xu, Xu, Uu, Uu, Xu, Xu, Xu, Xu, Xu, Uh, Uu, Ur, Uu, Uu, Xu, Xu, Xu, Xu, Xu, Xu, Xu, Xu, Xu, Xu, Xu, Xu, Xu, Ql, Uu, Ql, Ql, Ql, Ql, Ql, Ql, Ql, Uu, Uu^Vu, Uu, Ql^Bs\, Uu, Uu, Ql, Ql, Uu, Ur, Ql, Ql, Xu, Ql, Ur, Xu, Xu, Xu, Xu, Xu, Xu, Uh, Ur, Xu, Uu, Uu^Uf, Uu^Uf, Uu, Uu, Xu, Xu, Xu, Xu, Xu, Xu
Xu, Xu, Xu, Xu, Xu, Xu, Xu, Uh, Uu^Uf, Ur, Ur, Xu, Xu, Xu, Xu, Xu, Uh, Uh, Uu, Uu, Xu, Xu, Xu, Xu, Ur, Ur, Xu, Xu, Xu, Xu, Xu, Xu, Uu, Ur, Uu^Vu, Uu^Uf, Xu, Xu, Xu, Xu, Xu, Xu, Xu, Xu, Xu, Xu, Xu, Xu, Ur, Ur, Ur, Ql, Ql, Ql, Ql, Ql, Ql, Ql, Ql, Xu, Xu, Ql, Ql^Bs/, Uu, Ql, Ql, Ql, Ql, Ql, Xu, Xu, Ql, Ql^Bs/, Ur, Xu, Xu, Xu, Xu, Xu, Uh, Uu, Xu, Xu, Xu, Xu, Xu, Uu^Uf, Xu, Xu, Xu, Xu, Xu, Xu
Xu, Xu, Xu, Xu, Xu, Xu, Xu, Xu, Uh, Uu, Ur, Uu, Cud, Xu, Cud, Cud, Cud, Uu^Uf, Xu, Xu, Xu, Xu, Xu, Uu, Uh, Uu, Xu, Xu, Xu, Xu, Xu, Uh, Ur, Ur, Uh, Uu^Uf, Xu, Xu, Xu, Xu, Xu, Xu, Xu, Xu, Xu, Xu, Xu, Xu, Uu, Xu, Ql, Ql, Ql, Ql, Ur, Ql, Ql, Ql, Ql, Xu, Ur, Ur, Ql, Ql, Ql, Ql, Ql, Ql, Ql, Xu, Uu, Ur, Ql, Xu, Xu, Xu, Xu, Xu, Xu, Xu, Xu, Uu, Ur, Uu, Uu^Vu, Xu, Uu^Uf, Xu, Xu, Xu, Xu, Xu, Xu
Xu, Xu, Xu, Xu, Xu, Xu, Xu, Xu, Xu, Uu, Xu, Ur, Cud, Cud, Xu, Cud, Cud, Xu, Xu, Xu, Xu, Xu, Ur, Ur, Xu, Xu, Xu, Xu, Xu, Xu, Uu^Uf, Uu, Ur, Uu, Uh, Uh, Xu, Xu, Xu, Xu, Xu, Xu, Xu, Xu, Xu, Xu, Xu, Ur, Ql, Ur, Ql, Ql, Ql, Ql, Xu, Ur, Ur, Ur, Ur, Ql, Ql, Ql^Bs|, Uu^Vu, Ql, Ur, Ql, Ql, Ql, Ql, Ur, Ql, Ql^Bs\, Ur, Xu, Xu, Xu, Xu, Xu, Xu, Xu, Xu, Xu, Uu, Ur, Uu, Uu, Uu, Uh, Xu, Xu, Xu, Xu, Xu
Xu, Xu, Xu, Xu, Xu, Xu, Xu, Xu, Xu, Xu, Xu, Cud, Cud, Xu, Xu, 5 Kud, Cud, Xu, Xu, Xu, Uu, Ur, Uh, Uh, Xu, Xu, Xu, Xu, Xu, Xu, Uu, Ur, Uu, Uu, Uu, Xu, Xu, Xu, Xu, Xu, Xu, Xu, Xu, Xu, Xu, Xu, Xu, Ql, Ql^Bs/, Ur, Ql^Bs\, Ql, Ql, Ql, Xu, Uu^Vu, Ql, Ql, Ql, Ql^Bs\, Ur, Ur, Xu, Xu, Ur, Ql, Ql, Ql, Ql, Ql, Ql, Ql, Ql, Ql^Bs\, Uu, Xu, Xu, Xu, Xu, Xu, Xu, Uu, Uu, Uu, Uu^Uf, Xu, Uu, Uh, Uh, Xu, Xu, Xu, Xu
Xu, Xu, Xu, Xu, Xu, Xu, Xu, Xu, Xu, Xu, Xu, Xu, Cud, Cud, Cud, Cud, Ur, Xu, Xu, Ur, Uu, Xu, Xu, Xu, Xu, Xu, Xu, Xu, Qlf, Qlf, Qlf, Ur, Qlf, Uu, Qlf, Xu, Xu, Xu, Xu, Xu, Xu, Xu, Xu, Xu, Xu, Xu, Xu, Uu^Vu, Ql, Ql, Ur, Ur, Ql, Ql, Ql^Bs/, Ur, Ql^Bs\, Ql, Ql, Ql, Ur, Xu, Ql, Ql, Ql, Ql, Ql, Ql, Cud, Xu, Xu, Ql, Ql, Ql, Ur, Xu, Xu, Xu, Xu, Xu, Uh, Ur, Xu, Xu, Xu, Uu^Uf, Uu, Uh, Uh, Xu, Xu, Xu, Xu
Xu, Xu, Xu, Xu, Xu, Xu, Xu, Xu, Xu, Xu, Xu, Xu, Xu, Xu, Xu, Uu, Uu, Ur, Uu, Ur, Uu, Xu, Xu, Xu, Xu, Xu, Xu, Xu, Qlf, Qlf, Qlf, Ur, Qlf, Qlf, Qlf, Qlf, Qlf, Xu, Xu, Xu, Xu, Xu, Xu, Xu, Xu, Xu, Xu, Ur, Ur, Xu, Ql, Ql^Bs\, Ur, Ur, Ql, Ql, Uu, Ur, Ql, Ql, Ql, Ql, Ql, Ql, Ql, Ql, Ur, Ql^Bs/, Cud, 2 Kud, Cud, Xu, Ql, Ql, Ql, Uu, Xu, Xu, Xu, Xu, Xu, Ur, Uu, Xu, Xu, Xu, Uu, Xu, Xu, Xu, Xu, Xu, Xu
Xu, Xu, Xu, Xu, Xu, Xu, Xu, Xu, Xu, Xu, Xu, Xu, Xu, Xu, Xu, Xu, Xu, Uu, Xu, Uu, Xu, Xu, Xu, Xu, Xu, Xu, Qlf, Qlf, Qlf, Qlf, Ur, Ur, Ur, Qlf, Qlf, Qlf, Qlf, Xu, Xu, Xu, Xu, Xu, Xu, Xu, Xu, Xu, Xu, Xu, Xu, Uu, Ur, Ql, Ur, Ql, Ur, Xu, Xu, Ur, Ql^Bs\, Ql, Ql, Ql, Uu, Ur, Uu, Ql^Bs/, Ur, Ql, Ql, Cud, Ql, Ql, Ql, Ql, Ql, Ur, Ur, Xu, Uu, Xu, Xu, Uu, Ur, Uu, Uu^Vu, Uu^Uf, Xu, Uh, Xu, Xu, Xu, Xu, Xu
Xu, Xu, Xu, Xu, Xu, Xu, Xu, Xu, Xu, Xu, Xu, Xu, Xu, Xu, Xu, Xu, Xu, Xu, Xu, Xu, Xu, Xu, Xu, Xu, Xu, Xu, Qlf, Qlf, Qlf, Qlf, Cud, Cud, Cud, Qlf, Qlf, Qlf, Qlf, Qlf, Xu, Xu, Xu, Xu, Xu, Xu, Xu, Xu, Xu, Xu, Xu, Xu, Uu, Ql, Ql, Ur, Xu, Xu, Ql, Ql, Ql, Uu, Ql, Ql, Ql^Bs/, Ur, Xu, Ql, Xu, Ql, Ql, Ql, Ql, Ql, Ql, Ql, Ql, Ur, Uu^Vu, Xu, Xu, Uu^Vu, Uu, Uu, Ur, Uu, Uu, Uu^Uf, Xu, Uh, Uh, Xu, Xu, Xu, Xu
Xu, Xu, Xu, Xu, Xu, Xu, Xu, Xu, Xu, Xu, Xu, Xu, Xu, Xu, Xu, Xu, Xu, Xu, Xu, Xu, Xu, Xu, Xu, Xu, Xu, Xu, Qlf, Qlf, Qlf, Qlf, Cud, 4 Kud, Cud, Qlf, Qlf, Qlf, Qlf, Xu, Xu, Xu, Xu, Xu, Xu, Xu, Xu, Xu, Xu, Xu, Xu, Xu, Ql, Ql, Ql, Ur, Ql, Ql, Ql, Ql, Ur, Uu^Vu, Xu, Uu^Vu, Ql, Ql, Ql, Ur, Ur, Ql, Ql, Ql, Uu, Ql, Ql^Bs/, Uu, Uu, Ql, Ur, Xu, Xu, Uu, Ur, Uu, Uu, Uu, Uu^Uf, Xu, Uh, Uh, Uh, Xu, Xu, Xu, Xu
Xu, Xu, Xu, Xu, Xu, Xu, Xu, Xu, Xu, Xu, Xu, Xu, Xu, Xu, Xu, Xu, Xu, Xu, Xu, Xu, Xu, Xu, Xu, Xu, Xu, Xu, Xu, Qlf, Qlf, Qlf, Qlf, Cud, Qlf, Qlf, Qlf, Qlf, Xu, Xu, Xu, Xu, Xu, Xu, Xu, Xu, Xu, Xu, Xu, Xu, Xu, Xu, Xu, Ql, Ql, Ql, Ql, Ql, Ql, Ql, Ql, Ur, Uu, Ur, Ql, Ql, Ql, Ql, Ql, Ql, Ql, Xu, Ur, Ur, Ql, Uu, Uu, Ql^Bs\, Uu, Ur, Uu, Ur, Uu, Uu, Xu, Uu^Uf, Xu, Uh, Xu, Uh, Xu, Xu, Xu, Xu, Xu
Xu, Xu, Xu, Xu, Xu, Xu, Xu, Xu, Xu, Xu, Xu, Xu, Xu, Xu, Xu, Xu, Xu, Xu, Xu, Xu, Xu, Xu, Xu, Xu, Xu, Xu, Xu, Qlf, Qlf, Qlf, Qlf, Qlf, Qlf, Qlf, Qlf, Qlf, Xu, Xu, Xu, Xu, Xu, Xu, Xu, Xu, Xu, Xu, Xu, Xu, Xu, Xu, Xu, Ql, Ql, Ql, Ql, Ql, Ql, Ql, Ql, Ur, Ql, Ql, Ql, Ql, Ql, Ql, Ql, Ql, Uu, Ql, Ql, Ql, Ql, Ql, Xu, Ql, Xu, Uu, Ql, Xu, Xu, Xu, Xu, Xu, Xu, Xu, Xu, Xu, Xu, Xu, Xu, Xu, Xu
Xu, Xu, Xu, Xu, Xu, Xu, Xu, Xu, Xu, Xu, Xu, Xu, Xu, Xu, Xu, Xu, Xu, Xu, Xu, Xu, Xu, Xu, Xu, Xu, Xu, Xu, Xu, Xu, Xu, Qlf, Xu, Qlf, Qlf, Qlf, Qlf, Qlf, Xu, Xu, Xu, Xu, Xu, Xu, Xu, Xu, Xu, Xu, Xu, Xu, Xu, Xu, Xu, Xu, Xu, Ql, Ql, Ql, Ql, Ql, Ql, Ql, Ql, Ql, Ql, Ql, Ql, Ql, Uu, Ur, Ur, Ql, Xu, Ql, Ql, Uu^Vu, Uu, Xu, Xu, Xu, Ql, Ql, Ql, Xu, Xu, Xu, Xu, Xu, Xu, Xu, Xu, Xu, Xu, Xu, Xu
Xu, Xu, Xu, Xu, Xu, Xu, Xu, Xu, Xu, Xu, Xu, Xu, Xu, Xu, Xu, Xu, Xu, Xu, Xu, Xu, Xu, Xu, Xu, Xu, Xu, Xu, Xu, Xu, Xu, Xu, Xu, Xu, Xu, Xu, Xu, Xu, Xu, Xu, Xu, Xu, Xu, Xu, Xu, Xu, Xu, Xu, Xu, Xu, Xu, Xu, Xu, Xu, Xu, Ql, Ql, Ql, Ql, Ql, Xu, Xu, Xu, Xu, Ql, Ql, Ql, Ql, Ql, Ql, Xu, Xu, Xu, Xu, Xu, Ql, Ql, Ql, Ql, Ql, Ql, Ql, Ql, Ql, Ql, Xu, Xu, Xu, Xu, Xu, Xu, Xu, Xu, Xu, Xu
