border_size=1
usage=map

Xos         , Xos         , Xos         , Xos         , Xos         , Xos         , Xos         , Xos         , Xos         , Xos         , Xos         , Xos         , Xos         , Xos         , Xos         , Xos         , Xos         , Xos         , Xos         , Xu          , Xu          , Xu          , Xu          , Xu          , Xu          , Xu          , Xu          , Xu          , Xu          , Xu          , Xu          , Xu          , Xu          , Xu          , Xu          , Xu          , Xu          , Xu          , Xu          , Xu          , Xu          , Xu          , Xu          , Xu          , Xu          , Xu          
Xos         , Xos         , Xos         , Xos         , Xos         , Xos         , Xos         , Xos         , Urb         , Xos         , Xos         , Xos         , Xos         , Xos         , Xos         , Xos         , Xos         , Xos         , Xu          , Xu          , Xu          , Xu          , Xu          , Xu          , Uh          , Uh          , Uh          , Uh          , Uh          , Xu          , Xu          , Xu          , Xu          , Xu          , Xu          , Xu          , Uu^Uf       , Xu          , Uu^Emf      , Xu          , Xu          , Xu          , Xu          , Xu          , Xu          , Xu          
Xos         , Xos         , Xos         , Xos         , Xos         , Xos         , Urb         , Urb         , Urb         , Urb         , Urb         , Xos         , Xos         , Xos         , Xos         , Xos         , Xos         , Xos         , Xu          , Xu          , Xu          , Xu          , Xu          , Uh          , Uh          , Uu          , Uu          , Uu          , Uu          , Uu^Uf       , Uu^Uf       , Xu          , Xu          , Xu          , Uh          , Uh          , Uh          , Uu          , Uh          , Uu^Emf      , Uu^Emf      , Xu          , Xu          , Xu          , Xu          , Xu          
Xos         , Xos         , Xos         , Xos         , Xos         , Xos         , Urb         , Urb         , Urb         , Urb         , Urb         , Urb         , Urb         , Xos         , Xos         , Xos         , Xos         , Xos         , Xos         , Xu          , Xu          , Xu          , Xu          , Uh          , Uh          , Uh          , Uh          , Uu          , Uu          , Uu          , Uu          , Xu          , Uu          , Uu^Emf      , Uu^Emf      , Uu          , Uu          , Uh          , Uh          , Uh          , Uu^Emf      , Uu^Emf      , Uu^Uf       , Xu          , Xu          , Xu          
Xos         , Xos         , Xos         , Xos         , Urb         , Urb         , Urb         , Urb         , Urb         , Urb         , Urb         , Urb         , Urb         , Urb         , Urb         , Xos         , Xos         , Xos         , Xu          , Xu          , Xu          , Xu          , Xu          , Xu          , Xu          , Uh          , Xu          , Uh          , Uh          , Uu          , Uu^Vu       , Uu          , Uu          , Uu^Emf      , Xu          , Uu          , Cud         , Uu          , Uu          , Uh          , Uu          , Uu^Emf      , Uu^Emf      , Xu          , Xu          , Xu          
Xos         , Xos         , Urb         , Urb         , Urb         , Urb         , Urb         , Urb         , Xos         , Urb         , Urb         , Urb         , Urb         , Urb         , Urb         , Urb         , Urb         , Xos         , Xos         , Xu          , Xu          , Xu          , Xu          , Xu          , Xu          , Xu          , Qxu         , Xu          , Xu          , Uh          , Uh          , Uu^Emf      , Uu^Emf      , Uu          , Uu          , Cud         , Cud         , Cud         , Uu          , Xu          , Uu          , Uu          , Uu^Emf      , Uu^Emf      , Uu^Emf      , Xu          
Xos         , Xos         , Xos         , Urb         , Urb         , Urb         , Xos         , Xos         , Urb         , Urb         , Urb         , Urb         , Urb         , Urb         , Urb         , Urb         , Urb         , Urb         , Urb         , Xos         , Xos         , Xu          , Xu          , Xu          , Qxu         , Qxu         , Qxu         , Qxu         , Xu          , Uh          , Uh          , Uh          , Uu^Emf      , Uu^Emf      , Uu          , Cud         , 2 Kud       , Cud         , Uu          , Uh          , Uh          , Uu          , Uu          , Uu^Emf      , Uu^Uf       , Xu          
Xos         , Xos         , Xos         , Xos         , Xos         , Xos         , Xos         , Urb         , Urb         , Urb         , Urb         , Urb         , Urb         , Urb         , Urb         , Urb         , Urb         , Urb         , Urb         , Uu^Vu       , Xos         , Xos         , Xu          , Xu          , Qxu         , Qxu         , Qxu         , Qxu         , Xu          , Uh          , Uh          , Uh          , Uu^Emf      , Uu^Emf      , Uu          , Cud         , Cud         , Cud         , Ur          , Uu          , Uh          , Uh          , Uu          , Uu          , Uu          , Xu          
Xos         , Xos         , Xos         , Xos         , Urb         , Urb         , Urb         , Xos         , Xos         , Urb         , Urb         , Urb         , Urb         , Urb         , Urb         , Urb         , Urb         , Xos         , Xos         , Xos         , Xu          , Xu          , Xu          , Xu          , Qxu         , Qxu         , Qxu         , Qxu         , Xu          , Uh          , Uh          , Uu^Emf      , Uu^Emf      , Uu          , Uu          , Ur          , Uu          , Uu          , Uu          , Ur          , Xu          , Uu          , Uu          , Uh          , Uu          , Xu          
Xos         , Xos         , Urb         , Urb         , Urb         , Urb         , Urb         , Urb         , Urb         , Xos         , Xos         , Urb         , Urb         , Urb         , Xos         , Urb         , Urb         , Urb         , Urb         , Xos         , Xos         , Xu          , Xu          , Xu          , Qxu         , Qxu         , Qxu         , Qxu         , Uh          , Uh          , Uh          , Uu^Emf      , Uu          , Uu          , Ur          , Ur          , Uh          , Uu^Uf       , Uu          , Ur          , Uu          , Uu          , Uu          , Uu          , Xu          , Xu          
Urb         , Urb         , Urb         , Urb         , Urb         , Urb         , Urb         , Urb         , Urb         , Urb         , Urb         , Xos         , Xos         , Urb         , Xos         , Urb         , Urb         , Urb         , Urb         , Urb         , Urb         , Xos         , Xos         , Xu          , Qxu         , Qxu         , Qxu         , Uh          , Uh          , Uu^Emf      , Uu^Emf      , Uh          , Uu          , Xu          , Ur          , Uu^Uf       , Uh          , Uh          , Uu          , Ur          , Uh          , Uh          , Uu          , Uu^Vu       , Xu          , Xu          
Xos         , Urb         , Urb         , Urb         , Urb         , 1 Urb       , Urb         , Urb         , Urb         , Urb         , Urb         , Urb         , Urb         , Xos         , Urb         , Urb         , Urb         , Urb         , Urb         , Urb         , Urb         , Urb         , Urb         , Xos         , Qxu         , Qxu         , Uu          , Uu          , Uu          , Uu^Emf      , Uu          , Uh          , Uu          , Ur          , Uh          , Uh          , Uh          , Uh          , Uu          , Ur          , Uu          , Uu          , Xu          , Xu          , Xos         , Xos         
Xos         , Xos         , Xos         , Urb         , Urb         , Urb         , Urb         , Urb         , Xos         , Xos         , Xos         , Urb         , Urb         , Urb         , Urb         , Urb         , Urb         , Urb         , Urb         , Urb         , Urb         , Urb         , Urb         , Xos         , Qxu         , Uu          , Uu          , Uu          , Xu          , Uu          , Uu          , Uu          , Ur          , Ur          , Uh          , Uh          , Uu          , Uu          , Ur          , Ur          , Uu          , Uu          , Xu          , Xu          , Xos         , Xos         
Xos         , Xos         , Xos         , Xos         , Xos         , Urb         , Xos         , Xos         , Xos         , Xos         , Xos         , Urb         , Urb         , Urb         , Urb         , Urb         , Urb         , Urb         , Xos         , Urb         , Urb         , Urb         , Urb         , Urb         , Qxu^Bs\     , Uu          , Uu          , Uu          , Uu          , Uu          , Ur          , Ur          , Uh          , Uh          , Uu          , Uu          , Ur          , Ur          , Ur          , Uu          , Uu          , Xu          , Xu          , Xos         , Xos         , Xos         
Xos         , Xos         , Xos         , Xos         , Xos         , Xos         , Xos         , Xos         , Xos         , Xos         , Xos         , Urb         , Urb         , Urb         , Urb         , Urb         , Xos         , Xos         , Urb         , Xos         , Xos         , Urb         , Xos         , Qxu^Bs\     , Ur          , Ur          , Ur          , Uu          , Ur          , Ur          , Ur          , Uu          , Urb         , Xu          , Ur          , Ur          , Uu          , Uu          , Ur          , Uu          , Xu          , Xu          , Xos         , Xos         , Urb         , Urb         
Xos         , Xos         , Xos         , Xos         , Xos         , Xos         , Xos         , Xos         , Xos         , Xos         , Urb         , Urb         , Urb         , Xos         , Xos         , Urb         , Urb         , Urb         , Urb         , Urb         , Xos         , Xos         , Qxu         , Qxu         , Uu          , Ur          , Ur          , Ur          , Ur          , Ur          , Uu          , Ur          , Ur          , Ur          , Uu          , Uu          , Uu          , Uu          , Ur          , Uu          , Xu          , Xos         , Urb         , Urb         , Urb         , Urb         
Xos         , Xos         , Xos         , Xos         , Xos         , Xos         , Xos         , Xos         , Urb         , Urb         , Urb         , Urb         , Urb         , Xos         , Xos         , Urb         , Urb         , Urb         , Urb         , Urb         , Xos         , Qxu         , Qxu         , Qxu         , Qxu         , Uu          , Uu          , Ur          , Uu          , Uu          , Uu          , Uu          , Uu          , Uu^Vu       , Uu          , Uu          , Uu          , Ur          , Xu          , Xu          , Xos         , Xos         , Urb         , Urb         , Urb         , Urb         
Xos         , Xos         , Xos         , Xos         , Xos         , Xos         , Urb         , Urb         , Urb         , Urb         , Urb         , Urb         , Urb         , Xos         , Xos         , Xos         , Xos         , Xos         , Urb         , Urb         , Xos         , Qxu         , Qxu         , Qxu         , Qxu         , Uu          , Uu          , Uu          , Uu          , Uu          , Uu          , Uu          , Xu          , Uu          , Xu          , Xu          , Xos         , Ur          , Xos         , Xos         , Urb         , Urb         , Urb         , Urb         , Urb         , Urb         
Xos         , Xos         , Xos         , Xos         , Xos         , Urb         , Urb         , Urb         , Urb         , Xos         , Xos         , Urb         , Urb         , Urb         , Urb         , Xos         , Urb         , Urb         , Urb         , Urb         , Xos         , Qxu         , Qxu         , Qxu         , Qxu         , Uu          , Uu          , Uu          , Xu          , Xu          , Xu          , Xu          , Xos         , Xu          , Xos         , Xos         , Xos         , Urb         , Urb         , Urb         , Urb         , Urb         , Urb         , Urb         , Urb         , Xos         
Xos         , Xos         , Xos         , Xos         , Xos         , Urb         , Urb         , Urb         , Urb         , Urb         , Urb         , Xos         , Xos         , Urb         , Urb         , Urb         , Urb         , Urb         , Urb         , Urb         , Xos         , Qxu         , Qxu         , Qxu         , Qxu         , Uu          , Uu          , Xu          , Xu          , Xos         , Xos         , Xos         , Urb         , Xos         , Urb         , Xos         , Urb         , Urb         , Urb         , Urb         , Urb         , Urb         , Urb         , Urb         , Urb         , Xos         
Xos         , Xos         , Xos         , Xos         , Xos         , Uu^Vu       , Urb         , Urb         , Urb         , Urb         , Urb         , Urb         , Urb         , Xos         , Xos         , Urb         , Xos         , Urb         , Xos         , Xos         , Qxua        , Qxu         , Qxu         , Qxu         , Qxu         , Uu          , Uu          , Xu          , Xos         , Xos         , Urb         , Urb         , Urb         , Urb         , Urb         , Urb         , Urb         , Urb         , Urb         , Urb         , Urb         , Urb         , Urb         , Urb         , Urb         , Xos         
Xos         , Xos         , Xos         , Xos         , Xos         , Xos         , Xos         , Urb         , Xos         , Urb         , Urb         , Xos         , Xos         , Xos         , Xos         , Urb         , Xos         , Xos         , Xu          , Xos         , Qxu         , Qxu         , Qxu         , Qxu         , Qxu         , Uu          , Uu          , Xu          , Xos         , Uu^Vu       , Urb         , Urb         , Xos         , Urb         , Xos         , Urb         , Urb         , Urb         , Urb         , Urb         , Urb         , Urb         , Urb         , Urb         , Urb         , Xos         
Xos         , Xos         , Xu          , Xos         , Xos         , Xos         , Xu          , Xos         , Xos         , Xos         , Urb         , Xos         , Xu          , Xos         , Xu          , Ur          , Xu          , Xu          , Xu          , Qxu         , Qxu         , Qxu         , Qxu         , Qxu         , Qxu         , Uu          , Xu          , Xu          , Xos         , Xos         , Urb         , Urb         , Urb         , Xos         , Xos         , Xos         , Xos         , Urb         , Urb         , Urb         , Urb         , Urb         , Urb         , Urb         , Xos         , Xos         
Xu          , Xu          , Xu          , Xu          , Xu          , Xu          , Xu          , Xu          , Xu          , Xu          , Ur          , Xu          , Xu          , Xu          , Xu          , Ur          , Uu          , Xu          , Uu          , Uu          , Uu          , Uu          , Qxu         , Qxu         , Qxu         , Xu          , Xos         , Xos         , Urb         , Urb         , Urb         , Urb         , Urb         , Urb         , Xos         , Xos         , Xos         , Xos         , Xos         , Urb         , Urb         , Urb         , Urb         , Urb         , Xos         , Xos         
Xuc         , Xuc         , Uu          , Uu          , Uu          , Xu          , Uu          , Xu          , Uu          , Xu          , Ur          , Xu          , Uu          , Uu          , Uu          , Ur          , Ur          , Uu          , Uu          , Uu          , Urb         , Qxu         , Qxu         , Qxu         , Qxu         , Xos         , Xos         , Xos         , Urb         , Urb         , Urb         , Urb         , Urb         , Xos         , Xos         , Xos         , Xos         , Xos         , Urb         , Xos         , Urb         , Urb         , Urb         , Xos         , Xos         , Xos         
Xuc         , Uu          , Uu          , Uu          , Uu          , Uu          , Uu          , Uu          , Uu          , Uu          , Ur          , Uu          , Uu          , Uu          , Uu          , Uu          , Uu          , Ur          , Ur          , Uu          , Urb         , Urb         , Qxu         , Qxu         , Qxu         , Urb         , Urb         , Urb         , Urb         , Urb         , Urb         , Urb         , Urb         , Urb         , Urb         , Urb         , Urb         , Xos         , Urb         , Urb         , Urb         , Xos         , Xos         , Xos         , Xos         , Xos         
Xuc         , Uu          , Uh          , Uu          , Uu          , Uu          , Uu          , Uu          , Uu          , Uu          , Uu          , Ur          , Ur          , Uu          , Uu          , Uu          , Uu          , Uu          , Urb         , Urb         , Qxu^Bs\     , Qxu         , Qxu         , Qxu         , Qxu         , Urb         , Qxu         , Urb         , Urb         , Urb         , Urb         , Urb         , Urb         , Urb         , Urb         , Urb         , Urb         , Urb         , Urb         , Urb         , Xos         , Xos         , Urb         , Xos         , Urb         , Xos         
Xuc         , Uu^Vu       , Xuc         , Uh          , Uh          , Uu          , Uu          , Uu          , Uu          , Uu          , Uu          , Uu          , Ur          , Ur          , Ur          , Uu          , Uu          , Urb         , Urb         , Urb         , Qxu         , Urb         , Urb         , Qxu         , Qxu^Bs/     , Urb         , Qxu         , Xos         , Xos         , Urb         , Xos         , Xos         , Xos         , Xos         , Xos         , Xos         , Xos         , Xos         , Xos         , Xos         , Urb         , Urb         , Urb         , Urb         , Urb         , Xos         
Xuc         , Xuc         , Xuc         , Xuc         , Uh          , Uh          , Uh          , Uu          , Uu          , Uu          , Uu          , Uu          , Uu          , Uu          , Uu          , Ur          , Ur          , Urb         , Urb         , Urb         , Urb         , Qxu         , Qxu^Bs/     , Urb         , Qxu         , Qxu         , Xos         , Xos         , Urb         , Xos         , Xos         , Xos         , Xos         , Xos         , Xos         , Xos         , Urb         , Urb         , Urb         , Urb         , Urb         , Urb         , Urb         , Urb         , Urb         , Xos         
Xuc         , Uu^Uf       , Uu^Uf       , Xuc         , Xuc         , Uh          , Xuc         , Uh          , Uh          , Uu          , Ur          , Uu          , Uu          , Uu          , Uu          , Uu          , Uu          , Urb         , Urb         , Urb         , Qxu         , Urb         , Qxu         , Urb         , Qxu^Bs\     , Qxu         , Qxu         , Urb         , Urb         , Urb         , Urb         , Xos         , Urb         , Xos         , Urb         , Xos         , Urb         , Urb         , Urb         , Urb         , Urb         , Urb         , Urb         , Urb         , Urb         , Urb         
Xuc         , Uu^Uf       , Uu^Uf       , Uu^Uf       , Uu^Uf       , Xuc         , Uh          , Uh          , Xuc         , Xuc         , Uu          , Uu          , Uh          , Uu          , Uu          , Uu          , Uu          , Uu          , Urb         , Urb         , Qxu         , Qxu^Bs|     , Qxu         , Qxu         , Qxu         , Urb         , Urb         , Urb         , Urb         , Urb         , Urb         , Urb         , Urb         , Urb         , Urb         , Urb         , Urb         , Urb         , Xos         , Urb         , Urb         , Urb         , Urb         , Urb         , Urb         , Urb         
Xuc         , Uu^Uf       , Uu^Uf       , Uu^Uf       , Uu^Uf       , Uu^Uf       , Uu^Uf       , Xuc         , Uh          , Uh          , Uh          , Uh          , Xuc         , Uh          , Uh          , Uu          , Uh          , Uu^Vu       , Uh          , Urb         , Urb         , Urb         , Qxu         , Qxu         , Qxu         , Qxu         , Urb         , Urb         , Urb         , Urb         , Urb         , Urb         , Urb         , Urb         , Urb         , Urb         , Urb         , Urb         , Xos         , Xos         , Urb         , Urb         , Urb         , Urb         , Urb         , Urb         
Xuc         , Uu^Uf       , Uu^Uf       , Uu^Uf       , Uu^Uf       , Uu^Uf       , Uu^Uf       , Uu^Uf       , Uu^Uf       , Uh          , Ur          , Uh          , Xuc         , Xuc         , Uh          , Uh          , Xuc         , Uh          , Uh          , Uh          , Xuc         , Qxu         , Qxu         , Qxu         , Xu          , Xos         , Xos         , Urb         , Urb         , Urb         , Urb         , Urb         , Urb         , Urb         , Urb         , Urb         , Urb         , Xos         , Urb         , Xos         , Xos         , Xos         , Xos         , Xos         , Xos         , Xos         
Xuc         , Xuc         , Uu^Uf       , Uu^Uf       , Uu^Uf       , Uu^Uf       , Uu^Uf       , Uu^Uf       , Uu^Uf       , Uh          , Uu          , Uh          , Uh          , Uh          , Xuc         , Xuc         , Uh          , Xuc         , Xuc         , Xuc         , Qxu         , Qxu         , Xu          , Xu          , Xu          , Xos         , Xos         , Xos         , Xos         , Urb         , Xos         , Urb         , Uu^Vu       , Urb         , Urb         , Urb         , Urb         , Urb         , Urb         , Urb         , Urb         , Urb         , Urb         , Urb         , Xos         , Xos         
Xuc         , Xuc         , Xuc         , Uu^Uf       , Uu^Uf       , Uu^Uf       , Uu^Uf       , Uu^Uf       , Urb         , Uh          , Urb         , Uh          , Uh          , Uh          , Uu          , Uh          , Xuc         , Xu          , Xu          , Xu          , Xu          , Xu          , Xu          , Xu          , Xu          , Xos         , Xos         , Xos         , Xos         , Xos         , Xos         , Xos         , Xos         , Xos         , Xos         , Xos         , Xos         , Xos         , Xos         , Xos         , Xos         , Xos         , Xos         , Xos         , Xos         , Xos         
