border_size=1
usage=map

Hh^Fds      , Hh^Fds      , Hh^Fds      , Mm          , Mm          , Mm          , Mm          , Mm          , Mm          , Mm          , Mm          , Mm          , Mm          , Mm          , Mm          , Mm          , Mm          , Mm          , Mm          , Mm          , Mm          , Mm^Xm       , Mm^Xm       , Mm^Xm       , Mm^Xm       , Mm^Xm       , Mm^Xm       , Mm^Xm       , Mm^Xm       , Mm^Xm       , Mm^Xm       , Mm^Xm       , Mm^Xm       , Mm^Xm       , Mm^Xm       , Mm^Xm       , Mm^Xm       , Mm^Xm       , Mm^Xm       , Ms^Xm       , Ms^Xm       , Ms^Xm       , Ms^Xm       , Ms^Xm       , Ms^Xm       , Ms^Xm       , Ms^Xm       , Ms^Xm       , Ms^Xm       , Ms^Xm       , Ms^Xm       , Ms^Xm       
Hh^Fds      , Hh^Fds      , Hh^Fds      , Hh^Fds      , Hh^Fds      , Mm          , Mm          , Mm          , Mm          , Mm          , Mm          , Mm          , Mm          , Mm          , Mm          , Mm          , Mm          , Mm          , Mm          , Mm          , Mm          , Mm          , Mm          , Mm^Xm       , Mm^Xm       , Mm^Xm       , Mm^Xm       , Mm^Xm       , Mm^Xm       , Mm^Xm       , Mm^Xm       , Mm^Xm       , Mm^Xm       , Mm^Xm       , Mm^Xm       , Mm^Xm       , Mm^Xm       , Mm^Xm       , Mm^Xm       , Mm^Xm       , Mm^Xm       , Mm^Xm       , Mm^Xm       , Ms^Xm       , Ms^Xm       , Ms^Xm       , Ms^Xm       , Ms^Xm       , Ms^Xm       , Ms^Xm       , Ms^Xm       , Ms^Xm       
Gs^Fds      , Hh^Fds      , Hh^Fds      , Hh^Fds      , Hh^Fds      , Hh^Fds      , Hh^Fds      , Mm          , Mm          , Mm          , Mm          , Mm          , Mm          , Mm          , Mm          , Mm          , Mm          , Mm          , Mm          , Mm          , Mm          , Mm          , Mm          , Mm          , Mm          , Mm          , Mm          , Mm          , Mm          , Mm^Xm       , Mm          , Mm^Xm       , Mm^Xm       , Mm          , Mm          , Mm^Xm       , Mm          , Mm^Xm       , Mm^Xm       , Mm^Xm       , Mm^Xm       , Mm^Xm       , Mm^Xm       , Mm^Xm       , Mm^Xm       , Ms^Xm       , Ms^Xm       , Ms^Xm       , Ms^Xm       , Ms^Xm       , Ms^Xm       , Ms^Xm       
Gs^Fds      , Gs^Fds      , Hh^Fds      , Hh^Fds      , Hh^Fds      , Hh^Fds      , Hh^Fds      , Hh^Fds      , Hh^Fds      , Mm          , Mm          , Mm          , Mm          , Mm          , Mm          , Mm          , Mm          , Mm          , Mm          , Mm          , Mm          , Mm          , Mm          , Mm          , Mm          , Mm          , Mm          , Mm          , Mm          , Mm          , Mm          , Mm          , Mm          , Md          , Mm          , Mm          , Mm          , Mm          , Mm          , Mm^Xm       , Mm^Xm       , Mm^Xm       , Mm^Xm       , Mm^Xm       , Mm^Xm       , Mm^Xm       , Mm^Xm       , Ms^Xm       , Ms^Xm       , Ms^Xm       , Ms^Xm       , Ms^Xm       
Gs^Fds      , Gs^Fds      , Gg          , Hh^Fds      , Hh^Fds      , Hh^Fds      , Hh^Fds      , Hh^Fds      , Hh^Fds      , Mm          , Mm          , Mm          , Mm          , Mm          , Mm          , Mm          , Hh^Fds      , Mm          , Wwf         , Hh^Fds      , Hh^Fds      , Mm          , Mm          , Mm          , Mm          , Mm          , Mm          , Mm          , Mm          , Mm          , Mm          , Md          , Mm          , Md          , Mm          , Mm          , Mm          , Mm          , Mm          , Mm          , Mm          , Mm^Xm       , Mm^Xm       , Mm^Xm       , Mm^Xm       , Mm^Xm       , Mm^Xm       , Mm^Xm       , Mm^Xm       , Ms^Xm       , Ms^Xm       , Ms^Xm       
Gg          , Gg          , Gg          , Gg          , Hh^Fds      , Hh^Fds      , Hh^Fds      , Hh^Fds      , Hh^Fds      , Mm          , Mm          , Mm          , Md          , Md          , Md          , Md          , Hh^Fds      , Hh^Fds      , Hh^Fds      , Wwf         , Hh^Fds      , Hh^Fds      , Hh^Fds      , Mm          , Mm          , Mm          , Mm          , Mm          , Mm          , Mm          , Mm          , Mm          , Mm          , Mm          , Mm          , Mm          , Mm          , Mm          , Mm          , Mm          , Mm          , Mm          , Mm          , Mm^Xm       , Mm^Xm       , Mm^Xm       , Mm^Xm       , Mm^Xm       , Mm^Xm       , Ms^Xm       , Ms^Xm       , Ms^Xm       
Gg          , Gg          , Gg          , Gg          , Gs^Fds      , Hh^Fds      , Hh^Fds      , Hh^Fds      , Mm          , Mm          , Mm          , Mm          , Md          , Md          , Md          , Md          , Md          , Hh^Fds      , Hh^Fds      , Wwf         , Hh^Fds      , Hh^Fds      , Hh^Fds      , Hh^Fds      , Hh^Fds      , Hh^Fds      , Mm          , Mm          , Mm          , Mm          , Mm          , Mm          , Hh^Fds      , Mm          , Hh^Fds      , Hh^Fds      , Hh^Fds      , Hh^Fds      , Hh^Fds      , Mm          , Mm          , Mm          , Mm          , Mm          , Mm          , Mm^Xm       , Mm^Xm       , Mm^Xm       , Mm^Xm       , Ms^Xm       , Ms^Xm       , Ms^Xm       
Gg          , Gg          , Gs^Vc       , Gs^Fds      , Gs^Fds      , Gs^Fds      , Hh^Fds      , Hh^Fds      , Hh^Fds      , Mm          , Mm          , Hh^Fds      , Md          , Md          , Md          , Md          , Hh^Fds      , Md          , Hh^Fds      , Wwf         , Wwf         , Hh^Fds      , Gg          , Gg          , Gs^Vc       , Hh^Fds      , Hh^Fds      , Hh^Fds      , Hh^Fds      , Mm          , Hh^Fds      , Hh^Fds      , Hh^Fds      , Hh^Fds      , Hh^Fds      , Hh^Fds      , Hh^Fds      , Hh^Fds      , Hh^Fds      , Mm          , Mm          , Mm          , Mm          , Mm          , Mm          , Mm^Xm       , Mm^Xm       , Mm^Xm       , Mm^Xm       , Mm^Xm       , Mm^Xm       , Ms^Xm       
Gg          , Gg          , Gg          , Gs^Fds      , Gs^Fds      , Hh^Fds      , Hh^Fds      , Hh^Fds      , Hh^Fds      , Hh^Fds      , Hh^Fds      , Hh^Fds      , Hh^Fds      , Md          , Hh^Fds      , Hh^Fds      , Hh^Fds      , Hh^Fds      , Hh^Fds      , Hh^Fds      , Hh^Fds      , Wwf         , Wwf         , Gg          , Gg          , Hh^Fds      , Hh^Fds      , Hh^Fds      , Hh^Fds      , Hh^Fds      , Hh^Fds      , Hh^Fds      , Hh^Fds      , Hh^Fds      , Hh^Fds      , Hh^Fds      , Hh^Fds      , Hh^Fds      , Hh^Fds      , Hh^Fds      , Hh^Fds      , Mm          , Mm          , Mm          , Mm          , Mm          , Mm          , Mm^Xm       , Mm^Xm       , Mm^Xm       , Mm^Xm       , Mm^Xm       
Gg          , Gg          , Gg          , Gg          , Gg          , Gs^Fds      , Gg          , Hh^Fds      , Gg          , Hh^Fds      , Gs^Fds      , Hh^Fds      , Hh^Fds      , Hh^Fds      , Hh^Fds      , Hh^Fds      , Hh^Fds      , Hh^Fds      , Hh^Fds      , Hh^Fds      , Hh^Fds      , Hh^Fds      , Hh^Fds      , Wwf         , Gg          , Hh^Fds      , Wwf         , Hh^Fds      , Gg          , Hh^Fds      , Hh^Fds      , Hh^Fds      , Hh^Fds      , Hh^Fds      , Hh^Fds      , Gg          , Gg          , Hh^Fds      , Hh^Fds      , Hh^Fds      , Hh^Fds      , Md          , Md          , Md          , Md          , Mm          , Mm          , Mm          , Mm          , Mm^Xm       , Mm^Xm       , Mm^Xm       
Gg          , Gg          , Gs^Fds      , Gg          , Gg          , Gg          , Gg          , Gg          , Co          , Gs^Fds      , Gs^Fds      , Gs^Fds      , Gs^Fds      , Hh^Fds      , Hh^Fds      , Hh^Fds      , Hh^Fds      , Gs^Vc       , Hh^Fds      , Hh^Fds      , Hh^Fds      , Hh^Fds      , Hh^Fds      , Wwf         , Wwf         , Wwf         , Sm          , Wwf         , Gg          , Gs^Fds      , Gg          , Gs^Fds      , Gs^Fds      , Gs^Fds      , Gs^Fds      , Gg          , Gg          , Gs^Vc       , Hh^Fds      , Hh^Fds      , Hh^Fds      , Hh^Fds      , Hh^Fds      , Md          , Md          , Md          , Md          , Mm          , Mm          , Mm          , Mm          , Mm^Xm       
Rb          , Gg          , Gs^Fds      , Gs^Fds      , Gs^Fds      , Gg          , Gg          , Co          , Co          , Co          , Co          , Gs^Fds      , Gs^Fds      , Hh^Fds      , Hh^Fds      , Mm          , Mm          , Mm          , Mm          , Hh^Fds      , Hh^Fds      , Hh^Fds      , Hh^Fds      , Hh^Fds      , Hh^Fds      , Sm          , Sm          , Wwf         , Gg          , Gg          , Gg          , Gg          , Gs^Fds      , Gg          , Gs^Fds      , Gg          , Gg          , Gg          , Gs^Fds      , Hh^Fds      , Hh^Fds      , Hh^Fds      , Hh^Fds      , Mm          , Mm          , Md          , Mm          , Mm          , Mm          , Mm          , Mm          , Mm          
Gg          , Rb          , Rb          , Gs^Fds      , Gg          , Gg          , Gg          , 2 Ko        , Co          , Co          , Co          , Gs^Fds      , Hh^Fds      , Hh^Fds      , Hh^Fds      , Hh^Fds      , Hh^Fds      , Mm          , Mm          , Mm          , Mm          , Mm          , Hh^Fds      , Hh^Fds      , Hh^Fds      , Gg          , Gs^Fds      , Wwf         , Gg          , Gg          , Gg          , Gs^Vc       , Gg          , Gs^Fds      , Gg          , Gg          , Gg          , Gg          , Gs^Fds      , Gs^Fds      , Gs^Fds      , Hh^Fds      , Hh^Fds      , Hh^Fds      , Hh^Fds      , Mm          , Mm          , Mm          , Mm          , Mm          , Mm          , Mm          
Gg          , Gg          , Gg          , Rb          , Gg          , Gg          , Gs^Fds      , Co          , Co          , Co          , Hh^Fds      , Gs^Fds      , Hh^Fds      , Hh^Fds      , Hh^Fds      , Hh^Fds      , Hh^Fds      , Hh^Fds      , Mm          , Mm          , Mm          , Mm          , Mm          , Hh^Fds      , Hh^Fds      , Hh^Fds      , Gs^Fds      , Wwf         , Gg          , Gg          , Gg          , Gg          , Gg          , Gg          , Gg          , Gg          , Gg          , Gg          , Gg          , Gs^Fds      , Gs^Fds      , Gs^Fds      , Gg          , Hh^Fds      , Hh^Fds      , Hh^Fds      , Hh^Fds      , Hh^Fds      , Mm          , Mm          , Mm          , Mm          
Gg          , Gg          , Gg          , Rb          , Gg          , Gg          , Gs^Fds      , Gg          , Rb          , Gg          , Hh^Fds      , Hh^Fds      , Hh^Fds      , Hh^Fds      , Hh^Fds      , Hh^Fds      , Mm          , Hh^Fds      , Mm          , Mm          , Mm          , Mm          , Mm          , Hh^Fds      , Hh^Fds      , Gs^Fds      , Gs^Fds      , Wwf         , Gg          , Gg          , Rb          , Rb          , Rb          , Gg          , Rb          , Rb          , Rb          , Gg          , Gg          , Gg          , Gg          , Gg          , Gg          , Gs^Fds      , Gs^Fds      , Gs^Fds      , Gs^Fds      , Hh^Fds      , Hh^Fds      , Hh^Fds      , Hh^Fds      , Hh^Fds      
Gg          , Gg          , Gg          , Rb          , Gs^Fds      , Gs^Fds      , Gs^Fds      , Gs^Fds      , Rb          , Gg          , Gg          , Hh^Fds      , Gs^Fds      , Hh^Fds      , Hh^Fds      , Hh^Fds      , Hh^Fds      , Mm          , Mm          , Mm          , Mm          , Mm          , Hh^Fds      , Hh^Fds      , Hh^Fds      , Hh^Fds      , Gg          , Wwf         , Rb          , Rb          , Gs^Fds      , Gs^Fds      , Gs^Fds      , Rb          , Gs^Fds      , Gs^Fds      , Gs^Fds      , Rb          , Rb          , Gg          , Gg          , Gg          , Gg          , Gg          , Gs^Vc       , Gg          , Gs^Fds      , Gs^Fds      , Hh^Fds      , Hh^Fds      , Gs^Fds      , Hh^Fds      
Gg          , Gg          , Gg          , Rb          , Rb          , Gs^Fds      , Gs^Fds      , Gs^Fds      , Rb          , Gg          , Gg          , Gs^Fds      , Gs^Fds      , Hh^Fds      , Hh^Fds      , Hh^Fds      , Hh^Fds      , Mm          , Mm          , Mm          , Mm          , Mm          , Hh^Fds      , Hh^Fds      , Hh^Fds      , Gs^Fds      , Rb          , Wwf^Bw/r    , Gg          , Gs^Vc       , Gs^Fds      , Gg          , Hh^Fds      , Gs^Fds      , Gs^Fds      , Gs^Fds      , Hh^Fds      , Gs^Fds      , Gg          , Rb          , Rb          , Gg          , Rb          , Gg          , Gs^Fds      , Gs^Fds      , Gs^Fds      , Gs^Fds      , Gs^Fds      , Hh^Fds      , Gs^Fds      , Gg          
Gg          , Gg          , Gg          , Gg          , Rb          , Gs^Fds      , Gg          , Gg          , Rb          , Gg          , Gg          , Gg          , Gs^Vc       , Gs^Fds      , Gs^Fds      , Hh^Fds      , Hh^Fds      , Hh^Fds      , Hh^Fds      , Mm          , Mm          , Mm          , Hh^Fds      , Hh^Fds      , Hh^Fds      , Gs^Fds      , Rb          , Wwf         , Gs^Fds      , Gs^Fds      , Hh^Fds      , Hh^Fds      , Hh^Fds      , Hh^Fds      , Hh^Fds      , Hh^Fds      , Hh^Fds      , Gg          , Gs^Fds      , Gs^Fds      , Gs^Fds      , Rb          , Gg          , Rb          , Rb          , Gs^Fds      , Gg          , Gs^Fds      , Gg          , Gg          , Gg          , Gg          
Gg          , Gg          , Gs^Vc       , Gg          , Gg          , Rb          , Rb          , Gg          , Rb          , Gg          , Gg          , Gg          , Gg          , Gg          , Gg          , Gs^Fds      , Gs^Fds      , Hh^Fds      , Hh^Fds      , Hh^Fds      , Hh^Fds      , Hh^Fds      , Hh^Fds      , Hh^Fds      , Hh^Fds      , Gs^Fds      , Rb          , Wwf         , Gs^Fds      , Hh^Fds      , Hh^Fds      , Hh^Fds      , Mm          , Hh^Fds      , Hh^Fds      , Hh^Fds      , Hh^Fds      , Gs^Fds      , Gs^Fds      , Gs^Fds      , Gs^Fds      , Gs^Fds      , Gg          , Gg          , Gg          , Rb          , Rb          , Gg          , Gg          , Gg          , Gg          , Gg          
Gg          , Gg          , Gg          , Gg          , Gg          , Gs^Fds      , Gs^Fds      , Rb          , Rb          , Gg          , Gg          , Gg          , Gg          , Gg          , Gg          , Gs^Fds      , Gs^Fds      , Gs^Fds      , Hh^Fds      , Hh^Fds      , Hh^Fds      , Hh^Fds      , Hh^Fds      , Gs^Fds      , Rb          , Rb          , Wwg         , Wwf         , Gs^Fds      , Gs^Fds      , Hh^Fds      , Mm          , Mm          , Mm          , Mm          , Hh^Fds      , Gs^Fds      , Hh^Fds      , Gs^Fds      , Gs^Fds      , Gg          , Gs^Fds      , Gg          , Gg          , Gg          , Gg          , Gg          , Rb          , 1 Rb        , Gg          , Gg          , Gg          
Gg          , Gg          , Gg          , Gg          , Gg          , Gs^Fds      , Gs^Fds      , Gs^Fds      , Gs^Fds      , Rb          , Rb          , Gg          , Gg          , Gg          , Gg          , Gs^Fds      , Gs^Fds      , Gs^Fds      , Gs^Fds      , Gs^Fds      , Gs^Fds      , Gs^Fds      , Gs^Fds      , Rb          , Wwg         , Wwg         , Gg          , Gg          , Gs^Fds      , Hh^Fds      , Hh^Fds      , Mm          , Mm          , Mm          , Mm          , Hh^Fds      , Gs^Fds      , Gs^Fds      , Gs^Fds      , Gg          , Gg          , Gg          , Gg          , Gg          , Gg          , Gg          , Gg          , Gg          , Gg          , Rb          , Rb          , Gg          
Gg          , Gg          , Gg          , Gg          , Gg          , Gs^Fds      , Gg          , Gs^Fds      , Gg          , Gg          , Gg          , Rb          , Rb          , Gg          , Gg          , Gg          , Ww          , Gg          , Ww          , Ww          , Ww          , Gs^Vc       , Rb          , Rb          , Wwg         , Gg          , Gg          , Gg          , Gs^Fds      , Hh^Fds      , Hh^Fds      , Hh^Fds      , Mm          , Mm          , Mm          , Mm          , Hh^Fds      , Gs^Fds      , Gs^Fds      , Gg          , Gg          , Gg          , Gg          , Gg          , Gg          , Gg          , Gg          , Gg          , Gs^Fds      , Gg          , Gg          , Rb          
Gg          , Gs^Fds      , Gs^Fds      , Gg          , Gg          , Gg          , Gg          , Gg          , Gg          , Gg          , Ww          , Ww          , Ww          , Rb          , Ww^Bw\r     , Ww          , Gg          , Ww          , Rb          , Gg          , Rb          , Ww^Bw/r     , Ww          , Ww          , Ww          , Sm          , Gg          , Gg          , Gs^Fds      , Gs^Fds      , Hh^Fds      , Hh^Fds      , Hh^Fds      , Hh^Fds      , Hh^Fds      , Hh^Fds      , Hh^Fds      , Hh^Fds      , Gg          , Gg          , Gg          , Gg          , Gg          , Gg          , Wwg         , Gg          , Gg          , Gg          , Gs^Fds      , Gs^Fds      , Gs^Fds      , Gg          
Gs^Fds      , Gs^Fds      , Gg          , Gg          , Gg          , Gg          , Gg          , Gg          , Ww          , Ww          , Gg          , Gg          , Gs^Vc       , Ww          , Gg          , Rb          , Rb          , Rb          , Gs^Fds      , Rb          , Gg          , Gg          , Gg          , Gg          , Gg          , Ww          , Ww          , Gs^Fds      , Ww          , Gs^Fds      , Gs^Fds      , Hh^Fds      , Hh^Fds      , Hh^Fds      , Hh^Fds      , Hh^Fds      , Hh^Fds      , Gs^Vc       , Gg          , Gg          , Gg          , Gg          , Wwg         , Wwg         , Gg          , Wwg         , Wwg         , Wwg         , Wwg         , Gs^Fds      , Wwg         , Gg          
Gs^Fds      , Gs^Fds      , Gg          , Gg          , Gg          , Gg          , Ww          , Ww          , Gg          , Gg          , Gs^Fds      , Gs^Fds      , Gs^Fds      , Gg          , Gs^Fds      , Gs^Fds      , Gs^Fds      , Gs^Fds      , Gs^Fds      , Gs^Fds      , Gs^Fds      , Gs^Vc       , Gg          , Gg          , Gg          , Sm          , Sm          , Ww          , Gs^Fds      , Ww          , Ww          , Gs^Fds      , Gg          , Hh^Fds      , Gg          , Gg          , Gg          , Gg          , Gg          , Gg          , Wwg         , Wwg         , Gs^Fds      , Gg          , Gs^Fds      , Gg          , Gs^Fds      , Gg          , Gg          , Wwg         , Gs^Fds      , Wwg         
Gs^Fds      , Gs^Fds      , Gg          , Gg          , Ww          , Ww          , Gg          , Gg          , Gg          , Gs^Fds      , Hh^Fds      , Gs^Fds      , Hh^Fds      , Gs^Fds      , Hh^Fds      , Gs^Fds      , Hh^Fds      , Gs^Fds      , Hh^Fds      , Hh^Fds      , Hh^Fds      , Gs^Fds      , Gs^Fds      , Gg          , Gg          , Gg          , Sm          , Wwg         , Gg          , Gs^Fds      , Gg          , Ww          , Ww          , Gg          , Gg          , Gg          , Gs^Fds      , Gg          , Gg          , Wwg         , Gg          , Gs^Fds      , Gs^Fds      , Gs^Fds      , Gs^Fds      , Gs^Fds      , Gs^Fds      , Gs^Vc       , Gs^Fds      , Gs^Fds      , Gs^Fds      , Gs^Fds      
Gg          , Gs^Vc       , Gg          , Gg          , Ww          , Gg          , Gg          , Gg          , Gs^Fds      , Gs^Fds      , Hh^Fds      , Hh^Fds      , Mm          , Hh^Fds      , Hh^Fds      , Hh^Fds      , Md          , Hh^Fds      , Md          , Hh^Fds      , Hh^Fds      , Hh^Fds      , Hh^Fds      , Gg          , Gg          , Gg          , Wwg         , Wwg         , Gs^Fds      , Gs^Fds      , Gg          , Gg          , Gg          , Ww          , Ww          , Gg          , Gs^Fds      , Gs^Fds      , Wwg         , Wwg         , Gs^Fds      , Gs^Fds      , Hh^Fds      , Gs^Fds      , Gs^Fds      , Gs^Fds      , Hh^Fds      , Hh^Fds      , Hh^Fds      , Gs^Fds      , Hh^Fds      , Hh^Fds      
Gg          , Gg          , Ww          , Ww          , Gg          , Gs^Fds      , Hh^Fds      , Hh^Fds      , Hh^Fds      , Hh^Fds      , Mm          , Mm          , Mm          , Mm          , Mm          , Md          , Md          , Md          , Md          , Md          , Hh^Fds      , Hh^Fds      , Gs^Fds      , Gs^Fds      , Gg          , Wwg         , Gg          , Gg          , Gg          , Gg          , Gg          , Gg          , Gg          , Gg          , Gg          , Ww          , Ww          , Wwg         , Gs^Fds      , Gs^Fds      , Hh^Fds      , Hh^Fds      , Hh^Fds      , Hh^Fds      , Hh^Fds      , Hh^Fds      , Hh^Fds      , Hh^Fds      , Hh^Fds      , Hh^Fds      , Hh^Fds      , Hh^Fds      
Gg          , Gg          , Ww          , Gs^Fds      , Gs^Fds      , Gs^Fds      , Hh^Fds      , Hh^Fds      , Hh^Fds      , Mm          , Mm          , Mm          , Mm          , Mm          , Mm          , Md          , Mm          , Md          , Md          , Md          , Md          , Hh^Fds      , Gg          , Gg          , Wwf         , Wwg         , Gg          , Gg          , Gg          , Gg          , Gg          , Gg          , Gg          , Gs^Vc       , Gs^Fds      , Gg          , Gg          , Gg          , Gs^Fds      , Gs^Fds      , Hh^Fds      , Hh^Fds      , Hh^Fds      , Hh^Fds      , Hh^Fds      , Hh^Fds      , Hh^Fds      , Hh^Fds      , Hh^Fds      , Hh^Fds      , Mm          , Mm          
Ww          , Ww          , Gs^Fds      , Gs^Fds      , Hh^Fds      , Hh^Fds      , Hh^Fds      , Hh^Fds      , Mm          , Mm          , Mm          , Mm          , Md          , Mm          , Mm          , Mm          , Md          , Md          , Md          , Md          , Hh^Fds      , Hh^Fds      , Gg          , Gg          , Wwf         , Gg          , Gg          , Gg          , Gg          , Gg          , Gg          , Gg          , Hh^Fds      , Gs^Fds      , Gs^Fds      , Gs^Fds      , Gs^Fds      , Gs^Fds      , Hh^Fds      , Hh^Fds      , Hh^Fds      , Hh^Fds      , Mm          , Mm          , Mm          , Mm          , Md          , Mm          , Md          , Md          , Mm          , Mm          
Gs^Fds      , Gs^Fds      , Hh^Fds      , Hh^Fds      , Hh^Fds      , Hh^Fds      , Mm          , Mm          , Mm          , Mm          , Mm          , Mm          , Md          , Mm          , Md          , Mm          , Md          , Md          , Md          , Md          , Hh^Fds      , Gs^Fds      , Gg          , Gg          , Wwf         , Gg          , Gg          , Gg          , Gg          , Gg          , Gs^Fds      , Gs^Fds      , Hh^Fds      , Gs^Fds      , Hh^Fds      , Hh^Fds      , Hh^Fds      , Hh^Fds      , Hh^Fds      , Hh^Fds      , Hh^Fds      , Hh^Fds      , Md          , Md          , Md          , Md          , Md          , Md          , Mm          , Md          , Md          , Md          
Gs^Fds      , Gs^Fds      , Hh^Fds      , Hh^Fds      , Mm          , Mm          , Mm          , Mm          , Mm          , Mm          , Mm          , Mm          , Md          , Md          , Hh^Fds      , Md          , Hh^Fds      , Md          , Hh^Fds      , Hh^Fds      , Gg          , Gs^Fds      , Wwf         , Wwf         , Gg          , Gg          , Gg          , Gs^Vc       , Gs^Fds      , Gs^Fds      , Gs^Fds      , Gs^Fds      , Hh^Fds      , Hh^Fds      , Hh^Fds      , Hh^Fds      , Hh^Fds      , Hh^Fds      , Hh^Fds      , Hh^Fds      , Hh^Fds      , Hh^Fds      , Mm          , Md          , Mm          , Md          , Mv          , Md          , Mm          , Mm          , Mm          , Mm          
Gs^Fds      , Hh^Fds      , Hh^Fds      , Hh^Fds      , Mm          , Mm          , Mm          , Mm          , Mm          , Mm          , Mm          , Mm          , Hh^Fds      , Hh^Fds      , Hh^Fds      , Hh^Fds      , Wwf         , Hh^Fds      , Wwf         , Hh^Fds      , Wwf         , Wwf         , Gs^Fds      , Gs^Fds      , Gs^Fds      , Gs^Fds      , Gs^Fds      , Gs^Fds      , Hh^Fds      , Gs^Fds      , Hh^Fds      , Hh^Fds      , Hh^Fds      , Hh^Fds      , Md          , Hh^Fds      , Mm          , Hh^Fds      , Hh^Fds      , Hh^Fds      , Md          , Hh^Fds      , Mm          , Mm          , Md          , Md          , Mm          , Mm          , Mm          , Mm          , Mm^Xm       , Mm^Xm       
Hh^Fds      , Hh^Fds      , Hh^Fds      , Hh^Fds      , Mm          , Mm          , Mm          , Md          , Mm          , Md          , Mm          , Mm          , Hh^Fds      , Gs^Fds      , Gs^Vc       , Wwf         , Sm          , Wwf         , Gs^Fds      , Wwf         , Hh^Fds      , Gs^Fds      , Hh^Fds      , Hh^Fds      , Hh^Fds      , Hh^Fds      , Hh^Fds      , Hh^Fds      , Hh^Fds      , Hh^Fds      , Hh^Fds      , Hh^Fds      , Md          , Md          , Md          , Md          , Md          , Mm          , Mm          , Mm          , Md          , Md          , Mm          , Md          , Mm          , Mm          , Md          , Mm          , Mm^Xm       , Mm^Xm       , Mm^Xm       , Mm^Xm       
Hh^Fds      , Hh^Fds      , Md          , Hh^Fds      , Md          , Mm          , Md          , Md          , Md          , Mm          , Mm          , Mm          , Hh^Fds      , Hh^Fds      , Wwf         , Wwf         , Gs^Fds      , Gs^Fds      , Hh^Fds      , Hh^Fds      , Hh^Fds      , Hh^Fds      , Hh^Fds      , Hh^Fds      , Mm          , Md          , Md          , Hh^Fds      , Md          , Hh^Fds      , Md          , Md          , Mm          , Md          , Mm          , Md          , Mm          , Mm          , Mm          , Mm          , Md          , Md          , Md          , Md          , Md          , Mm          , Mm^Xm       , Md          , Mm^Xm       , Mm^Xm       , Mm^Xm       , Mm^Xm       
Hh^Fds      , Hh^Fds      , Mm          , Md          , Mm          , Mm          , Mm          , Mm          , Md          , Md          , Hh^Fds      , Hh^Fds      , Wwf         , Wwf         , Hh^Fds      , Hh^Fds      , Hh^Fds      , Hh^Fds      , Hh^Fds      , Hh^Fds      , Md          , Hh^Fds      , Mm          , Mm          , Mm          , Md          , Md          , Md          , Mm          , Md          , Md          , Md          , Mm          , Mm          , Mm          , Mm          , Md          , Mm          , Mm          , Mm          , Mm          , Md          , Md          , Md          , Mm^Xm       , Mm^Xm       , Mm^Xm       , Mm^Xm       , Mm^Xm       , Mm^Xm       , Mm^Xm       , Mm^Xm       
Hh^Fds      , Mm          , Mm          , Mm          , Mm          , Mm          , Mm          , Mm          , Mm          , Md          , Md          , Hh^Fds      , Hh^Fds      , Hh^Fds      , Hh^Fds      , Hh^Fds      , Md          , Hh^Fds      , Mm          , Hh^Fds      , Md          , Md          , Md          , Mm          , Md          , Mm          , Mm          , Md          , Md          , Mm          , Md          , Md          , Md          , Md          , Mm          , Mm          , Md          , Mm          , Mm          , Md          , Mm^Xm       , Md          , Mm^Xm       , Mm^Xm       , Mm^Xm       , Mm^Xm       , Mm^Xm       , Mm^Xm       , Mm^Xm       , Mm^Xm       , Mm^Xm       , Mm^Xm       
Mm          , Md          , Mm          , Mm          , Mm          , Mm          , Mm          , Mm          , Md          , Mm          , Md          , Hh^Fds      , Hh^Fds      , Hh^Fds      , Hh^Fds      , Md          , Md          , Mm          , Md          , Md          , Mm          , Mm          , Mm          , Mm          , Mm          , Mm          , Mm          , Mm          , Mm          , Mm          , Mm          , Md          , Md          , Md          , Md          , Mm          , Mm^Xm       , Mm^Xm       , Mm^Xm       , Mm^Xm       , Mm^Xm       , Mm^Xm       , Mm^Xm       , Mm^Xm       , Mm^Xm       , Mm^Xm       , Mm^Xm       , Mm^Xm       , Mm^Xm       , Mm^Xm       , Mm^Xm       , Mm^Xm       
Mm          , Md          , Mm          , Mm          , Md          , Mm          , Mm          , Md          , Md          , Md          , Mm          , Hh^Fds      , Md          , Hh^Fds      , Md          , Md          , Mm          , Mm          , Mm          , Mm          , Mm^Xm       , Mm          , Mm^Xm       , Mm          , Mm^Xm       , Mm^Xm       , Mm^Xm       , Mm          , Mm          , Mm          , Mm          , Mm          , Mm^Xm       , Mm^Xm       , Mm^Xm       , Mm^Xm       , Mm^Xm       , Mm^Xm       , Mm^Xm       , Mm^Xm       , Mm^Xm       , Mm^Xm       , Mm^Xm       , Mm^Xm       , Mm^Xm       , Mm^Xm       , Mm^Xm       , Mm^Xm       , Mm^Xm       , Mm^Xm       , Mm^Xm       , Mm^Xm       
Mm          , Mm          , Mm          , Md          , Md          , Md          , Mm          , Mm          , Mm          , Md          , Mm          , Md          , Md          , Md          , Md          , Md          , Mm          , Md          , Mm^Xm       , Mm          , Mm^Xm       , Mm^Xm       , Mm^Xm       , Mm^Xm       , Mm^Xm       , Mm^Xm       , Mm^Xm       , Mm^Xm       , Mm^Xm       , Mm^Xm       , Mm^Xm       , Mm^Xm       , Mm^Xm       , Mm^Xm       , Mm^Xm       , Mm^Xm       , Mm^Xm       , Mm^Xm       , Mm^Xm       , Mm^Xm       , Mm^Xm       , Mm^Xm       , Mm^Xm       , Mm^Xm       , Mm^Xm       , Mm^Xm       , Mm^Xm       , Mm^Xm       , Mm^Xm       , Mm^Xm       , Mm^Xm       , Mm^Xm       
Md          , Md          , Md          , Md          , Mm          , Md          , Md          , Md          , Md          , Md          , Md          , Md          , Mm          , Md          , Mm^Xm       , Mm^Xm       , Mm^Xm       , Mm^Xm       , Mm^Xm       , Mm^Xm       , Mm^Xm       , Mm^Xm       , Mm^Xm       , Mm^Xm       , Mm^Xm       , Mm^Xm       , Mm^Xm       , Mm^Xm       , Mm^Xm       , Mm^Xm       , Mm^Xm       , Mm^Xm       , Mm^Xm       , Mm^Xm       , Mm^Xm       , Mm^Xm       , Mm^Xm       , Mm^Xm       , Mm^Xm       , Mm^Xm       , Mm^Xm       , Mm^Xm       , Mm^Xm       , Mm^Xm       , Mm^Xm       , Mm^Xm       , Mm^Xm       , Mm^Xm       , Mm^Xm       , Mm^Xm       , Mm^Xm       , Mm^Xm       
