border_size=1
usage=map

Gd^Gvs      , Gd^Gvs      , Gd^Gvs      , Gd^Gvs      , Gd^Gvs      , Gd^Gvs      , Gd^Gvs      , Gd^Gvs      , Gd^Gvs      , Gd^Gvs      , Gd^Gvs      , Gd^Gvs      , Dd          , Gd^Gvs      , Gd^Gvs      , Gd^Gvs      , Gd^Gvs      , Sm          , Ss          , Gd^Gvs      , Gd^Gvs      , Gd^Gvs      , Gd^Gvs      , Gd^Gvs      , Gd^Gvs      , Gd^Gvs      , Gd^Gvs      , Gd^Gvs      , Gd^Gvs      , Gd^Gvs      , Gd^Gvs      , Gd^Gvs      , Gd^Gvs      , Gd^Gvs      , Dd          
Gd^Gvs      , Gd^Gvs      , Gd^Gvs      , Gd^Gvs      , Dd          , Gd^Gvs      , Dd          , Gd^Gvs      , Gd^Gvs      , Gd^Gvs      , Gd^Gvs      , Dd          , Dd          , Dd          , Gd^Gvs      , Gd^Gvs      , Gd^Gvs      , Sm          , Ss          , Gd^Gvs      , Gd^Gvs      , Gd^Gvs      , Gd^Gvs      , Gd^Gvs      , Ch          , Gd^Gvs      , Gd^Gvs      , Gd^Gvs      , Gd^Gvs      , Gd^Gvs      , Gd^Gvs      , Gd^Gvs      , Dd          , Dd          , Dd          
Gd^Gvs      , Gd^Gvs      , Gd^Gvs      , Gd^Gvs      , Gd^Gvs      , Dd          , Dd          , Dd          , Gd^Gvs      , Gd^Gvs      , Gd^Gvs      , Gd^Gvs      , Gd^Gvs      , Gd^Gvs      , Gd^Gvs      , Gd^Gvs      , Ch          , Ww^Ewf      , Ch          , Ch          , Ch          , Gd^Gvs      , Ch          , Ch          , Rrc         , Ch          , Rrc         , Gd^Gvs      , Gd^Gvs      , Gd^Gvs      , Gd^Gvs      , Gd^Gvs      , Dd          , Dd          , Dd          
Gd^Gvs      , Gd^Gvs      , Gd^Gvs      , Dd          , Dd          , Dd          , Gd^Gvs      , Gd^Gvs      , Dd          , Gd^Gvs      , Gd^Gvs      , Gd^Gvs      , Gd^Gvs      , Gd^Gvs      , Ch          , Ch          , Kh          , Ww^Ewl      , Ss          , Rrc         , Rr^Vhc      , Rrc         , Rrc         , Rrc         , Rr^Vhc      , Rrc         , Rrc         , Ch          , Ch          , Gd^Gvs      , Gd^Gvs      , Gd^Gvs      , Gd^Gvs      , Gd^Gvs      , Gd^Gvs      
Gd^Gvs      , Gd^Gvs      , Gd^Gvs      , Gd^Wm       , Gd^Gvs      , Gd^Gvs      , Gd^Gvs      , Gd^Gvs      , Dd          , Dd          , Gd^Gvs      , Gd^Gvs      , Ch          , Rrc         , Rrc         , Rrc         , Rrc         , Rrc         , Wwg^Bsb/    , Rrc         , Rrc         , Rrc         , Ch          , Rrc         , Ch          , Rrc         , Rrc         , Rrc         , Ch          , Gd^Gvs      , Gd^Gvs      , Gd^Gvs      , Gd^Gvs      , Gd^Gvs      , Gd^Gvs      
Gd^Gvs      , Gd^Gvs      , Gd^Gvs      , Gd^Gvs      , Gd^Gvs      , Gd^Gvs      , Gd^Gvs      , Dd          , Gd^Gvs      , Gd^Gvs      , Gd^Gvs      , Ch          , Rrc         , Rrc         , Rrc         , Rr^Vhc      , Rrc         , Rrc         , Rrc         , Ss          , Ss          , Ch          , 2 Kh        , Ch          , Ch          , Ch          , Rrc         , Rr^Vhc      , Rrc         , Gd^Gvs      , Gd^Gvs      , Gd^Gvs      , Gd^Gvs      , Gd^Gvs      , Gd^Gvs      
Dd          , Gd^Gvs      , Dd          , Gd^Gvs      , Gd^Gvs      , Gd^Gvs      , Gd^Gvs      , Dd          , Gd^Gvs      , Gd^Gvs      , Gd^Gvs      , Ch          , Rrc         , Rrc         , Rrc         , Rrc         , Rrc         , Rrc         , Rrc         , Sm          , Ww^Ewf      , Ch          , Ch          , Ch          , Rrc         , Rrc         , Rrc         , Rrc         , Rrc         , Ch          , Ch          , Gd^Gvs      , Gd^Gvs      , Gd^Gvs      , Gd^Gvs      
Dd          , Dd          , Dd          , Dd          , Gd^Gvs      , Gd^Gvs      , Gd^Gvs      , Gd^Gvs      , Gd^Gvs      , Gd^Gvs      , Rrc         , Rrc         , Rrc         , Rrc         , Rrc         , Rr^Vhc      , Rrc         , Rrc         , Rrc         , Rrc         , Sm          , Ss          , Ch          , Rrc         , Rrc         , Rrc         , Rr^Vhc      , Rrc         , Rrc         , Rrc         , Ch          , Gd^Gvs      , Gd^Gvs      , Gd^Gvs      , Gd^Gvs      
Gd^Gvs      , Dd          , Dd          , Gd^Gvs      , Gd^Gvs      , Gd^Gvs      , Gd^Gvs      , Gd^Gvs      , Ch          , Ch          , Rrc         , Rrc         , Rr^Vhc      , Rrc         , Ch          , Ch          , Rrc         , Rr^Vhc      , Rrc         , Rrc         , Ss^Bsb\     , Ss          , Rrc         , Rrc         , Rrc         , Rrc         , Ch          , Rrc         , Rrc         , Rrc         , Rrc         , Gd^Gvs      , Gd^Gvs      , Gd^Gvs      , Dd          
Gd^Gvs      , Gd^Gvs      , Gd^Gvs      , Gd^Gvs      , Gd^Gvs      , Gd^Gvs      , Gd^Gvs      , Gd^Gvs      , Ch          , Rrc         , Rrc         , Rrc         , Rrc         , Rrc         , Rrc         , Rrc         , Rrc         , Rrc         , Rrc         , Rrc         , Sm          , Ss^Bsb\     , Rrc         , Rrc         , Rrc         , Kh          , Ch          , Rrc         , Rrc         , Rrc         , Ch          , Gd^Gvs      , Gd^Gvs      , Dd          , Dd          
Gd^Gvs      , Gd^Gvs      , Gd^Gvs      , Gd^Gvs      , Gd^Gvs      , Gd^Gvs      , Ch          , Rrc         , Rrc         , Rrc         , Rr^Vhc      , Rrc         , Rrc         , Rrc         , Rrc         , Rrc         , Rrc         , Rr^Vhc      , Rrc         , Rrc         , Ss          , Ss          , Rrc         , Rr^Vhc      , Rrc         , Rrc         , Rrc         , Rrc         , Rr^Vhc      , Rrc         , Ch          , Gd^Gvs      , Gd^Gvs      , Gd^Gvs      , Dd          
Gd^Gvs      , Gd^Gvs      , Gd^Gvs      , Gd^Gvs      , Gd^Gvs      , Ch          , Kh          , Rrc         , Rrc         , Rrc         , Rrc         , Rrc         , Rrc         , Rr^Vhc      , Rrc         , Rrc         , Kh          , Rrc         , Rrc         , Rrc         , Ss          , Ww^Ewl      , Rrc         , Rrc         , Rrc         , Rrc         , Rr^Vhc      , Rrc         , Rrc         , Rrc         , Ch          , Gd^Gvs      , Gd^Gvs      , Dd          , Dd          
Gd^Gvs      , Gd^Gvs      , Dd          , Gd^Gvs      , Gd^Gvs      , Ch          , Ch          , Rrc         , Rrc         , Rrc         , Rrc         , Rrc         , Rrc         , Rrc         , Rrc         , Rrc         , Ch          , Ch          , Rrc         , Rrc         , Sm          , Ss          , Rrc         , Rrc         , Ch          , Rrc         , Rrc         , Rrc         , Rrc         , Rrc         , Rrc         , Gd^Gvs      , Gd^Gvs      , Dd          , Dd          
Gd^Gvs      , Dd          , Dd          , Gd^Gvs      , Gd^Gvs      , Gd^Gvs      , Rrc         , Rrc         , Rr^Vhc      , Rrc         , Ch          , Rrc         , Rr^Vhc      , Rrc         , Rrc         , Rrc         , Rrc         , Rrc         , Rrc         , Rrc         , Rrc         , Ss          , Rrc         , Rrc         , Rrc         , Ch          , Rrc         , Rrc         , Rr^Vhc      , Rrc         , Ch          , Gd^Gvs      , Gd^Gvs      , Gd^Gvs      , Gd^Gvs      
Gd^Gvs      , Dd          , Dd          , Gd^Gvs      , Gd^Gvs      , Gd^Gvs      , Ch          , Rrc         , Rrc         , Rrc         , Ch          , Rrc         , Rrc         , Rrc         , Rrc         , Rrc         , Rrc         , Rr^Vhc      , Rrc         , Rrc         , Wwg^Bsb\    , Ww^Ewf      , Rrc         , Rrc         , Rrc         , Rrc         , Rrc         , Rrc         , Rrc         , Rrc         , Ch          , Gd^Gvs      , Gd^Gvs      , Gd^Gvs      , Gd^Gvs      
Gd^Gvs      , Dd          , Dd          , Gd^Gvs      , Gd^Gvs      , Gd^Gvs      , Ch          , Rrc         , Rrc         , Rrc         , Rrc         , Rrc         , Rrc         , Rrc         , Rr^Vhc      , Rrc         , Rrc         , Rrc         , Rrc         , Rrc         , Ww^Ewl      , Rrc         , Rrc         , Rrc         , Rrc         , Rr^Vhc      , Rrc         , Rrc         , Rrc         , Rrc         , Kh          , Ch          , Gd^Gvs      , Gd^Gvs      , Gd^Gvs      
Gd^Gvs      , Dd          , Gd^Gvs      , Gd^Gvs      , Gd^Gvs      , Gd^Gvs      , Rrc         , Rrc         , Rrc         , Rrc         , Rrc         , Rrc         , Rr^Vhc      , Rrc         , Rrc         , Rrc         , Rrc         , Rrc         , Rrc         , Rrc         , Sm          , Ss          , Rrc         , Rrc         , Rr^Vhc      , Rrc         , Rrc         , Rrc         , Ch          , Rrc         , Rrc         , Rrc         , Ch          , Gd^Gvs      , Gd^Gvs      
Gd^Gvs      , Gd^Gvs      , Gd^Gvs      , Gd^Gvs      , Gd^Gvs      , Gd^Gvs      , Ch          , Rrc         , Kh          , Rrc         , Rrc         , Rrc         , Rrc         , Rrc         , Rrc         , Rrc         , Ch          , Rrc         , Rrc         , Rr^Vhc      , Rrc         , Ss          , Ss          , Rrc         , Rrc         , Rrc         , Rrc         , Rrc         , Ch          , Rrc         , Rr^Vhc      , Rrc         , Ch          , Gd^Gvs      , Gd^Gvs      
Gd^Gvs      , Gd^Gvs      , Gd^Gvs      , Gd^Gvs      , Gd^Gvs      , Gd^Gvs      , Gd^Gvs      , Ch          , Rrc         , Rrc         , Rrc         , Rrc         , Rr^Vhc      , Rrc         , Rrc         , Rrc         , Ch          , Ch          , Ch          , Rrc         , Rrc         , Sm          , Ss^Bsb/     , Rrc         , Rrc         , Rrc         , Rrc         , Rrc         , Rrc         , Rrc         , Rrc         , Rrc         , Ch          , Gd^Gvs      , Gd^Gvs      
Gd^Gvs      , Gd^Gvs      , Dd          , Gd^Gvs      , Gd^Gvs      , Gd^Gvs      , Gd^Gvs      , Rrc         , Rrc         , Rr^Vhc      , Rrc         , Rrc         , Rrc         , Rrc         , Rrc         , Rrc         , Ch          , 1 Kh        , Ch          , Ch          , Rrc         , Ss^Bsb/     , Sm          , Rrc         , Rrc         , Rr^Vhc      , Rrc         , Rrc         , Rrc         , Rrc         , Rrc         , Rrc         , Rrc         , Gd^Gvs      , Gd^Gvs      
Gd^Gvs      , Dd          , Dd          , Dd          , Gd^Gvs      , Gd^Gvs      , Gd^Gvs      , Ch          , Ch          , Rrc         , Ch          , Rrc         , Rrc         , Rrc         , Rrc         , Rrc         , Rrc         , Ch          , Ch          , Ch          , Rrc         , Ww^Ewf      , Ss          , Rrc         , Rr^Vhc      , Rrc         , Rrc         , Rrc         , Rrc         , Rr^Vhc      , Rrc         , Rrc         , Ch          , Gd^Gvs      , Gd^Gvs      
Gd^Gvs      , Dd          , Dd          , Gd^Gvs      , Gd^Gvs      , Gd^Gvs      , Gd^Gvs      , Gd^Gvs      , Gd^Gvs      , Gd^Gvs      , Gd^Gvs      , Ch          , Gd^Gvs      , Ch          , Ch          , Rrc         , Rr^Vhc      , Rrc         , Rrc         , Rrc         , Rrc         , Ss          , Ww^Ewf      , Rrc         , Rrc         , Rrc         , Rr^Vhc      , Rrc         , Rrc         , Rrc         , Rrc         , Ch          , Gd^Gvs      , Gd^Gvs      , Gd^Gvs      
Gd^Gvs      , Gd^Gvs      , Gd^Gvs      , Gd^Gvs      , Gd^Gvs      , Gd^Gvs      , Gd^Gvs      , Gd^Gvs      , Gd^Gvs      , Gd^Gvs      , Gd^Gvs      , Gd^Gvs      , Gd^Gvs      , Gd^Gvs      , Gd^Gvs      , Rrc         , Ch          , Rrc         , Rrc         , Rrc         , Rrc         , Sm          , Ss          , Rrc         , Rrc         , Rrc         , Rrc         , Rrc         , Ch          , Ch          , Gd^Gvs      , Gd^Gvs      , Dd          , Dd          , Dd          
Gd^Gvs      , Gd^Gvs      , Gd^Gvs      , Gd^Gvs      , Gd^Gvs      , Gd^Gvs      , Dd          , Dd          , Dd          , Gd^Gvs      , Gd^Gvs      , Gd^Gvs      , Gd^Gvs      , Gd^Gvs      , Gd^Gvs      , Gd^Gvs      , Gd^Gvs      , Ch          , Rrc         , Rrc         , Rrc         , Ss          , Ss          , Sm          , Rrc         , Rrc         , Rrc         , Rrc         , Gd^Gvs      , Gd^Gvs      , Gd^Gvs      , Gd^Gvs      , Dd          , Dd          , Gd^Gvs      
Gd^Gvs      , Gd^Gvs      , Gd^Gvs      , Gd^Gvs      , Gd^Gvs      , Dd          , Gd^Gvs      , Dd          , Dd          , Dd          , Gd^Gvs      , Gd^Gvs      , Gd^Gvs      , Gd^Gvs      , Gd^Gvs      , Gd^Gvs      , Gd^Gvs      , Gd^Gvs      , Gd^Gvs      , Ch          , Ch          , Ss          , Ss          , Sm          , Ch          , Rrc         , Ch          , Ch          , Gd^Gvs      , Gd^Gvs      , Gd^Gvs      , Dd          , Dd          , Dd          , Gd^Gvs      
Gd^Gvs      , Gd^Gvs      , Gd^Gvs      , Gd^Gvs      , Gd^Gvs      , Gd^Gvs      , Gd^Gvs      , Gd^Gvs      , Gd^Gvs      , Gd^Gvs      , Gd^Gvs      , Gd^Gvs      , Gd^Gvs      , Gd^Gvs      , Gd^Gvs      , Gd^Gvs      , Gd^Gvs      , Gd^Gvs      , Gd^Gvs      , Gd^Gvs      , Gd^Gvs      , Ss          , Ss          , Ch          , Gd^Gvs      , Gd^Gvs      , Gd^Gvs      , Gd^Gvs      , Gd^Gvs      , Gd^Gvs      , Gd^Gvs      , Gd^Gvs      , Gd^Gvs      , Gd^Gvs      , Gd^Gvs      
