border_size=1
usage=map

Xu          , Xu          , Xu          , Xu          , Xu          , Xu          , Xu          , Xu          , Xu          , Xu          , Xu          , Xu          , Xu          , Xu          , Xu          , Xu          , Xu          , Xu          , Xu          , Xu          , Xu          , Xu          , Xu          , Xu          , Xu          , Xu          , Xu          , Xu          , Xu          , Xu          , Xu          , Xu          , Xu          , Xu          , Xu          , Xu          , Xu          , Xu          , Xu          , Xu          , Xu          , Xu          , Xu          , Xu          , Xu          , Xu          
Xu          , Xu          , Xu          , Xu          , Xu          , Xu          , Xu          , Xu          , Xu          , Xu          , Xu          , Xu          , Xu          , Xu          , Xu          , Xu          , Xu          , Xu          , Xu          , Xu          , Xu          , Xu          , Xu          , Xu          , Xu          , Xu          , Xu          , Xu          , Xu          , Xu          , Xu          , Xu          , Xu          , Xu          , Xu          , Xu          , Xu          , Xu          , Xu          , Xu          , Xu          , Xu          , Xu          , Xu          , Xu          , Xu          
Xu          , Xu          , Xu          , Xu          , Xu          , Xu          , Xu          , Xu          , Xu          , Xu          , Xu          , Xu          , Xu          , Xu          , Xu          , Xu          , Xu          , Xu          , Xu          , Xu          , Xu          , Xu          , Xu          , Xu          , Xu          , Xu          , Xu          , Xu          , Uu          , Uu          , Uu          , Xu          , Xu          , Xu          , Ur^Emf      , Xu          , Ur          , Xu          , Xu          , Xu          , Xu          , Xu          , Xu          , Xu          , Xu          , Xu          
Xu          , Xu          , Xu          , Xu          , Xu          , Xu          , Xu          , Xu          , Xu          , Xu          , Xu          , Xu          , Xu          , Xu          , Xu          , Xu          , Xu          , Xu          , Ur          , Xu          , Xu          , Xu          , Uu          , Uu          , Uu          , Xu          , Uu^Es       , Uu^Es       , Xu          , Xu          , Xu          , Uu          , Uu^Es       , Uu          , Uu          , Ur          , Ur          , Ur          , Xu          , Xu          , Xu          , Xu          , Xu          , Xu          , Xu          , Xu          
Xu          , Xu          , Xu          , Xu          , Xu          , Xu          , Xu          , Xu          , Xu          , Xu          , Xu          , Xu          , Xu          , Xu          , Xu          , Xu          , Xu          , Xu          , Ur          , Ur^Es       , Uu          , Uu          , Xu          , Xu          , Xu          , Uu^Es       , Xu          , Xu          , Xu          , Xu          , Xu          , Xu          , Xu          , Uu^Es       , Uu          , Uu^Es       , Xu          , Xu          , Xu          , Xu          , Xu          , Xu          , Xu          , Xu          , Xu          , Xu          
Xu          , Xu          , Xu          , Xu          , Xu          , Xu          , Xu          , Xu          , Xu          , Xu          , Xu          , Xu          , Xu          , Xu          , Xu          , Xu          , Xu          , Xu          , Uu          , Uu          , Uu^Emf      , Uu^Emf      , Uu^Emf      , Xu          , Xu          , Xu          , Xu          , Xu          , Xu          , Xu          , Xu          , Xu          , Xu          , Uu          , Xu          , Xu          , Xu          , Xu          , Xu          , Xu          , Xu          , Xu          , Xu          , Xu          , Xu          , Xu          
Xu          , Xu          , Xu          , Xu          , Xu          , Xu          , Xu          , Xu          , Xu          , Xu          , Xu          , Ur          , Ur          , Xu          , Uu          , Xu          , Xu          , Xu          , Xu          , Uu^Emf      , Uu^Uf       , Uu^Uf       , Uu^Uf       , Xu          , Uu^Uf       , Xu          , Uh^Es       , Xu          , Xu          , Xu          , Uh          , Uh          , Uh          , Uh          , Uh          , Xu          , Uh          , Xu          , Xu          , Xu          , Xu          , Xu          , Xu          , Xu          , Xu          , Xu          
Xu          , Xu          , Xu          , Xu          , Xu          , Xu          , Xu          , Xu          , Xu          , Xu          , Ur          , Ur          , Uu          , Uu          , Uu          , Xu          , Xu          , Xu          , Xu          , Xu          , Uu^Uf       , Uu^Uf       , Uu^Uf       , Uu^Uf       , Xu          , Ur^Emf      , Uu          , Ur^Es       , Ur          , Uu          , Xu          , Uh          , Uu          , Uh          , Uu          , Uu          , Uu^Vu       , Uh          , Uh^Emf      , Xu          , Xu          , Xu          , Xu          , Xu          , Xu          , Xu          
Xu          , Xu          , Xu          , Xu          , Xu          , Xu          , Xu          , Xu          , Xu          , Xu          , Xu          , Ur          , Uu          , Uu          , Uu          , Uu          , Xu          , Xu          , Xu          , Uu^Uf       , Uu^Uf       , Xu          , Uu^Emf      , Xu          , Xu          , Xu          , Ur          , Ur          , Xu          , Xu          , Xu          , Xu          , Uu^Emf      , Uu          , Xu          , Uu^Es       , Ur          , Uu^Emf      , Uu^Uf       , Uh^Emf      , Uu^Uf       , Xu          , Xu          , Xu          , Xu          , Xu          
Xu          , Xu          , Xu          , Xu          , Xu          , Xu          , Xu          , Xu          , Xu          , Xu          , Xu          , Xu          , Uu          , Uu          , Uu          , Uu^Emf      , Uu^Uf       , Xu          , Xu          , Uu^Uf       , Xu          , Uu^Uf       , Ur^Emf      , Uu^Vu       , Ur^Emf      , Ur          , Ur^Es       , Xu          , Xu          , Xu          , Xu          , Xu          , Xu          , Xu          , Xu          , Ur^Es       , Ur^Es       , Ur^Emf      , Xu          , Uu^Uf       , Uu^Emf      , Xu          , Xu          , Xu          , Xu          , Xu          
Xu          , Xu          , Xu          , Xu          , Xu          , Xu          , Xu          , Xu          , Xu          , Xu          , Xu          , Xu          , Xu          , Uu          , Xu          , Uh^Emf      , Uu^Uf       , Xu          , Uu          , Ur^Emf      , Ur^Emf      , Ur^Emf      , Uu^Uf       , Ur^Emf      , Uu^Uf       , Ur^Emf      , Uu          , Xu          , Ur^Emf      , Xu          , Uu^Uf       , Xu          , Xu          , Xu          , Uh          , Uh^Es       , Ur          , Ur          , Xu          , Uu^Emf      , Uh          , Uu          , Xu          , Xu          , Xu          , Xu          
Uu          , Xu          , Xu          , Xu          , Xu          , Xu          , Xu          , Xu          , Xu          , Xu          , Xu          , Xu          , Xu          , Xu          , Xu          , Uu^Uf       , Uu^Uf       , Uh^Emf      , Uh          , Ur^Es       , Ur^Emf      , Uu^Uf       , Xu          , Uu^Uf       , Xu          , Xu          , Ur          , Ur          , Ur^Emf      , Uu^Uf       , Uu^Uf       , Uh^Emf      , Xu          , Xu          , Xu          , Uh          , Ur^Emf      , Ur          , Uu          , Uh          , Xu          , Xu          , Xu          , Xu          , Xu          , Xu          
Ur          , Ur          , Ur          , Uu          , Uu          , Uu          , Xu          , Xu          , Ql          , Xu          , Xu          , Xu          , Uh          , Xu          , Uu^Vu       , Xu          , Xu          , Uh^Emf      , Ur^Es       , Ur          , Xu          , Xu          , Xu          , Xu          , Xu          , Uh          , Uh^Es       , Uh          , Ur          , Ur^Emf      , Ur^Emf      , Ur^Emf      , Uu^Vu       , Xu          , Xu          , Xu          , Xu          , Uu          , Ur          , Xu          , Xu          , Xu          , Xu          , Xu          , Xu          , Xu          
Uu          , Ur          , Ur          , Uu^Emf      , Xu          , Uu^Emf      , Uu^Vu       , Xu          , Uu          , Xu          , Uh          , Uh          , Ur^Es       , Uh          , Ur          , Xu          , Ur^Es       , Ur          , Ur^Es       , Xu          , Uh          , Xu          , Xu          , Xu          , Xu          , Uh          , Xu          , Uh          , Uh          , Uh          , Ur          , Ur          , Uu          , Xu          , Ur          , Xu          , Ur          , Ur          , Uu^Emf      , Xu          , Xu          , Xu          , Xu          , Xu          , Xu          , Xu          
Xu          , Uu          , Ur          , Ur          , Ur          , Ur          , Ur          , Uu          , Xu          , Xu          , Ur^Es       , Ur^Es       , Ur^Es       , Ur^Es       , Xu          , Ur^Es       , Xu          , Uu          , Xu          , Uh          , Uh          , Uh          , Uh          , Xu          , Xu          , Xu          , Uu          , Xu          , Xu          , Xu          , Uh          , Uu          , Uh^Es       , Uu^Es       , Uh^Es       , Ur^Es       , Ur          , Uu^Emf      , Uu^Uf       , Uu^Uf       , Xu          , Xu          , Xu          , Xu          , Xu          , Xu          
Ur          , Ur          , Xu          , Ur^Emf      , Uu^Uf       , Uu^Uf       , Xu          , Ur          , Ur^Es       , Ur^Es       , Ur^Es       , Uh          , Xu          , Xu          , Xu          , Xu          , Xu          , Xu          , Xu          , Uh          , Xu          , Uh          , Uu          , Xu          , Xu          , Ur          , Xu          , Uu          , Uu          , Xu          , Xu          , Xu          , Xu          , Uh^Es       , Uh          , Ur^Es       , Ur          , Ur^Emf      , Uu^Uf       , Uu^Uf       , Uu^Uf       , Ur^Emf      , Ur          , Xu          , Xu          , Xu          
Xu          , Xu          , Xu          , Uh          , Xu          , Uu^Uf       , Uu^Uf       , Ur          , Ur          , Ur^Es       , Xu          , Xu          , Xu          , Xu          , Xu          , Xu          , Xu          , Xu          , Uh          , Uh          , Uh          , Xu          , Uh          , Uu          , Ur^Es       , Xu          , Uh          , Xu          , Xu          , Uu          , Uu          , Xu          , Uu          , Xu          , Xu          , Ur          , Ur          , Ur^Emf      , Ur^Emf      , Uu^Uf       , Uu^Uf       , Uh^Emf      , Ur^Es       , Xu          , Xu          , Xu          
Xu          , Xu          , Xu          , Xu          , Xu          , Uh^Emf      , Ur          , Ur          , Uh          , Xu          , Ql          , Xu          , Xu          , Xu          , Xu          , Uu          , Uu          , Xu          , Uu          , Uh          , Uh          , Xu          , Uh          , Uh          , Ur          , Ur^Es       , Uu^Vu       , Uh          , Xu          , Xu          , Xu          , Uu          , Xu          , Uu^Es       , Uu^Es       , Xu          , Xu          , Xu          , Ur^Emf      , Xu          , Uu^Uf       , Uh^Emf      , Ur^Emf      , Ur          , Xu          , Xu          
Xu          , Xu          , Xu          , Xu          , Uu          , Uu^Vu       , Ur          , Ur          , Xu          , Uh          , Xu          , Xu          , Xu          , Xu          , Xu          , Xu          , Xu          , Uu          , Xu          , Ur^Es       , Ur^Es       , Uh          , Xu          , Xu          , Xu          , Uu          , Uu          , Uu          , Ur^Emf      , Xu          , Xu          , Xu          , Xu          , Xu          , Xu          , Uu^Es       , Uu          , Xu          , Ur^Emf      , Uu^Uf       , Xu          , Uu^Uf       , Uu^Emf      , Xu          , Xu          , Xu          
Xu          , Xu          , Xu          , Xu          , Uu          , Ur          , Uu          , Xu          , Ql          , Xu          , Xu          , Xu          , Xu          , Xu          , Xu          , Xu          , Xu          , Xu          , Uu^Uf       , Uh^Emf      , Xu          , Ur          , Ur          , Xu          , Xu          , Ur          , Ur          , Uu          , Xu          , Ur          , Uu^Emf      , Ur          , Xu          , Xu          , Ur          , Uu          , Uu          , Uu          , Uu          , Ur^Emf      , Xu          , Uu^Uf       , Ur^Emf      , Uu          , Xu          , Xu          
Xu          , Xu          , Xu          , Xu          , Uh          , Ur          , Ur          , Uu          , Xu          , Uh          , Xu          , Xu          , Xu          , Xu          , Xu          , Xu          , Xu          , Uu^Uf       , Uu^Uf       , Xu          , Xu          , Xu          , Ur^Es       , Xu          , Xu          , Ur          , Uu          , Ur          , Ur          , Ur          , Uu          , Ur          , Ur          , Ur          , Xu          , Ur          , Xu          , Uu          , Uu          , Uu          , Uu^Vu       , Xu          , Xu          , Xu          , Xu          , Xu          
Xu          , Xu          , Xu          , Xu          , Uh          , Ur          , Ur          , Uu          , Uh          , Uh          , Xu          , Xu          , Xu          , Xu          , Xu          , Xu          , Ur^Emf      , Uu^Uf       , Xu          , Xu          , Uu          , Xu          , Ur          , Ur          , Ur^Emf      , Xu          , Xu          , Uu^Emf      , Xu          , Ur          , Ur          , Ur          , Xu          , Xu          , Xu          , Xu          , Xu          , Xu          , Xu          , Uu          , Uu          , Xu          , Xu          , Xu          , Xu          , Xu          
Xu          , Xu          , Xu          , Xu          , Uh          , Uh          , Uu          , Ur          , Ur          , Xu          , Xu          , Xu          , Xu          , Xu          , Xu          , Xu          , Ur          , Xu          , Xu          , Uh          , Xu          , Uu^Vu       , Xu          , Ur          , Ur^Emf      , Uu^Uf       , Uu^Uf       , Uu^Uf       , Ur^Emf      , Ur          , Ur          , Xu          , Xu          , Xu          , Ur          , Xu          , Xu          , Ur          , Ur          , Uu^Es       , Xu          , Ur          , Xu          , Xu          , Xu          , Xu          
Xu          , Xu          , Xu          , Xu          , Xu          , Uh          , Uu          , Ur          , Uu^Vu       , Xu          , Xu          , Xu          , Xu          , Xu          , Xu          , Xu          , Ur^Es       , Xu          , Uh          , Uh          , Xu          , Xu          , Xu          , Ur          , Ur^Emf      , Uu^Uf       , Xu          , Xu          , Xu          , Xu          , Xu          , Xu          , Uu          , Uu          , Xu          , Xu          , Xu          , Ur          , Xu          , Uu          , Ur          , Ur^Emf      , Xu          , Xu          , Xu          , Xu          
Xu          , Xu          , Xu          , Xu          , Xu          , Uh^Emf      , Ur          , Ur          , Uh          , Ql          , Xu          , Xu          , Xu          , Xu          , Xu          , Xu          , Ur          , Ur          , Uu          , Uh          , Uh          , Xu          , Xu          , Xu          , Ur^Emf      , Xu          , Xu          , Xu          , Xu          , Xu          , Xu          , Uu          , Xu          , Xu          , Xu          , Xu          , Xu          , Xu          , Ur          , Uu          , Ur          , Xu          , Xu          , Xu          , Xu          , Xu          
Xu          , Xu          , Xuc         , Xuc         , Xuc         , Uu^Uf       , Ur          , Uu          , Xuc         , Uh          , Xu          , Xu          , Xu          , Xu          , Xu          , Xu          , Xu          , Xu          , Ur^Es       , Uu          , Xu          , Xu          , Uu          , Ur          , Xu          , Xu          , Xu          , Xu          , Xu          , Xu          , Uu          , Uu^Es       , Xu          , Xu          , Xu          , Xu          , Xu          , Ur          , Xu          , Ur          , Xu          , Xu          , Xu          , Xu          , Xu          , Xu          
Xu          , Xuc         , Cud         , Cud         , Cud         , Uu^Emf      , Ur          , Ur          , Cud         , Xuc         , Xuc         , Xu          , Xu          , Xu          , Xu          , Xu          , Xu          , Ur          , Uu^Es       , Xu          , Uu          , Xu          , Xu          , Ur^Es       , Ur          , Xu          , Ur          , Xu          , Xu          , Uu          , Xu          , Xu          , Xu          , Xu          , Xu          , Xu          , Ur          , Ur^Es       , Xu          , Uu          , Xu          , Xu          , Xu          , Xu          , Xu          , Xu          
Xu          , Xuc         , Xuc         , Kud         , Cud         , Ur          , Cud         , Cud         , Kud         , Xuc         , Xuc         , Xu          , Xu          , Xu          , Xu          , Xu          , Xu          , Xu          , Uu^Es       , Uu          , Uu^Emf      , Xu          , Uu^Uf       , Xu          , Xu          , Uu^Es       , Uu          , Ur^Emf      , Ur          , Ur          , Ur^Es       , Xu          , Ur          , Xu          , Ur          , Uu          , Uu          , Ur          , Ur          , Uu^Vu       , Xu          , Xu          , Xu          , Xu          , Xu          , Xu          
Xu          , Xuc         , Xuc         , Cud         , Ur          , Ur          , Cud         , Cud         , Ql          , Xuc         , Xu          , Xu          , Xu          , Xu          , Xu          , Xu          , Xu          , Xu          , Uu          , Uu          , Uu^Emf      , Uu^Uf       , Uu^Uf       , Xu          , Uu^Emf      , Ur          , Xu          , Uu          , Xu          , Uu          , Uu          , Ur          , Xu          , Ur^Es       , Uu          , Uu          , Xu          , Ur          , Ur          , Xu          , Xu          , Xu          , Ur          , Xu          , Uu          , Xu          
Xu          , Xu          , Xuc         , Uu^Vu       , Uu          , Ur          , Ur^Emf      , Uu^Emf      , Xuc         , Xuc         , Xu          , Xu          , Xu          , Xu          , Xu          , Xu          , Xu          , Ur          , Ur          , Ur^Emf      , Uu^Uf       , Uu^Uf       , Xu          , Uu^Uf       , Uu^Emf      , Ur          , Ur          , Uu^Es       , Ur          , Ur          , Uh          , Ur          , Uh          , Ur          , Ur^Emf      , Xu          , Xu          , Uu^Emf      , Uu^Emf      , Ur          , Ur          , Xu          , Ur^Es       , Ur          , Uu          , Xu          
Xu          , Xu          , Xuc         , Uh          , Ur          , Ur          , Ur^Emf      , Uu^Uf       , Xuc         , Xuc         , Xu          , Xu          , Xu          , Xu          , Xu          , Xu          , Xu          , Xu          , Xu          , Xu          , Uu^Uf       , Uu^Uf       , Uu^Uf       , Xu          , Uu^Emf      , Ur^Emf      , Ur^Emf      , Ur          , Uu^Vu       , Xu          , Uh          , Uh          , Uh          , Uh          , Xu          , Xu          , Uu^Emf      , Uu^Emf      , Uu^Emf      , Uu          , Ur          , Ur          , Ur          , Ur          , Uu          , Ur          
Xuc         , Xuc         , Uu^Uf       , Xuc         , Ur^Emf      , 1 Ur        , Uh          , Uh^Emf      , Xuc         , Xuc         , Xu          , Xu          , Xu          , Xu          , Xu          , Xu          , Xu          , Xu          , Xu          , Uu^Emf      , Uu^Emf      , Uu^Uf       , Uu^Uf       , Uu^Uf       , Uu^Emf      , Ur^Emf      , Xu          , Xu          , Xu          , Xu          , Xu          , Uh          , Uu          , Uu          , Xu          , Xu          , Xu          , Uu^Emf      , Uu^Emf      , Uu          , Ur          , Uu          , Uu          , Ur          , Ur          , Ur          
Xuc         , Xuc         , Uu^Uf       , Uu^Uf       , Ur^Emf      , Uu          , Xuc         , Xuc         , Xuc         , Xu          , Xu          , Xu          , Xu          , Xu          , Xu          , Xu          , Xu          , Xu          , Ur          , Uu          , Uu^Emf      , Uu^Emf      , Xu          , Xu          , Xu          , Xu          , Xu          , Xu          , Xu          , Xu          , Xu          , Uu          , Uu          , Uu^Emf      , Xu          , Xu          , Xu          , Xu          , Xu          , Xu          , Xu          , Uu          , Xu          , Xu          , Xu          , Uu          
Xuc         , Uh^Emf      , Ur^Emf      , Ur^Emf      , Xuc         , Xuc         , Xuc         , Xuc         , Xu          , Xu          , Xu          , Xu          , Xu          , Xu          , Xu          , Xu          , Xu          , Xu          , Xu          , Ur          , Xu          , Xu          , Xu          , Xu          , Xu          , Xu          , Xu          , Xu          , Xu          , Xu          , Uu          , Uu          , Xu          , Xu          , Xu          , Xu          , Xu          , Xu          , Xu          , Xu          , Xu          , Xu          , Xu          , Xu          , Xu          , Uu          
Ur          , Ur          , Xu          , Xu          , Xu          , Xuc         , Xu          , Xuc         , Xu          , Xu          , Xu          , Xu          , Xu          , Xu          , Xu          , Xu          , Xu          , Xu          , Xu          , Xu          , Xu          , Xu          , Xu          , Xu          , Xu          , Xu          , Xu          , Xu          , Xu          , Xu          , Xu          , Xu          , Xu          , Xu          , Xu          , Xu          , Xu          , Xu          , Xu          , Xu          , Xu          , Xu          , Xu          , Xu          , Xu          , Xu          
