border_size=1
usage=map

Xuc         , Xuc         , Xuc         , Xuc         , Xuc         , Xuc         , Xuc         , Xuc         , Xuc         , Xuc         , Uu          , Uu          , Ur          , Ur          , Uu          , Xuc         , Xuc         , Xuc         , Xuc         , Xuc         , Xuc         , Xuc         , Xuc         , Xuc         , Xuc         , Xuc         , Xuc         , Xuc         , Xuc         , Xuc         , Xuc         , Xuc         , Xuc         , Xuc         , Xuc         , Xuc         , Xuc         
Xuc         , Xuc         , Xuc         , Xuc         , Xuc         , Xuc         , Xuc         , Xuc         , Xuc         , Xuc         , Xuc         , Uu          , Ur          , Ur          , Uu          , Xuc         , Xuc         , Xuc         , Xuc         , Xuc         , Xuc         , Xuc         , Xuc         , Xuc         , Xuc         , Xuc         , Xuc         , Xuc         , Xuc         , Xuc         , Xuc         , Xuc         , Xuc         , Xuc         , Xuc         , Xuc         , Xuc         
Xuc         , Xuc         , Xuc         , Xuc         , Xuc         , Xuc         , Xuc         , Xuc         , Xuc         , Xuc         , Xuc         , Uu          , Uu          , Ur          , Xuc         , Xuc         , Xuc         , Xuc         , Xuc         , Xuc         , Xuc         , Xuc         , Xuc         , Xuc         , Xuc         , Xuc         , Xuc         , Xuc         , Xuc         , Xuc         , Xuc         , Xuc         , Xuc         , Xuc         , Xuc         , Xuc         , Xuc         
Xuc         , Xuc         , Xuc         , Xuc         , Xuc         , Xuc         , Xuc         , Xuc         , Xuc         , Xuc         , Xuc         , Uu          , Ur          , Ur          , Ur          , Ur          , Ur          , Xuc         , Xuc         , Xuc         , 3 Kud       , Xuc         , Uu          , Xuc         , Uu          , Xuc         , Xuc         , Xuc         , Xuc         , Xuc         , Xuc         , Xuc         , Xuc         , Xuc         , Xuc         , Xuc         , Xuc         
Xuc         , Xuc         , Xuc         , Xuc         , Xuc         , Xuc         , Xuc         , Xuc         , Xuc         , Xuc         , Xuc         , Xuc         , Xuc         , Uu          , Cud         , Uu          , Uu^Vud      , Ur          , Ur          , Cud         , Xuc         , Cud         , Cud         , Uu          , Uu^Vud      , Xuc         , Uu          , Uu^Vud      , Xuc         , Xuc         , Xuc         , Xuc         , Xuc         , Xuc         , Xuc         , Xuc         , Xuc         
Xuc         , Xuc         , Xuc         , Xuc         , Xuc         , Xuc         , Xuc         , Xuc         , Xuc         , Xuc         , Xuc         , Xuc         , Xuc         , Cud         , Cud         , Xuc         , Xuc         , Ur          , Ur          , Cud         , Ur          , Cud         , Uu          , Uu          , Uu          , Uu          , Cud         , Uu          , Uu          , Xuc         , Xuc         , Xuc         , Xuc         , Xuc         , Xuc         , Xuc         , Xuc         
Xuc         , Xuc         , Xuc         , Xuc         , Xuc         , Xuc         , Xuc         , Xuc         , Xuc         , Xuc         , Xuc         , Xuc         , Cud         , 4 Kud       , Xuc         , Xuc         , Xuc         , Uu          , Ur          , Ur          , Ur          , Ur          , Ur          , Uu          , Uu          , Uu          , Uu          , Cud         , Uu          , Xuc         , Xuc         , Xuc         , Xuc         , Xuc         , Xuc         , Xuc         , Xuc         
Xuc         , Xuc         , Xuc         , Xuc         , Xuc         , Xuc         , Xuc         , Xuc         , Xuc         , Xuc         , Uu^Vud      , Cud         , Cud         , Xuc         , Cud         , Cud         , Ur          , Xuc         , Xuc         , Ur          , Xuc         , Xuc         , Uu^Vud      , Ur          , Ur          , Uu          , Xuc         , Uu          , Cud         , Xuc         , Xuc         , Xuc         , Xuc         , Xuc         , Xuc         , Xuc         , Xuc         
Xuc         , Xuc         , Xuc         , Xuc         , Xuc         , Xuc         , Xuc         , Xuc         , Uu          , Uu          , Uu          , Uu          , Xuc         , Xuc         , Uu^Vud      , Cud         , Ur          , Ur          , Uu^Vud      , Xuc         , 2 Kud       , Cud         , Xuc         , Uu          , Xuc         , Ur          , Ur          , Xuc         , Cud         , Xuc         , Xuc         , Xuc         , Xuc         , Xuc         , Xuc         , Xuc         , Xuc         
Uu          , Xuc         , Xuc         , Xuc         , Cud         , Cud         , 5 Kud       , Cud         , Uu          , Uu          , Uu^Vud      , Xuc         , Ur          , Uu          , Ur          , Ur          , Uu          , Ur          , Ur          , Cud         , Cud         , 1 Cud       , Xuc         , Xuc         , Xuc         , Xuc         , Xuc         , Ur          , Cud         , Kud         , Cud         , Xuc         , Xuc         , Xuc         , Xuc         , Xuc         , Uu          
Ur          , Uu          , Uu          , Ur          , Ur          , Cud         , Cud         , Ur          , Ur          , Xuc         , Uu          , Uu          , Ur          , Ur          , Ur          , Ur          , Xuc         , Ur          , Ur          , Cud         , Ur          , Ur          , Ur          , Ur          , Ur          , Uu          , Ur          , Uu^Vud      , Ur          , Ur          , Ur          , Ur          , Ur          , Xuc         , Ur          , Uu          , Ur          
Uu          , Ur          , Ur          , Uu          , Ur          , Xuc         , Ur          , Xuc         , Ur          , Ur          , Ur          , Xuc         , Uu          , Ur          , Uu          , Xuc         , Uu          , Uu^Vud      , Uu          , Ur          , Cud         , Cud         , Cud         , Ur          , Ur          , Ur          , Cud         , Ur          , Ur          , Xuc         , 9 Kud       , Cud         , Xuc         , Ur          , Uu          , Ur          , Uu          
Xuc         , Uu          , Uu          , Ur          , Cud         , Cud         , Xuc         , Ur          , Xuc         , Ur          , Ur          , Ur          , Xuc         , Uu^Vud      , Xuc         , Ur          , Ur          , Xuc         , Xuc         , Ur          , Cud         , Xuc         , Cud         , Xuc         , Ur          , Cud         , Cud         , Cud         , Xuc         , Uu          , Xuc         , Cud         , Ur          , Ur          , Uu^Vud      , Uu          , Xuc         
Xuc         , Xuc         , Xuc         , Xuc         , Xuc         , 6 Kud       , Cud         , Cud         , Uu^Vud      , Uu          , Ur          , Ur          , Ur          , Uu          , Cud         , Xuc         , Ur          , Uu^Vud      , Uu          , Ur          , Ur          , Xuc         , Ur          , Ur          , Ur          , Xuc         , Xuc         , Xuc         , Xuc         , Ur          , Ur          , Ur          , Cud         , Ur          , Xuc         , Uu          , Xuc         
Xuc         , Xuc         , Xuc         , Xuc         , Uu^Vud      , Xuc         , Cud         , Uu          , Xuc         , Ur          , Uu^Vud      , Ur          , Ur          , Cud         , Cud         , Xuc         , Cud         , Ur          , Ur          , Uu^Vud      , Ur          , Ur          , Uu^Vud      , Uu          , Xuc         , Xuc         , Uu          , Uu^Vud      , Ur          , Ur          , Xuc         , Cud         , Kud         , Xuc         , Xuc         , Uu          , Xuc         
Xuc         , Xuc         , Xuc         , Xuc         , Xuc         , Uu          , Ur          , Ur          , Ur          , Ur          , Ur          , Ur          , Ur          , Cud         , Cud         , Xuc         , Cud         , Cud         , Cud         , Ur          , Ur          , Ur          , Ur          , Uu          , Uu^Vud      , Uu          , Ur          , Ur          , Ur          , Ur          , Xuc         , Cud         , Cud         , Xuc         , Xuc         , Xuc         , Xuc         
Xuc         , Xuc         , Xuc         , Xuc         , Xuc         , Xuc         , Xuc         , Uu^Vud      , Uu          , Uu          , Uu^Vud      , Uu          , Ur          , Uu          , Xuc         , Uu^Vud      , Xuc         , Cud         , Xuc         , Cud         , Ur          , Ur          , Ur          , Xuc         , Ur          , Ur          , Cud         , Cud         , Xuc         , Uu          , Uu^Vud      , Xuc         , Xuc         , Xuc         , Xuc         , Xuc         , Xuc         
Xuc         , Xuc         , Xuc         , Xuc         , Xuc         , Xuc         , Xuc         , Xuc         , Xuc         , Uu          , Xuc         , Xuc         , Xuc         , Ur          , Ur          , Uu          , Ur          , Ur          , Ur          , Ur          , Ur          , Uu          , Xuc         , Ur          , Ur          , Ur          , Cud         , Cud         , Xuc         , Uu          , Xuc         , Xuc         , Xuc         , Xuc         , Xuc         , Xuc         , Xuc         
Xuc         , Xuc         , Xuc         , Xuc         , Xuc         , Xuc         , Xuc         , Xuc         , Xuc         , Xuc         , Xuc         , Xuc         , Uu^Vud      , Uu          , Uu          , Ur          , Uu^Vud      , Ur          , Uu          , Uu          , Ur          , Uu^Vud      , Xuc         , Xuc         , Xuc         , Ur          , Ur          , Xuc         , Uu          , Uu^Vud      , Xuc         , Xuc         , Xuc         , Xuc         , Xuc         , Xuc         , Xuc         
Xuc         , Xuc         , Xuc         , Xuc         , Xuc         , Xuc         , Xuc         , Xuc         , Xuc         , Xuc         , Xuc         , Xuc         , Xuc         , Xuc         , Xuc         , Xuc         , Uu          , Uu          , Cud         , Xuc         , Cud         , Ur          , Xuc         , Xuc         , Cud         , Uu          , Ur          , Uu          , Uu^Vud      , Xuc         , Xuc         , Xuc         , Xuc         , Xuc         , Xuc         , Xuc         , Xuc         
Xuc         , Xuc         , Xuc         , Xuc         , Xuc         , Xuc         , Xuc         , Xuc         , Xuc         , Xuc         , Xuc         , Xuc         , Xuc         , Xuc         , Xuc         , Xuc         , Uu^Vud      , Uu          , Cud         , Cud         , Cud         , Ur          , Cud         , 8 Kud       , Cud         , Cud         , Uu          , Uu          , Xuc         , Xuc         , Xuc         , Xuc         , Xuc         , Xuc         , Xuc         , Xuc         , Xuc         
Xuc         , Xuc         , Xuc         , Xuc         , Xuc         , Xuc         , Xuc         , Xuc         , Xuc         , Xuc         , Xuc         , Xuc         , Xuc         , Xuc         , Xuc         , Uu          , Uu          , Xuc         , Cud         , 7 Kud       , Cud         , Ur          , Ur          , Cud         , Ur          , Ur          , Uu          , Xuc         , Xuc         , Xuc         , Xuc         , Xuc         , Xuc         , Xuc         , Xuc         , Xuc         , Xuc         
Xuc         , Xuc         , Xuc         , Xuc         , Xuc         , Xuc         , Xuc         , Xuc         , Xuc         , Xuc         , Xuc         , Xuc         , Xuc         , Xuc         , Uu          , Uu^Vud      , Xuc         , Uu          , Xuc         , Xuc         , Ur          , Ur          , Uu          , Xuc         , Uu          , Ur          , Uu^Vud      , Xuc         , Xuc         , Xuc         , Xuc         , Xuc         , Xuc         , Xuc         , Xuc         , Xuc         , Xuc         
Xuc         , Xuc         , Xuc         , Xuc         , Xuc         , Xuc         , Xuc         , Xuc         , Xuc         , Xuc         , Xuc         , Xuc         , Xuc         , Uu          , Uu          , Xuc         , Uu          , Xuc         , Xuc         , Xuc         , Ur          , Ur          , Xuc         , Uu^Vud      , Xuc         , Ur          , Uu          , Xuc         , Xuc         , Xuc         , Xuc         , Xuc         , Xuc         , Xuc         , Xuc         , Xuc         , Xuc         
Xuc         , Xuc         , Xuc         , Xuc         , Xuc         , Xuc         , Xuc         , Xuc         , Xuc         , Xuc         , Xuc         , Xuc         , Xuc         , Xuc         , Xuc         , Xuc         , Uu          , Xuc         , Uu          , Uu^Vud      , Ur          , Ur          , Uu          , Xuc         , Uu          , Ur          , Uu          , Xuc         , Uu          , Xuc         , Xuc         , Xuc         , Xuc         , Xuc         , Xuc         , Xuc         , Xuc         
Xuc         , Xuc         , Xuc         , Xuc         , Xuc         , Xuc         , Xuc         , Xuc         , Xuc         , Xuc         , Xuc         , Xuc         , Xuc         , Xuc         , Xuc         , Xuc         , Xuc         , Uu          , Xuc         , Uu          , Xuc         , Ur          , Ur          , Ur          , Ur          , Ur          , Uu          , Uu          , Xuc         , Uu          , Xuc         , Xuc         , Xuc         , Xuc         , Xuc         , Xuc         , Xuc         
