border_size=1
usage=map

Dd          , Ch          , Kh          , Kh          , Kh          , Ch          , Dd          , Rd          , Dd          , Dd          , Dd^Ftd      , Dd          , Rd          , Dd^Ftd      , Dd          , Dd          , Dd          , Dd^Ftd      , Dd^Ftd      , Rd          , Rd          , Dd          , Dd          , Dd          , Dd^Ftd      , Dd          , Dd^Ftd      , Dd          , Cd          , Cd          , Dd^Ftd      , Dd^Ftd      , Dd^Ftd      , Dd^Ftd      , Rd          , Dd          , Dd^Ftd      , Dd^Ftd      , Dd^Ftd      , Dd          , Rd          , Dd^Ftd      , Rd          , Dd          , Dd          , Rrc         , Dd^Ftd      , Rrc         , Cd          , Dd          
Dd          , Ch          , Kh          , 2 Kh        , Kh          , Ch          , Rd          , Rd          , Rd          , Dd^Ftd      , Dd^Ftd      , Dd^Ftd      , Rd          , Dd^Ftd      , Dd^Ftd      , Cd          , Dd^Ftd      , Dd^Ftd      , Dd^Ftd      , Dd^Ftd      , Rd          , Dd          , Dd^Vda      , Dd^Ftd      , Dd          , Dd^Ftd      , Dd          , Dd          , Cd          , Dd          , Dd^Ftd      , Dd          , Dd^Ftd      , Dd          , Rd          , Dd          , Dd^Vda      , Dd^Ftd      , Dd          , Dd          , Rd          , Rd          , Dd          , Dd^Ftd      , Dd^Ftd      , Dd^Ftd      , Cd          , Cd          , Dd^Ftd      , Dd          
Dd          , Ch          , Kh          , Kh          , Kh          , Ch          , Dd          , Dd          , Rd          , Dd^Ftd      , Dd          , Dd^Vda      , Rd          , Dd          , Dd          , Cd          , Cd          , Dd^Ftd      , Dd          , Dd^Ftd      , Rd          , Dd          , Rd          , Rd          , Rd          , Rd          , Rd          , Cd          , Dd          , Dd^Ftd      , Dd          , Dd^Vda      , Dd          , Dd          , Rd          , Rd          , Rd          , Dd          , Rd          , Rd          , Rd          , Dd^Vda      , Dd          , Dd          , Cd          , Cd          , Dd^Ftd      , Dd^Ftd      , Dd          , Dd          
Dd          , Ch          , Ch          , Ch          , Ch          , Ch          , Dd          , Dd          , Rd          , Rd          , Rd          , Dd          , Rd          , Dd          , Dd          , Dd^Ftd      , Cd          , Dd^Ftd      , Dd          , Dd          , Dd          , Rd          , Dd          , Dd          , Gg          , Dd          , Ch          , Rd          , Rd          , Dd          , Rd          , Dd          , Rd          , Rd          , Dd^Ftd      , Dd          , Dd^Ftd      , Rd          , Cd          , Dd          , Rd          , Dd          , Cd          , Cd          , Dd^Ftd      , Dd^Ftd      , Dd^Ftd      , Dd          , Rd          , Rd          
Dd^Ftd      , Dd          , Dd          , Dd          , Dd          , Dd          , Dd          , Rd          , Dd          , Dd^Ftd      , Dd^Ftd      , Rd          , Dd          , Rd          , Rd          , Dd          , Cd          , Dd^Ftd      , Dd^Ftd      , Dd^Vda      , Dd          , Rd          , Gg^Ftp      , Gg^Ftp      , Ch          , Ch          , Ch          , Ch          , Dd          , Rd          , Dd          , Rd          , Dd          , Dd          , Dd^Ftd      , Dd          , Cd          , Cd          , Dd          , Dd          , Dd          , Rd          , Rd          , Dd          , Dd          , Dd          , Rd          , Rd          , Dd          , Dd          
Dd          , Dd          , Dd^Vda      , Dd^Ftd      , Dd^Ftd      , Dd          , Dd          , Rd          , Dd          , Dd^Vda      , Dd          , Dd^Ftd      , Dd^Ftd      , Dd          , Rd          , Dd          , Rd          , Dd          , Dd          , Dd          , Rd          , Rd          , Gg          , Ch          , Ch          , 8 Kh        , Ch          , Ch          , Gg          , Dd^Ftd      , Dd          , Rd          , Dd^Vda      , Dd^Ftd      , Dd^Ftd      , Dd^Ftd      , Cd          , Dd^Ftd      , Dd^Ftd      , Dd          , Dd          , Dd^Ftd      , Dd^Vda      , Rd          , Rd          , Rd          , Dd          , Dd^Vda      , Dd^Ftd      , Dd          
Dd          , Dd^Ftd      , Dd^Ftd      , Dd          , Dd          , Dd^Ftd      , Rd          , Rd          , Dd^Ftd      , Dd          , Cd          , Cd          , Dd^Ftd      , Dd^Ftd      , Rd          , Rd          , Dd          , Rd          , Rd          , Rd          , Rd          , Dd          , Gg^Ftp      , Ch          , Ch          , Ch          , Gg^Ftp      , Ch          , Gg^Ftp      , Dd^Ftd      , Dd          , Rd          , Dd          , Dd^Ftd      , Rd          , Dd          , Dd          , Dd^Ftd      , Cd          , Cd          , Dd          , Dd          , Dd          , Rd          , Dd          , Dd          , Dd^Ftd      , Dd          , Dd          , Dd          
Rd          , Rd          , Rd          , Rd          , Rd          , Rd          , Dd          , Rd          , Rd          , Rd          , Cd          , Dd^Ftd      , Dd^Ftd      , Dd^Ftd      , Rd          , Dd          , Dd^Vda      , Dd          , Dd          , Cd          , Dd          , Rd          , Rd          , Ch          , Rrc         , Ch          , Gg^Ftp      , Gg          , Dd          , Dd^Ftd      , Rd          , Rd          , Rd          , Rd          , Dd^Ftd      , Rd          , Dd^Vda      , Dd^Ftd      , Cd          , Dd          , Dd          , Dd^Ftd      , Rd          , Rd          , Dd^Ftd      , Dd^Ftd      , Dd          , Dd          , Cd          , Cd          
Dd^Ftd      , Dd          , Dd          , Dd          , Dd^Ftd      , Dd          , Dd          , Dd^Vda      , Rd          , Dd          , Cd          , Dd^Ftd      , Dd^Ftd      , Dd          , Rd          , Dd          , Dd          , Dd^Ftd      , Dd          , Cd          , Dd          , Dd^Ftd      , Dd^Vda      , Rd          , Rd          , Dd          , Dd          , Dd          , Dd^Vda      , Dd^Ftd      , Rd          , Dd          , Dd          , Dd^Ftd      , Cd          , Rd          , Dd^Ftd      , Dd          , Cd          , Dd          , Dd^Vda      , Dd          , Rd          , Dd          , Dd          , Dd^Vda      , Dd          , Cd          , Dd          , Dd          
Dd          , Dd          , Dd^Vda      , Dd^Ftd      , Dd          , Dd^Ftd      , Cd          , Dd          , Rd          , Dd          , Dd          , Dd          , Dd^Ftd      , Dd^Ftd      , Rd          , Dd^Ftd      , Dd^Ftd      , Dd          , Cd          , Cd          , Dd^Ftd      , Dd^Ftd      , Rd          , Rd          , Dd          , Rd          , Rd          , Dd^Ftd      , Rd          , Dd          , Rd          , Dd          , Cd          , Cd          , Dd          , Rd          , Rd          , Dd          , Dd          , Dd          , Rd          , Rd          , Dd^Ftd      , Rd          , Rrc         , Dd          , Cd          , Cd          , Dd          , Dd          
Rd          , Dd          , Dd          , Dd          , Cd          , Cd          , Dd^Ftd      , Dd^Ftd      , Dd^Ftd      , Rd          , Dd^Vda      , Dd^Ftd      , Dd          , Dd^Vda      , Rd          , Dd          , Dd^Ftd      , Dd          , Cd          , Dd          , Rd          , Rd          , Dd          , Dd^Ftd      , Dd^Ftd      , Dd          , Rd          , Rd          , Dd          , Rd          , Rd          , Dd^Ftd      , Cd          , Dd^Ftd      , Dd^Ftd      , Dd          , Cd          , Rd          , Rd          , Rd          , Dd          , Dd          , Gg          , Dd          , Ch          , Rrc         , Rrc         , Dd          , Rr          , Dd          
Dd          , Rd          , Rd          , Dd          , Rd          , Dd^Ftd      , Rd          , Rd          , Rd          , Rd          , Rd          , Dd^Ftd      , Dd^Ftd      , Dd          , Rd          , Dd          , Cd          , Cd          , Dd^Ftd      , Dd          , Rd          , Dd          , Dd^Ftd      , Dd^Ftd      , Dd          , Dd^Ftd      , Rd          , Dd^Ftd      , Dd^Ftd      , Dd          , Rd          , Dd^Ftd      , Dd          , Dd^Ftd      , Cd          , Cd          , Dd^Ftd      , Dd          , Rd          , Dd^Vda      , Dd^Ftd      , Dd          , 5 Kh        , Ch          , Gg          , Gg          , Gs^Vh       , Rr          , Gd^Gvs      , Rp          
Dd          , Dd          , Dd^Vda      , Rd          , Dd          , Rd          , Dd          , Dd          , Cd          , Dd          , Rd          , Dd          , Rd          , Rd          , Dd          , Rd          , Dd^Ftd      , Dd          , Dd          , Dd          , Rd          , Dd^Ftd      , Dd^Ftd      , Dd^Vda      , Dd          , Dd          , Rd          , Dd          , Dd^Ftd      , Dd^Vda      , Dd          , Rd          , Dd          , Dd^Ftd      , Cd          , Dd^Ftd      , Dd          , Rd          , Dd          , Dd          , Gg          , Gg          , Ch          , Ch          , Gg^Ftp      , Gg^Ftp      , Dd          , Gd^Gvs      , Gd^Gvs      , Gd^Gvs      
Dd          , Dd          , Dd          , Dd          , Dd          , Dd          , Dd^Ftd      , Dd^Ftd      , Cd          , Dd          , Rd          , Rd          , Dd          , Rd          , Rd          , Dd          , Dd          , Dd          , Dd^Vda      , Dd          , Rd          , Dd          , Dd          , Dd^Ftd      , Dd          , Rd          , Dd          , Rd          , Rd          , Dd          , Rd          , Rd          , Rd          , Cd          , Dd^Ftd      , Dd^Ftd      , Dd          , Rd          , Dd^Vda      , Dd          , Gg          , Gg^Ftp      , Ch          , Gg^Ftp      , Dd          , Dd          , Dd          , Gd^Gvs      , Gd^Gvs      , Gd^Gvs      
Dd          , Dd          , Dd^Ftd      , Dd^Ftd      , Dd^Ftd      , Dd^Ftd      , Dd          , Cd          , Dd^Ftd      , Dd^Ftd      , Rd          , Dd^Ftd      , Dd^Vda      , Dd          , Dd          , Rd          , Rd          , Rd          , Rd          , Rd          , Rd          , Rd          , Rd          , Rd          , Rd          , Rd          , Dd^Ftd      , Dd          , Dd          , Rd          , Dd^Vda      , Dd          , Dd          , Rd          , Dd          , Dd^Ftd      , Dd^Vda      , Rd          , Dd          , Dd          , Gg^Ftp      , Gg^Ftp      , Ch          , Dd          , Gd^Gvs      , Gd^Gvs      , Dd          , Gd^Gvs      , Gd^Gvs      , Gd^Gvs      
Dd          , Dd          , Dd          , Dd^Ftd      , Dd          , Dd^Ftd      , Cd          , Cd          , Dd          , Dd          , Rd          , Dd          , Dd          , Dd^Ftd      , Gg          , Gg          , Rrc         , Dd          , Gg^Ftp      , Dd          , Dd          , Dd          , Dd^Ftd      , Dd          , Rd          , Dd          , Cd          , Cd          , Dd^Ftd      , Dd^Ftd      , Dd          , Dd          , Cd          , Rd          , Rd          , Dd          , Rd          , Rd          , Dd          , Gg          , Ch          , Ch          , Dd          , Gs^Vh       , Gd^Gvs      , Gd^Gvs      , Dd          , Dd          , Dd          , Gd^Gvs      
Dd          , Dd          , Cd          , Cd          , Cd          , Cd          , Dd          , Dd          , Dd          , Dd          , Rd          , Dd^Ftd      , Gg          , Gg          , Gg^Ftp      , Gg^Ftp      , Ch          , Ch          , Ch          , Ch          , Gg^Ftp      , Dd          , Dd          , Dd^Vda      , Rd          , Dd^Ftd      , Cd          , Dd^Ftd      , Dd          , Dd          , Dd          , Cd          , Dd^Ftd      , Dd          , Dd          , Rd          , Rrc         , Dd          , Ch          , Ch          , Gg          , Gg^Ftp      , Dd          , Gd^Gvs      , Gd^Gvs      , Gd^Gvs      , Gd^Gvs      , Dd          , Dd          , Dd          
Dd          , Dd          , Dd          , Dd          , Dd          , Dd          , Dd^Ftd      , Dd^Vda      , Dd          , Dd^Ftd      , Rd          , Dd          , Dd          , Gg          , Gg^Ftp      , Gg          , Ch          , 7 Kh        , Ch          , Ch          , Gg^Ftp      , Gg          , Dd^Ftd      , Dd^Ftd      , Rd          , Dd          , Dd          , Dd          , Cd          , Cd          , Cd          , Cd          , Dd          , Dd^Vda      , Dd          , Dd          , Ch          , Rrc         , Rrc         , Rrc         , Rrc         , Rrc         , Rr          , Dd          , Gd^Gvs      , Gd^Gvs      , Gd^Gvs      , Dd          , Dd          , Dd          
Dd          , Dd          , Dd          , Dd^Ftd      , Rd          , Dd          , Dd          , Dd          , Rd          , Rd          , Dd^Ftd      , Dd^Ftd      , Dd          , Dd          , Gg^Ftp      , Ch          , Ch          , Ch          , Ch          , Ch          , Gg^Ftp      , Gg          , Dd          , Dd          , Rd          , Dd          , Dd^Vda      , Dd          , Dd          , Dd          , Dd          , Dd^Ftd      , Dd          , Dd          , Dd          , Ch          , Gg^Ftp      , Dd          , Dd          , Gd^Gvs      , Gd^Gvs      , Gd^Gvs      , Dd          , Rr          , Rp          , Dd          , Dd          , Dd          , Dd          , Dd          
Rd          , Rd          , Rd          , Rd          , Dd          , Rd          , Rd          , Rd          , Dd^Ftd      , Dd          , Dd^Ftd      , Dd^Vda      , Dd          , Gg          , Rd          , Gg          , Rrc         , Ch          , Dd          , Gg          , Gg          , Gg          , Dd          , Dd^Ftd      , Dd          , Rd          , Rd          , Rd          , Rd          , Dd          , Dd          , Dd^Vda      , Dd          , Dd          , 4 Kh        , Ch          , Dd          , Dd          , Gs^Vh       , Gd^Gvs      , Gd^Gvs      , Gd^Gvs      , Gd^Gvs      , Dd          , Dd          , Rp          , Rp          , Dd          , Dd          , Dd          
Dd          , Dd          , Dd          , Dd^Vda      , Dd          , Dd          , Dd          , Rd          , Rd          , Dd          , Dd^Ftd      , Dd          , Rd          , Rd          , Dd          , Rd          , Rd          , Dd          , Dd^Ftd      , Dd          , Dd          , Dd          , Dd          , Dd^Vda      , Dd          , Dd^Ftd      , Cd          , Cd          , Dd          , Rd          , Dd          , Dd          , Dd          , Dd          , Ch          , Ch          , Gg^Ftp      , Dd          , Dd          , Gd^Gvs      , Gd^Gvs      , Gd^Gvs      , Gd^Gvs      , Dd          , Dd          , Dd          , Rp          , Dd          , Dd          , Gd          
Dd          , Dd^Ftd      , Dd^Ftd      , Dd          , Dd          , Dd^Ftd      , Dd^Ftd      , Dd          , Cd          , Rd          , Rd          , Rd          , Dd^Ftd      , Dd          , Cd          , Cd          , Rd          , Dd          , Dd          , Dd^Ftd      , Dd^Vda      , Dd^Ftd      , Dd          , Dd          , Dd          , Cd          , Dd^Ftd      , Dd          , Dd^Ftd      , Rd          , Dd          , Dd^Vda      , Gg          , Gg^Ftp      , Ch          , Gg^Ftp      , Gg^Ftp      , Dd          , Dd          , Gd^Gvs      , Dd          , Gd^Gvs      , Dd          , Dd          , Dd          , Dd          , Rp          , Dd          , Gd          , Gd          
Dd          , Dd^Ftd      , Dd^Ftd      , Dd^Ftd      , Dd^Ftd      , Dd^Ftd      , Cd          , Cd          , Dd^Ftd      , Rd          , Dd^Ftd      , Dd          , Dd          , Cd          , Dd          , Dd          , Dd^Ftd      , Rd          , Rd          , Dd          , Rd          , Dd          , Cd          , Dd          , Cd          , Cd          , Dd          , Dd^Ftd      , Dd          , Rd          , Dd          , Dd          , Gg          , Ch          , Gg^Ftp      , Gg^Ftp      , Dd          , Dd          , Gd^Gvs      , Dd          , Dd          , Dd          , Dd          , Dd          , Dd          , Dd          , Gd          , Rp          , Gd          , Gd          
Dd          , Dd          , Dd          , Dd^Ftd      , Dd^Ftd      , Dd^Ftd      , Cd          , Dd^Ftd      , Dd          , Rd          , Dd^Vda      , Dd          , Cd          , Cd          , Dd          , Dd          , Rd          , Rd          , Dd          , Rd          , Rd          , Cd          , Dd^Ftd      , Cd          , Dd^Ftd      , Dd^Ftd      , Dd          , Dd^Vda      , Rd          , Rd          , Gg          , Gg          , Ch          , Ch          , Dd          , Dd          , Gd^Gvs      , Gd^Gvs      , Gd^Gvs      , Dd          , Dd          , Dd          , Dd          , Dd          , Dd          , Dd          , Gd          , Rp          , Gd          , Gd          
Dd          , Dd          , Cd          , Dd^Ftd      , Cd          , Cd          , Dd          , Dd^Ftd      , Rd          , Rd          , Dd          , Dd          , Cd          , Dd          , Rd          , Rd          , Dd^Ftd      , Dd          , Dd          , Rd          , Dd          , Rd          , Rd          , Dd^Ftd      , Dd^Vda      , Dd          , Rd          , Rd          , Dd          , Rrc         , Gg          , Ch          , Dd          , Dd          , Dd          , Gd^Gvs      , Gd^Gvs      , Gd^Gvs      , Gd^Gvs      , Dd          , Dd          , Dd          , Dd          , Dd          , Dd^Vht      , Gd          , Gd          , Gd          , Gd          , Aa^Fda      
Dd          , Rd          , Rd          , Cd          , Dd          , Dd          , Rd          , Rd          , Rd          , Dd          , Dd^Ftd      , Dd          , Cd          , Dd          , Rd          , Dd          , Dd^Vda      , Dd          , Dd^Ftd      , Cd          , Dd          , Dd^Vda      , Rd          , Rd          , Rd          , Rd          , Dd          , Dd          , Gg          , Rrc         , Rrc         , Ch          , Rr          , Dd          , Dd          , Gs^Vh       , Dd          , Gd^Gvs      , Dd          , Dd          , Dd          , Dd          , Dd          , Dd          , Gd          , Gd          , Gd          , Gd          , Ha          , Ha          
Dd          , Dd^Ftd      , Dd          , Rd          , Dd          , Rd          , Dd          , Dd^Vda      , Dd          , Rd          , Dd          , Cd          , Dd^Ftd      , Dd^Ftd      , Rd          , Dd          , Dd          , Dd          , Dd^Ftd      , Cd          , Dd^Ftd      , Dd          , Rd          , Dd^Vda      , Dd          , Dd          , Gg          , Gg          , Ch          , Ch          , Dd          , Rrc         , Gd^Gvs      , Rr          , Rp          , Dd          , Dd          , Dd          , Dd          , Dd          , Dd          , Dd          , Dd          , Dd          , Gd          , Gd          , Gd          , Gd          , Ha          , Ha          
Dd          , Dd^Ftd      , Dd          , Rd          , Rd          , Rd          , Dd          , Dd^Ftd      , Dd          , Rd          , Rd          , Dd          , Dd^Vda      , Dd          , Rd          , Dd          , Dd^Ftd      , Dd^Ftd      , Dd^Ftd      , Cd          , Cd          , Cd          , Rd          , Dd          , Gg          , Gg          , Ch          , Ch          , Dd          , Dd          , Gs^Vh       , Gd^Gvs      , Gd^Gvs      , Gd^Gvs      , Dd          , Rp          , Rp          , Dd          , Dd          , Dd          , Dd          , Dd          , Dd          , Gd          , Gd          , Gd          , Gd          , Gd          , Aa^Fda      , Aa^Fda      
Dd          , Dd^Ftd      , Dd^Vda      , Rd          , Dd          , Dd          , Ch          , Dd          , Ch          , Dd          , Dd          , Rd          , Rd          , Dd          , Rd          , Dd^Ftd      , Dd          , Dd^Ftd      , Dd^Ftd      , Cd          , Dd          , Dd          , Rd          , Gg          , 3 Kh        , Ch          , Gg^Ftp      , Gg^Ftp      , Dd          , Dd          , Gd^Gvs      , Gd^Gvs      , Gd^Gvs      , Gd^Gvs      , Dd          , Dd          , Dd          , Rp          , Rp          , Dd          , Dd          , Dd          , Gd          , Gd          , Gd          , Gd          , Aa          , Ha          , Aa^Fda      , Ha          
Rd          , Rd          , Rd          , Rd          , Rrc         , Ch          , Ch          , Ch          , Ch          , Gg^Ftp      , Gg^Ftp      , Dd          , Rd          , Dd          , Rd          , Dd^Ftd      , Dd          , Dd^Ftd      , Cd          , Cd          , Dd          , Dd^Vda      , Rd          , Gg^Ftp      , Ch          , Ch          , Gg^Ftp      , Dd          , Dd          , Dd          , Dd          , Gd^Gvs      , Dd          , Dd          , Dd          , Dd          , Dd          , Dd          , Dd          , Rp          , Rp          , Gd          , Gd          , Gd          , Gd          , Gd          , Ha          , Aa^Fda      , Ha          , Ha          
Dd          , Dd^Ftd      , Rd          , Dd          , Gg^Ftp      , Gg^Ftp      , Ch          , 6 Kh        , Ch          , Ch          , Gg          , Rd          , Rd          , Rd          , Dd          , Rd          , Rd          , Cd          , Dd          , Dd          , Dd^Vda      , Dd          , Rrc         , Ch          , Gg^Ftp      , Gg^Ftp      , Gg^Ftp      , Dd          , Gd^Gvs      , Dd          , Gd^Gvs      , Dd          , Dd          , Dd          , Dd          , Dd          , Dd          , Dd^Vht      , Dd          , Dd          , Gd          , Rp          , Gd          , Gd          , Gd          , Gd          , Ha^Fda      , Ha^Fda      , Ha^Fda      , Ha          
Dd          , Dd          , Dd          , Rd          , Dd          , Gg^Ftp      , Ch          , Ch          , Ch          , Ch          , Dd          , Rd          , Dd^Vda      , Dd          , Dd^Ftd      , Dd^Ftd      , Dd          , Rd          , Rd          , Rd          , Rd          , Rd          , Rrc         , Ch          , Gg          , Gg          , Gg          , Gs^Vh       , Gd^Gvs      , Gd^Gvs      , Gd^Gvs      , Dd          , Dd          , Dd          , Dd          , Dd          , Dd          , Dd          , Gd          , Gd          , Gd          , Gd          , Gd          , Gd          , Aa^Fda      , Aa^Fda      , Ha^Fda      , Ha^Fda      , Ha^Fda      , Ha          
Dd^Ftd      , Dd          , Dd^Vda      , Rd          , Rd          , Gg^Ftp      , Gg          , Gg^Ftp      , Gg^Ftp      , Dd          , Rd          , Rd          , Dd          , Dd          , Dd          , Cd          , Dd          , Dd^Vda      , Rd          , Dd          , Dd^Ftd      , Dd          , Cd          , Rrc         , Rr          , Gg          , Gd^Gvs      , Gd^Gvs      , Gd^Gvs      , Gd^Gvs      , Gd^Gvs      , Dd          , Dd          , Dd          , Dd          , Dd          , Dd          , Dd          , Gd          , Gd          , Gd          , Gd          , Gd          , Gd          , Gd          , Aa          , Ha          , Ha^Fda      , Ha^Fda      , Ha^Fda      
Dd          , Dd^Ftd      , Dd          , Dd          , Rd          , Rd          , Rd          , Gg^Ftp      , Dd          , Dd          , Rd          , Dd          , Dd^Ftd      , Dd^Ftd      , Cd          , Cd          , Rd          , Rd          , Dd          , Dd^Ftd      , Cd          , Cd          , Dd          , Dd          , Dd          , Rr          , Rp          , Gd^Gvs      , Dd          , Gd^Gvs      , Dd          , Dd          , Dd          , Dd          , Dd          , Dd          , Gd          , Gd          , Gd          , Gd          , Gd          , Aa          , Aa          , Aa          , Ha          , Cha         , Cha         , Ha          , Ha^Fda      , Ha^Fda      
Rd          , Dd          , Rd          , Rd          , Dd          , Dd          , Dd          , Rd          , Rd          , Rd          , Dd          , Dd^Ftd      , Dd^Ftd      , Cd          , Dd          , Dd          , Rd          , Dd^Ftd      , Dd^Vda      , Dd          , Cd          , Dd          , Dd          , Gd^Gvs      , Gd^Gvs      , Gs^Vh       , Dd          , Rp          , Rp          , Dd          , Dd          , Dd          , Dd          , Dd          , Dd          , Dd          , Gd          , Gd          , Gd          , Gd          , Aa^Fda      , Ha          , Ha^Fda      , Ha          , Ha          , Cha         , 1 Kha       , Cha         , Ha^Fda      , Ha^Fda      
Dd          , Rd          , Dd^Ftd      , Dd          , Dd          , Cd          , Dd^Ftd      , Dd^Vda      , Dd          , Rd          , Dd          , Dd^Ftd      , Dd^Ftd      , Cd          , Dd          , Dd^Vda      , Rd          , Dd          , Dd^Ftd      , Cd          , Dd          , Dd          , Gd^Gvs      , Gd^Gvs      , Gd^Gvs      , Gd^Gvs      , Gd^Gvs      , Dd          , Dd          , Rp          , Rp          , Dd          , Rp          , Dd^Vht      , Rp          , Gd          , Rp          , Rp          , Gd          , Aa^Fda      , Aa^Fda      , Aa^Fda      , Ha^Fda      , Ha^Fda      , Ha^Fda      , Cha         , Cha         , Cha         , Ha^Fda      , Ha^Fda      
Dd          , Dd^Ftd      , Dd^Vda      , Dd          , Cd          , Cd          , Dd^Ftd      , Dd          , Dd^Ftd      , Rd          , Dd^Vda      , Dd          , Dd          , Cd          , Dd^Ftd      , Dd          , Rd          , Dd          , Dd^Ftd      , Cd          , Dd          , Dd          , Gd^Gvs      , Gd^Gvs      , Gd^Gvs      , Gd^Gvs      , Gd^Gvs      , Dd          , Dd          , Dd          , Dd          , Rp          , Dd          , Rp          , Dd          , Rp          , Rp          , Gd          , Ha          , Aa^Fda      , Ha          , Ha^Fda      , Ha^Fda      , Ha^Fda      , Ha^Fda      , Ha          , Ha          , Cha         , Ha^Fda      , Ha^Fda      
Dd          , Dd          , Dd          , Dd          , Cd          , Dd^Ftd      , Dd^Ftd      , Dd          , Dd          , Rd          , Dd          , Dd          , Dd^Ftd      , Dd          , Dd          , Dd^Vda      , Rd          , Dd          , Cd          , Cd          , Dd          , Dd          , Dd          , Gd^Gvs      , Gd^Gvs      , Gd^Gvs      , Dd          , Dd          , Dd          , Dd          , Dd          , Dd          , Dd          , Dd          , Dd          , Gd          , Gd          , Gd          , Ha          , Aa^Fda      , Ha          , Ha^Fda      , Ha^Fda      , Ha          , Ha^Fda      , Ha^Fda      , Aa^Fda      , Ha^Fda      , Ha^Fda      , Ha^Fda      
