border_size=1
usage=map

Ww          , Xu          , Xu          , Xu          , Xu          , Xu          , Qxu         , Xu          , Qxu         , Xu          , Xu          , Xu          , Ur          , Xu          , Xu          , Xu          , Ur          , Xu          , Qxu         , Xu          , Qxu         , Xu          , Xu          , Xu          , Xu          , Xu          , Xu          , Xu          , Xu          , Xu          , Xu          , Xu          , Xu          , Xu          , Xu          , Xu          , Xu          , Xu          , Xu          , Xu          , Xu          , Xu          , Xu          , Xu          , Xu          , Xu          
Ww          , Ww          , Wwf         , Wwf         , Xu          , Xu          , Qxu         , Qxu         , Qxu         , Xu          , Xu          , Xu          , Qxu         , Ur          , Qxu         , Uu^Vu       , Qxu         , Qxu         , Qxu         , Qxu         , Xu          , Xu          , Xu          , Xu          , Xu          , Xu          , Xu          , Xu          , Xu          , Xu          , Xu          , Xu          , Ql          , Xu          , Ql          , Xu          , Xu          , Xu          , Ql          , Xu          , Ur          , Xu          , Xu          , Xu          , Xu          , Xu          
Xu          , Xu          , Wwf         , Wwf         , Wwf         , Wwf         , Wwf         , Qxu         , Qxu         , Qxu         , Qxu         , Qxu         , Qxu         , Qxu         , Qxu         , Qxu         , Qxu         , Qxu         , Qxu         , Qxu         , Xu          , Xu          , Xu          , Xu          , Xu          , Xu          , Xu          , Xu          , Ql          , Ql          , Ql          , Ql          , Ql          , Ql          , Ql          , Ql          , Ql          , Ql          , Xu          , Ql          , Ur          , Ur          , Uu^Vu       , Xu          , Xu          , Xu          
Xu          , Xu          , Xu          , Wwf         , Wwf         , 1 Wwf       , Wwf         , Wwf         , Wwf         , Uu          , Uu          , Qxu         , Ur          , Qxu         , Uu^Vu       , Qxu         , Qxu         , Qxu         , Qxu         , Xu          , Xu          , Xu          , Xu          , Xu          , Xu          , Xu          , Ql          , Ql          , Ql          , Ql          , Ql          , Ql          , Ql          , Ql          , Ql          , Ql          , Ql          , Xu          , Ql          , Ql          , Ur          , Uu^Vu       , Ur          , Xu          , Xu          , Xu          
Xos         , Xos         , Xos         , Xu          , Xu          , Wwf         , Xu          , Wwf         , Xu          , Wwf         , Xu          , Uu          , Ur          , Ur          , Qxu         , Qxu^Bs\     , Ur          , Qxu         , Qxu         , Xu          , Ur          , Ur          , Ur          , Ur          , Uu          , Ql          , Ql          , Ql          , Ql          , Ql          , Ql          , Ql          , Ql          , Ql          , Xu          , Ql          , Ql          , Ql          , Ql          , Ql          , Ql          , Ur          , Ur          , Xu          , Xu          , Xu          
Xos         , Xos         , Xos         , Xos         , Xu          , Xu          , Xu          , Xu          , Xu          , Xu          , Xu          , Xu          , Qxu         , Qxu         , Qxu         , Qxu         , Qxu         , Qxu^Bs\     , Uu          , Uu          , Ur          , Uu          , Uu          , Ur          , Uu          , Ur          , Ql^Bs\      , Ql          , Qlf         , Ql          , Ql          , Ql          , Ql          , Ql          , Ql          , Xu          , Ql          , Ql          , Ql          , Ql          , Ql          , Ur          , Ur          , Uu^Vu       , Xu          , Xu          
Xos         , Xos         , Xos         , Xos         , Xos         , Xu          , Xu          , Xu          , Xu          , Xu          , Xu          , Xu          , Qxu         , Qxu         , Qxu         , Qxu         , Qxu         , Qxu         , Xu          , Ur          , Uu          , Uu^Vu       , Uu          , Uu          , Ur          , Ql          , Ql          , Ur          , Qlf         , Qlf         , Ql          , Ql          , Ql          , Ql          , Xu          , Ql          , Ql          , Ql          , Ql          , Ql          , Ql          , Xu          , Ur          , Ur          , Xu          , Xu          
Xos         , Xos         , Xos         , Xos         , Xos         , Xos         , Xos         , Xos         , Xos         , Xu          , Xu          , Xu          , Qxu         , Qxu         , Qxu         , Qxu         , Xu          , Xu          , Xu          , Uu          , Xu          , Xu          , Xu          , Uu          , Ql          , Ql          , Ql          , Ur          , Uu^Vu       , Qlf         , Qlf         , Ql          , Ql          , Ql          , Xu          , Xu          , Xu          , Ql          , Xu          , Ql          , Ql          , Xu          , Uu^Vu       , Ur          , Xu          , Xu          
Xos         , Xos         , Xos         , Xos         , Xos         , Xos         , Xos         , Xos         , Xos         , Xos         , Xu          , Xu          , Xu          , Qxu         , Xu          , Xu          , Xos         , Xos         , Xos         , Xu          , Xu          , Xu          , Ql          , Ql          , Ql          , Ql          , Ql          , Ur          , Ur          , Qlf         , Qlf         , Qlf         , Ql          , Ql          , Ql          , Xu          , Ql          , Ql          , Ql          , Ql          , Ql          , Xu          , Xu          , Xu          , Ur          , Xu          
Xos         , Xos         , Xos         , Xos         , Rr          , Xos         , Uu^Vud      , Xos         , Xos         , Xos         , Xos         , Xu          , Xu          , Xu          , Xos         , Xos         , Xos         , Xos         , Xos         , Xos         , Xu          , Ql          , Ql          , Ql          , Ql          , Ql          , Ql          , Ql          , Ur          , Qlf         , Qlf         , Qlf         , Ql          , Ql          , Ql          , Ql          , Xu          , Ql          , Ql          , Ql          , Ql          , Ql          , Ql          , Ql          , Ql          , Ur          
Xos         , Xos         , Xos         , Xos         , Xos         , Rr          , Rr^Ii       , Rr          , Rr          , Xos         , Xos         , Xos         , Xos         , Xos         , Xos         , Xos         , Rr^Ii       , Rr          , Xos         , Xos         , Xu          , Ql          , Ql          , Ql          , Ql          , Ql          , Ql          , Ql          , Ur          , Ur          , Ql          , Ql          , Ql          , Ql          , Xu          , Xu          , Ql          , Xu          , Ql          , Ql          , Ql          , Ql          , Ql          , Ql          , Ql          , Ur          
Xos         , Xos         , Xos         , Xos         , Xos         , Rr          , Rr^Ii       , Rr          , Xos         , Xos         , Xos         , Xos         , Xos         , Xos         , Rr          , Rr          , Rr          , Xos         , Xos         , Xos         , Xu          , Ql          , Ql          , Ql          , Uu^Vu       , Ql          , Ql          , Ql          , Ql          , Ur          , Ql          , Ql          , Ql          , Ql          , Xu          , Ql          , Ql          , Ql          , Xu          , Ql          , Xu          , Xu          , Xu          , Ql          , Xu          , Ql          
Xos         , Xos         , Xos         , Xos         , Xos         , Rr          , Rr^Ii       , Rr^Ii       , Rr          , Xos         , Rr          , Xos         , Xos         , Xos         , Rr          , Rr^Ii       , Rr^Ii       , Rr          , Uu^Vud      , Xos         , Xos         , Xu          , Ql          , Uh          , Ur          , Ql          , Ql          , Ql          , Ql          , Ql^Bs|      , Ql          , Ql          , Ql          , Ql          , Xu          , Xu          , Xu          , Xu          , Xu          , Xu          , Ur          , Ur          , Ur          , Xu          , Xu          , Xu          
Xos         , Xos         , Xos         , Xos         , Rr          , Rr          , Rr          , Rr^Ii       , Rr          , Rr          , Rr          , Rr          , Xos         , Xos         , Rr          , Rr          , Rr          , Rr          , Rr          , Xos         , Xos         , Xu          , Qlf         , Ql          , Ql^Bs|      , Ql          , Ql          , Ql          , Ur          , Ur          , Uu^Vu       , Ql          , Ql          , Ql          , Xu          , Xu          , Uh          , Uu^Vu       , Ur          , Uu          , Xu          , Uu          , Xu          , Ur          , Xu          , Xu          
Xos         , Xos         , Xos         , Xos         , Xos         , Xos         , Rr          , Rr^Ii       , Xos         , Xos         , Xos         , Xos         , Rr          , Xos         , Rr          , Xos         , Uu^Vud      , Xos         , Xos         , Xos         , Xu          , Xu          , Qlf         , Qlf         , Ur          , Qlf         , Qlf         , Ql          , Ur          , Ur          , Uu^Uf       , Uu^Uf       , Uu^Uf       , Xu          , Ur          , Uh          , Ql          , Ql          , Ql          , Ur          , Ur          , Xu          , Xu          , Ur          , Xu          , Xu          
Xos         , Xos         , Xos         , Xos         , Rr          , Rr          , Rr^Ii       , Rr          , Rr          , Rr          , Rr          , Rr          , Rr^Ii       , Rr          , Rr          , Rr          , Rr          , Xos         , Xos         , Xos         , Xu          , Qlf         , Qlf         , Qlf         , Ur          , Ur          , Ur          , Qlf         , Ur          , Ur          , Uu^Uf       , Uu^Uf       , Uu^Uf       , Uu^Uf       , Xu          , Ql          , Ql          , Ql          , Ur          , Ur          , Xu          , Xu          , Xu          , Ur          , Uu^Vu       , Xu          
Xos         , Xos         , Xos         , Rr          , Rr          , Rr          , Xos         , Xos         , Xos         , Rr          , Uu^Vud      , Rr          , Rr          , Rr          , Rr          , Rr          , Rr          , Rr          , Rr          , Xos         , Xos         , Xos         , Rr          , Qlf         , Qlf         , Ur          , Ur          , Ur          , Ur          , Ur          , Ql          , Uu^Uf       , Xu          , Uu^Uf       , Ql^Bs\      , Ql          , Xu          , Ql          , Ql          , Ur          , Xu          , Xu          , Xu          , Ur          , Uu          , Xu          
Xos         , Xos         , Xos         , Rr          , Rr          , Xos         , Xos         , Xos         , Xos         , Rr          , Rr^Ii       , Rr          , Rr          , Rr          , Rr          , Rr          , Rr          , Rr          , Rr          , Rr          , Rr          , Rr          , Rr          , Qlf         , Qlf         , Qlf         , Xu          , Ur          , Ur          , Ql          , Xu          , Ql          , Ql          , Ql          , Ql          , Ur          , Ur          , Ql          , Ur          , Uh          , Xu          , Xu          , Ur          , Ur          , Xu          , Xu          
Xos         , Xos         , Rr          , Rr          , Rr          , Rr          , Rr          , Xos         , Rr^Ii       , Rr          , Rr          , Rr          , Rr          , Rr          , Rr          , Rr          , Ch          , Ch          , Xos         , Xos         , Xos         , Xos         , Xu          , Ur          , Ur          , Qlf         , Ql          , Xu          , Xu          , Xu          , Xu          , Ql          , Xu          , Ql          , Ql          , Uu^Vu       , Qlf         , Ql^Bs\      , Uu          , Xu          , Xu          , Xu          , Ur          , Ur          , Xu          , Xu          
Xos         , Xos         , Rr          , Uu^Vud      , Rr          , Rr          , Rr          , Rr^Ii       , Rr^Ii       , Rr          , Xos         , Rr          , Rr^Ii       , Rr          , Rr          , Rr          , Ch          , Kud         , Xos         , Xos         , Xos         , Xos         , Xos         , Xu          , Ur          , Ur          , Ql          , Xu          , Xu          , Xu          , Xu          , Xu          , Ql          , Ql          , Ql          , Ql          , Qlf         , Ur          , Xu          , Xu          , Ql^Bs/      , Uu^Vu       , Xu          , Xu          , Xu          , Xu          
Xos         , Xos         , Rr          , Xos         , Xos         , Rr          , Xos         , Rr^Ii       , Rr^Ii       , Rr^Ii       , Xos         , Rr^Ii       , Rr^Ii       , Xos         , Rr          , Ch          , Xos         , Xos         , Xos         , Xos         , Xos         , Xos         , Xu          , Xu          , Ur          , Ql          , Ql          , Ql          , Ql          , Xu          , Ql          , Ql          , Ql          , Ql          , Ql          , Ql          , Ql          , Ur          , Xu          , Ur          , Ql          , Ql          , Ql          , Xu          , Xu          , Xu          
Xos         , Xos         , Rr          , Xos         , Uu^Vud      , Xos         , Xos         , Xos         , Xos         , Rr          , Xos         , Rr          , Rr          , Xos         , Xos         , Xos         , Xos         , Xos         , Xos         , Xos         , Xos         , Xos         , Xos         , Xu          , Uu          , Ql          , Ql          , Ql          , Ql          , Ql          , Ql          , Ql          , Qlf         , Ql          , Ql          , Ql          , Ql          , Ql          , Xu          , Ql^Bs|      , Ql          , Ql          , Ql          , Xu          , Xu          , Xu          
Xos         , Xos         , Rr          , Rr          , Rr          , Xos         , Rr          , Xos         , Rr          , Rr          , Rr          , Rr          , Rr^Ii       , Xos         , Xos         , Xos         , Xos         , Xos         , Rr          , Xos         , Xos         , Xos         , Xos         , Xu          , Xu          , Uu          , Uu          , Ql          , Xu          , Ql          , Ql          , Ql          , Qlf         , Qlf         , Qlf         , Ql          , Ql          , Ql          , Ur          , Uh          , Ql          , Ql          , Ql          , Ql          , Xu          , Xu          
Xos         , Xos         , Xos         , Rr          , Rr          , Rr          , Xos         , Rr          , Rr          , Xos         , Rr^Ii       , Rr^Ii       , Rr^Ii       , Rr          , Xos         , Xos         , Rr          , Rr          , Xos         , Rr          , Xos         , Xos         , Xos         , Xu          , Xu          , Xu          , Xu          , Ur          , Ur          , Qlf         , Qlf         , Qlf         , Qlf         , Qlf         , Qlf         , Ql          , Ql^Bs/      , Ur          , Ql          , Ql          , Ql          , Ql          , Ql          , Xu          , Xu          , Xu          
Xos         , Xos         , Xos         , Xos         , Rr^Ii       , Rr          , Rr          , Xos         , Rr          , Rr          , Rr^Ii       , Rr          , Rr          , Rr^Ii       , Rr          , Rr          , Rr          , Xos         , Rr^Ii       , Rr          , Xos         , Xos         , Xos         , Xos         , Xu          , Xu          , Xu          , Ur          , Ur          , Qlf         , Qlf         , Qlf         , Uh          , Qlf         , Uu          , Uh          , Uu^Vu       , Ql          , Ql          , Ql          , Xu          , Ql          , Ql          , Xu          , Xu          , Xu          
Xos         , Xos         , Rr          , Rr          , Rr^Ii       , Rr          , Rr          , Rr          , Rr^Ii       , Xos         , Rr^Ii       , Xos         , Rr          , Xos         , Rr          , Rr          , Xos         , Rr^Ii       , Rr^Ii       , Rr^Ii       , Rr          , Xos         , Xos         , Xos         , Xu          , Xu          , Xu          , Uu^Vu       , Ur          , Xu          , Ur          , Uh          , Uh          , Ur          , Ur          , Ur          , Uh          , Xu          , Xu          , Xu          , Xu          , Xu          , Xu          , Xu          , Xu          , Xu          
Xos         , Xos         , Xos         , Rr^Ii       , Rr          , Xos         , Xos         , Rr^Ii       , Rr^Ii       , Rr^Ii       , Rr^Ii       , Rr          , Rr          , Rr          , Rr          , Uu^Vud      , Xos         , Xos         , Rr          , Xos         , Rr^Ii       , Uu^Vud      , Xos         , Xos         , Xos         , Xu          , Xu          , Xu          , Xu          , Ur          , Xu          , Ur          , Xu          , Ur          , Xu          , Uh          , Xu          , Xu          , Xu          , Xu          , Xos         , Xu          , Xu          , Xos         , Xos         , Xu          
Xos         , Xos         , Xos         , Xos         , Xos         , Rr          , Rr          , Uu^Vud      , Rr          , Rr^Ii       , Rr^Ii       , Rr          , Rr          , Xos         , Rr          , Rr          , Rr          , Rr          , Rr          , Rr          , Xos         , Rr          , Rr          , Rr          , Rr          , Xos         , Xos         , Xu          , Xos         , Xu          , Xos         , Xu          , Xos         , Xu          , Xos         , Xu          , Xos         , Xos         , Xos         , Xos         , Xos         , Xos         , Xos         , Xos         , Xos         , Xos         
Xos         , Xos         , Xos         , Xos         , Rr          , Rr          , Xos         , Rr          , Xos         , Rr^Ii       , Rr          , Xos         , Rr          , Rr          , Rr          , Rr^Ii       , Rr^Ii       , Xos         , Rr          , Xos         , Rr          , Rr          , Rr          , Xos         , Rr          , Xos         , Rr          , Xos         , Xos         , Xos         , Uu^Vud      , Xos         , Rr          , Xos         , Xos         , Xos         , Xos         , Xos         , Xos         , Xos         , Rr          , Rr          , Rr          , Rr          , Xos         , Xos         
Xos         , Xos         , Xos         , Xos         , Rr^Ii       , Xos         , Rr          , Rr          , Rr          , Rr          , Rr          , Rr          , Xos         , Rr          , Rr^Ii       , Rr          , Rr          , Rr^Ii       , Rr          , Rr          , Rr^Ii       , Rr^Ii       , Rr^Ii       , Rr          , Rr          , Rr          , Rr^Ii       , Rr          , Rr          , Rr          , Xos         , Rr          , Rr^Ii       , Rr          , Rr^Ii       , Rr          , Rr          , Rr          , Rr          , Rr          , Xos         , Rr          , Rr^Cov      , Rr^Cov      , Xos         , Xos         
Xos         , Xos         , Xos         , Rr          , Rr^Ii       , Rr          , Xos         , Rr          , Rr^Ii       , Xos         , Uu^Vud      , Rr^Ii       , Rr^Ii       , Rr^Ii       , Rr          , Xos         , Rr          , Rr          , Rr          , Rr^Ii       , Rr          , Rr          , Rr          , Rr^Ii       , Rr          , Rr^Ii       , Rr^Ii       , Rr          , Rr^Ii       , Rr          , Rr          , Rr          , Rr          , Rr          , Rr          , Rr^Ii       , Rr^Ii       , Rr^Ii       , Rr          , Rr          , Rr          , Rr          , Rr^Cov      , Rr^Cov      , 2 Rr^Kov    , Xos         
Xos         , Xos         , Xos         , Rr^Ii       , Rr^Ii       , Xos         , Xos         , Rr^Ii       , Xos         , Xos         , Rr          , Rr^Ii       , Rr          , Rr^Ii       , Xos         , Rr          , Xos         , Xos         , Rr^Ii       , Rr^Ii       , Xos         , Rr          , Xos         , Rr          , Rr          , Rr^Ii       , Rr^Ii       , Xos         , Rr          , Rr          , Xos         , Rr^Ii       , Rr^Ii       , Xos         , Rr^Ii       , Rr          , Rr^Ii       , Rr^Ii       , Rr^Ii       , Rr^Ii       , Rr          , Rr          , Rr^Cov      , Rr^Cov      , Xos         , Xos         
Xos         , Xos         , Xos         , Rr          , Rr          , Rr          , Rr          , Rr^Ii       , Rr          , Rr          , Xos         , Rr          , Rr          , Rr          , Rr          , Rr          , Rr          , Uu^Vud      , Rr          , Rr^Ii       , Rr^Ii       , Xos         , Rr          , Rr          , Uu^Vud      , Rr          , Xos         , Rr          , Rr          , Rr          , Rr          , Xos         , Rr          , Rr^Ii       , Rr^Ii       , Rr          , Rr          , Rr^Ii       , Rr          , Rr^Ii       , Rr          , Rr          , Rr          , Xos         , Rr          , Xos         
Xos         , Xos         , Xos         , Xos         , Xos         , Xos         , Xos         , Rr          , Rr          , Xos         , Xos         , Xos         , Xos         , Xos         , Xos         , Xos         , Xos         , Xos         , Xos         , Rr          , Xos         , Rr          , Xos         , Xos         , Xos         , Xos         , Xos         , Rr          , Xos         , Rr          , Xos         , Rr          , Xos         , Rr          , Xos         , Xos         , Xos         , Rr          , Xos         , Rr          , Xos         , Rr          , Xos         , Rr          , Rr          , Rr          
Xos         , Xos         , Xos         , Xos         , Xos         , Xos         , Xos         , Xos         , Xos         , Xos         , Xos         , Xos         , Xos         , Xos         , Xos         , Xos         , Xos         , Xos         , Xos         , Xos         , Xos         , Xos         , Xos         , Xos         , Xos         , Xos         , Xos         , Xos         , Xos         , Xos         , Xos         , Xos         , Xos         , Xos         , Xos         , Xos         , Xos         , Xos         , Xos         , Xos         , Xos         , Xos         , Xos         , Xos         , Xos         , Xos         
