border_size=1
usage=map

Xu          , Xu          , Xu          , Xu          , Xu          , Xu          , Xu          , Xu          , Xu          , Xu          , Xu          , Xu          , Xu          , Xu          , Xu          , Xu          , Xu          , Xu          , Xu          , Xu          , Xu          , Xu          , Xu          , Xu          , Xu          , Xu          , Xu          , Xu          , Xu          , Xu          , Xu          , Xu          , Xu          , Xu          , Xu          
Xu          , Xu          , Xu          , Xu          , Xu          , Xu          , Xu          , Xu          , Xu          , Xu          , Xu          , Xu          , Xu          , Xu          , Xu          , Xu          , Xu          , Xu          , Xu          , Xu          , Xu          , Xu          , Xu          , Xu          , Xu          , Xu          , Xu          , Xu          , Xu          , Xu          , Xu          , Xu          , Xu          , Xu          , Xu          
Xu          , Xu          , Xu          , Xu          , Xu          , Xu          , Xu          , Xu          , Xu          , Xu          , Xu          , Xu          , Xu          , Xu          , Xu          , Xu          , Xu          , Xu          , Ww          , Xu          , Xu          , Xu          , Ww          , Xu          , Ww          , Xu          , Xu          , Xu          , Xu          , Xu          , Xu          , Xu          , Xu          , Xu          , Xu          
Xu          , Xu          , Xu          , Xu          , Xu          , Xu          , Xu          , Xu          , Xu          , Xu          , Xu          , Xu          , Xu          , Xu          , Uu^Uf       , Xu          , Uu^Uf       , Xu          , Uh          , Ww          , Ww          , Ww          , Xu          , Ww          , Ww          , Uu^Uf       , Uu^Uf       , Ww          , Ww          , Xu          , Uu^Uf       , Xu          , Xu          , Xu          , Xu          
Xu          , Xu          , Xu          , Xu          , Xu          , Xu          , Xu          , Xu          , Xu          , Xu          , Uu^Uf       , Xu          , Uu          , Xu          , Uu^Uf       , Uu^Uf       , Uh          , Uh          , Uh          , Uh          , Uh          , Xu          , Uu^Uf       , Ww          , Xu          , Xu          , Xu          , Uu          , Uu^Uf       , Uh          , Uu^Uf       , Uu^Uf       , Uu^Uf       , Xu          , Xu          
Xu          , Xu          , Xu          , Xu          , Uh          , Xu          , Ur          , Uu          , Ur          , Xu          , Uu          , Uu^Uf       , Uu          , Uu^Uf       , Uu^Uf       , Uu^Uf       , Uu          , Uu          , Uu^Uf       , Uu          , Uu          , Uh          , Uu          , Uu          , Ur          , Uh          , Uu          , Uu          , Uh          , Uh          , Xu          , Uh          , Uh          , Xu          , Xu          
Ur          , Ur          , Ur          , Uh          , Ur          , Ur          , Uh          , Ur          , Uu          , Ur          , Ur          , Ur          , Ur          , Uu          , Ur          , Ur          , Ur          , Uu          , Uu          , Uu          , Uu          , Uu          , Ur          , Ur          , Uu          , Ur          , Ur          , Xu          , Uu          , Uh          , Uu          , Uu          , Ur          , Xu          , Xu          
Uh          , Xu          , Xu          , Ur          , Xu          , Xu          , Xu          , Uh          , Uh          , Uh          , Uu          , Uu          , Uu          , Ur          , Uu          , Uu          , Uu          , Ur          , Ur          , Uu          , Ur          , Ur          , Uu          , Uu          , Uu          , Uu          , Xu          , Ur          , Xu          , Uu          , Xu          , Ur          , Xu          , Ur          , Ur          
Xu          , Xu          , Xu          , Xu          , Xu          , Xu          , Xu          , Xu          , Xu          , Uu^Uf       , Uu^Uf       , Uu          , Uu          , Uu          , Uh          , Uu          , Uu          , Uu          , Uu          , 1 Ur        , Uu          , Uu          , Uu          , Uu          , Uu          , Uu          , Uu          , Ur          , Ur          , Ur          , Ur          , Ur          , Xu          , Xu          , Xu          
Xu          , Xu          , Xu          , Xu          , Xu          , Xu          , Xu          , Xu          , Xu          , Xu          , Uu^Uf       , Xu          , Xu          , Uu          , Uh          , Uu          , Uu          , Uu          , Uu          , Uu          , Uu          , Uu          , Uu          , Uu          , Uu          , Uu          , Uu          , Uh          , Uu          , Uh          , Xu          , Xu          , Xu          , Xu          , Xu          
Xu          , Xu          , Xu          , Xu          , Xu          , Xu          , Xu          , Xu          , Xu          , Xu          , Uu^Uf       , Uu^Uf       , Uu^Uf       , Uh          , Uu          , Uu          , Uu          , Uu          , Uu          , Uh          , Uu^Uf       , Uu^Uf       , Uu^Uf       , Uu          , Uu          , Uu          , Uh          , Uh          , Uu^Uf       , Uu^Uf       , Xu          , Xu          , Xu          , Xu          , Xu          
Xu          , Xu          , Xu          , Xu          , Xu          , Xu          , Xu          , Xu          , Xu          , Xu          , Uu^Uf       , Uu^Uf       , Uu^Uf       , Uu          , Uh          , Uu          , Uu          , Uu          , Uu          , Uh          , Uu          , Uu^Uf       , Uu          , Uu          , Uh          , Uu          , Uu^Uf       , Uh          , Xu          , Xu          , Xu          , Xu          , Xu          , Xu          , Xu          
Xu          , Xu          , Xu          , Xu          , Xu          , Xu          , Xu          , Xu          , Xu          , Xu          , Xu          , Uu^Uf       , Xu          , Uu^Uf       , Uu^Uf       , Uu          , Uh          , Uu          , Uu          , Uu          , Uu          , Uu          , Uh          , Uu          , Uu^Uf       , Uu^Uf       , Xu          , Xu          , Xu          , Xu          , Xu          , Xu          , Xu          , Xu          , Xu          
Xu          , Xu          , Xu          , Xu          , Xu          , Xu          , Xu          , Xu          , Xu          , Xu          , Xu          , Xu          , Xu          , Uu^Uf       , Uu^Uf       , Xu          , Uh          , Xu          , Uu^Uf       , Uh          , Uu          , Xu          , Uu^Uf       , Uu^Uf       , Xu          , Xu          , Xu          , Xu          , Xu          , Xu          , Xu          , Xu          , Xu          , Xu          , Xu          
Xu          , Xu          , Xu          , Xu          , Xu          , Xu          , Xu          , Xu          , Xu          , Xu          , Xu          , Xu          , Xu          , Xu          , Xu          , Uu^Uf       , Uu^Uf       , Uh          , Uu^Uf       , Uu^Uf       , Xu          , Uh          , Xu          , Uu^Uf       , Xu          , Xu          , Xu          , Xu          , Xu          , Xu          , Xu          , Xu          , Xu          , Xu          , Xu          
Xu          , Xu          , Xu          , Xu          , Xu          , Xu          , Xu          , Xu          , Xu          , Xu          , Xu          , Xu          , Xu          , Xu          , Xu          , Xu          , Xu          , Xu          , Xu          , Xu          , Xu          , Xu          , Xu          , Xu          , Xu          , Xu          , Xu          , Xu          , Xu          , Xu          , Xu          , Xu          , Xu          , Xu          , Xu          
Xu          , Xu          , Xu          , Xu          , Xu          , Xu          , Xu          , Xu          , Xu          , Xu          , Xu          , Xu          , Xu          , Xu          , Xu          , Xu          , Xu          , Xu          , Xu          , Xu          , Xu          , Xu          , Xu          , Xu          , Xu          , Xu          , Xu          , Xu          , Xu          , Xu          , Xu          , Xu          , Xu          , Xu          , Xu          
