border_size=1
usage=map

Qxua        , Qxua        , Qxua        , Qxua        , Qxua        , Qxua        , Qxua        , Qxua        , Qxua        , Qxua        , Qxua        , Qxua        , Qxua        , Qxua        , Qxua        , Qxua        , Qxua        , Qxua        , Qxua        , Qxua        , Qxua        , Qxua        , Qxua        , Qxua        , Qxua        , Qxua        , Qxua        , Qxua        , Qxua        , Qxua        , Qxua        , Qxua        , Qxua        , Qxua        , Qxua        , Zwsl        , Zwsl        , Zwsl        , Zwsl        , Zwsl        , Zwsl        , Zwsl        , Zwsl        , Zwsl        , Zwsl        , Zwsl        
Qxua        , Qxua        , Qxua        , Qxua        , Qxua        , Qxua        , Qxua        , Qxua        , Qxua        , Qxua        , Qxua        , Qxua        , Qxua        , Qxua        , Qxua        , Qxua        , Qxua        , Qxua        , Qxua        , Qxua        , Qxua        , Qxua        , Qxua        , Qxua        , Qxua        , Qxua        , Qxua        , Qxua        , Qxua        , Qxua        , Qxua        , Qxua        , Qxua        , Qxua        , Qxua        , Zwsl        , Zwsl        , Zwsl        , Zwsl        , Zwsl        , Zwsl        , Zwsl        , Zwsl        , Zwsl        , Zwsl        , Zwsl        
Qxua        , Qxua        , Qxua        , Qxua        , Qxua        , Qxua        , Qxua        , Qxua        , Qxua        , Qxua        , Qxua        , Qxua        , Qxua        , Qxua        , Qxua        , Qxua        , Qxua        , Qxua        , Qxua        , Qxua        , Qxua        , Qxua        , Qxua        , Qxua        , Qxua        , Qxua        , Qxua        , Qxua        , Qxua        , Qxua        , Qxua        , Qxua        , Qxua        , Qxua        , Zwsl        , Zwsl        , Zwsl        , Zwsl        , 1 Zwsl      , Zwsl        , Zwsl        , Zwsl        , Zwsl        , Zwsl        , Qxua        , Zwsl        
Qxua        , Qxua        , Qxua        , Qxua        , Qxua        , Qxua        , Qxua        , Qxua        , Qxua        , Qxua        , Qxua        , Qxua        , Qxua        , Qxua        , Qxua        , Qxua        , Qxua        , Qxua        , Qxua        , Qxua        , Qxua        , Qxua        , Qxua        , Qxua        , Qxua        , Qxua        , Qxua        , Qxua        , Qxua        , Qxua        , Qxua        , Qxua        , Zwsl        , Zwsl        , Zwsl        , Zwsl        , Zwsl        , Zwsl        , Zwsl        , Zwsl        , Zwsl        , Zwsl        , Qxua        , Qxua        , Qxua        , Qxua        
Qxua        , Qxua        , Qxua        , Qxua        , Qxua        , Qxua        , Qxua        , Qxua        , Qxua        , Qxua        , Qxua        , Qxua        , Qxua        , Qxua        , Qxua        , Qxua        , Qxua        , Qxua        , Qxua        , Qxua        , Qxua        , Qxua        , Qxua        , Qxua        , Qxua        , Qxua        , Qxua        , Qxua        , Qxua        , Qxua        , Zwsl        , Zwsl        , Zwsl        , Zwsl        , Zwsl        , Zwsl        , Zvw         , Zwsl        , Zwsl        , Zwsl        , Zwsl        , Zwsl        , Qxua        , Qxua        , Qxua        , Qxua        
Qxua        , Qxua        , Qxua        , Qxua        , Qxua        , Qxua        , Qxua        , Qxua        , Qxua        , Qxua        , Qxua        , Qxua        , Qxua        , Qxua        , Qxua        , Qxua        , Qxua        , Qxua        , Qxua        , Qxua        , Qxua        , Qxua        , Qxua        , Qxua        , Qxua        , Qxua        , Qxua        , Qxua        , Zwsl        , Zwsl        , Zvw         , Zwsl        , Zwsl        , Zwsl        , Zwsl        , Zvw         , Zwsl        , Zwsl        , Zwsl        , Zwsl        , Qxua        , Qxua        , Qxua        , Qxua        , Qxua        , Qxua        
Qxua        , Qxua        , Qxua        , Qxua        , Qxua        , Qxua        , Qxua        , Qxua        , Qxua        , Qxua        , Qxua        , Qxua        , Qxua        , Qxua        , Qxua        , Qxua        , Qxua        , Qxua        , Zwsl        , Qxua        , Qxua        , Qxua        , Qxua        , Qxua        , Qxua        , Qxua        , Zwsl        , Zwsl        , Zvw         , Zwsl        , Zwsl        , Zwsl        , Zvw         , Zwsl        , Zwsl        , Zwsl        , Zwsl        , Zwsl        , Zwsl        , Qxua        , Qxua        , Qxua        , Qxua        , Qxua        , Qxua        , Qxua        
Qxua        , Qxua        , Qxua        , Qxua        , Qxua        , Qxua        , Qxua        , Qxua        , Qxua        , Qxua        , Qxua        , Qxua        , Qxua        , Qxua        , Qxua        , Qxua        , Zwsl        , Zwsl        , Zwsl        , Zwsl        , Zwsl        , Qxua        , Chr         , Chr         , Chr         , Zwsl        , Zwsl        , Zwsl        , Zvw         , Zwsl^Vzps    , Zwsl        , Zwsl        , Zwsl        , Zwsl        , Zvw         , Zwsl        , Zwsl        , Zwsl        , Qxua        , Qxua        , Qxua        , Qxua        , Qxua        , Qxua        , Qxua        , Qxua        
Qxua        , Qxua        , Qxua        , Qxua        , Qxua        , Qxua        , Qxua        , Qxua        , Qxua        , Qxua        , Qxua        , Qxua        , Qxua        , Qxua        , Zwsl        , Zwsl        , Zwsl        , Zvw         , Zwsl        , Zwsl        , Zwsl        , Zwsl        , Chr         , 4 Khr       , Chr         , Chr         , Zwsl        , Zvw         , Zwsl        , Zwsl        , Zvw         , Zvw         , Zwsl        , Zwsl        , Zwsl        , Zwsl        , Zwsl        , Qxua        , Qxua        , Qxua        , Qxua        , Qxua        , Qxua        , Qxua        , Qxua        , Qxua        
Qxua        , Qxua        , Qxua        , Qxua        , Qxua        , Qxua        , Qxua        , Qxua        , Qxua        , Qxua        , Zwsl        , Qxua        , Zwsl        , Zwsl        , Zwsl        , Zwsl        , Zwsl        , Zvw         , Zvw         , Zwsl        , Zwsl        , Zwsl        , Zwsl        , Chr         , Chr         , Chr         , Chr         , Zwsl        , Zwsl        , Zvw         , Zwsl        , Zwsl        , Zwsl        , Zwsl        , Zwsl        , Zwsl        , Qxua        , Qxua        , Qxua        , Qxua        , Qxua        , Qxua        , Qxua        , Qxua        , Qxua        , Qxua        
Qxua        , Qxua        , Qxua        , Qxua        , Qxua        , Qxua        , Qxua        , Qxua        , Zwsl        , Zwsl        , Zwsl        , Zwsl        , Zwsl        , Zwsl        , Zwsl        , Zwsl        , Zvw         , Zvw         , Zvw         , Zwsl        , Zwsl        , Zwsl        , Zwsl        , Zwsl        , Zwsl        , Chr         , Zwsl        , Zvw         , Zvw         , Zwsl        , Chr         , Zwsl        , Chr         , Zwsl        , Qxua        , Qxua        , Qxua        , Qxua        , Qxua        , Qxua        , Qxua        , Qxua        , Qxua        , Qxua        , Qxua        , Qxua        
Qxua        , Qxua        , Qxua        , Qxua        , Qxua        , Qxua        , Qxua        , Qxua        , Zwsl        , Zwsl        , Zwsl        , Zwsl        , Zwsl        , Zwsl        , Zvw         , Zvw         , Zvw         , Zwsl^Vzps    , Zwsl        , Zvw         , Zvw         , Zwsl        , Zwsl        , Zwsl        , Zvw         , Zvw         , Zvw         , Zvw         , Chr         , Chr         , Chr         , Chr         , Chr         , Chr         , Qxua        , Qxua        , Qxua        , Qxua        , Qxua        , Qxua        , Qxua        , Qxua        , Qxua        , Qxua        , Qxua        , Qxua        
Qxua        , Qxua        , Qxua        , Qxua        , Qxua        , Qxua        , Zwsl        , Zwsl        , Zwsl        , Zwsl        , Zvw         , Zwsl        , Zwsl        , Zwsl        , Zvw         , Zvw         , Zwsl        , Zwsl        , Zwsl        , Zwsl        , Zwsl        , Zvw         , Zvw         , Zvw         , Zvw         , Zvw^Vzps     , Zvw         , Zwsl        , Zwsl        , Chr         , Chr         , 3 Khr       , Chr         , Qxua        , Qxua        , Qxua        , Qxua        , Qxua        , Qxua        , Qxua        , Qxua        , Qxua        , Qxua        , Qxua        , Qxua        , Qxua        
Qxua        , Qxua        , Qxua        , Qxua        , Qxua        , Zwsl        , Zwsl        , Zwsl        , Zwsl        , Zvw         , Zvw         , Zvw         , Zvw         , Zvw         , Zvw         , Zvw         , Zwsl        , Zwsl        , Zwsl        , Zwsl        , Zwsl        , Zwsl        , Zwsl        , Zwsl        , Zwsl        , Zvw         , Zvw         , Zwsl        , Zwsl        , Zwsl        , Zwsl        , Chr         , Zwsl        , Qxua        , Qxua        , Qxua        , Qxua        , Qxua        , Qxua        , Qxua        , Qxua        , Qxua        , Qxua        , Qxua        , Qxua        , Qxua        
Qxua        , Qxua        , Qxua        , Qxua        , Zwsl        , Zwsl        , Zwsl        , Zwsl        , Zwsl        , Zvw^Vzps     , Zvw         , Zvw         , Zwsl        , Zvw         , Zwsl        , Zvw         , Zwsl        , Zwsl        , Cud         , Zwsl        , Cud         , Zwsl        , Zwsl        , Zwsl        , Zwsl        , Zwsl        , Zwsl        , Zvw         , Zvw         , Zwsl        , Zwsl        , Zwsl        , Zwsl        , Qxua        , Qxua        , Qxua        , Qxua        , Qxua        , Qxua        , Qxua        , Qxua        , Qxua        , Qxua        , Qxua        , Qxua        , Qxua        
Qxua        , Qxua        , Qxua        , Zwsl        , Zwsl        , Zwsl        , Zwsl        , Zwsl        , Zvw         , Zvw         , Zwsl        , Zwsl        , Zwsl        , Zwsl        , Zwsl        , Zwsl        , Zwsl        , Cud         , Cud         , Cud         , Cud         , Cud         , Cud         , Cud         , Cud         , Zwsl        , Zwsl        , Zwsl        , Zvw         , Zvw^Vzps     , Zwsl        , Zwsl        , Zwsl        , Qxua        , Qxua        , Qxua        , Qxua        , Qxua        , Qxua        , Qxua        , Qxua        , Qxua        , Qxua        , Qxua        , Qxua        , Qxua        
Qxua        , Qxua        , Qxua        , Qxua        , Zwsl        , Zwsl        , Zvw         , Zvw         , Zwsl        , Zwsl        , Cud         , Cud         , Cud         , Cud         , Xuc         , Zwsl        , Xuc         , Cud         , Xuc         , Xuc         , Xuc         , 5 Kud       , Xuc         , Cud         , Cud         , Zwsl        , Zwsl        , Zvw         , Zvw         , Zvw         , Zvw         , Zwsl        , Zwsl        , Zwsl        , Qxua        , Qxua        , Qxua        , Qxua        , Qxua        , Qxua        , Qxua        , Qxua        , Qxua        , Qxua        , Qxua        , Qxua        
Qxua        , Qxua        , Qxua        , Qxua        , Zwsl        , Zwsl^Vzps    , Zvw         , Zwsl        , Zwsl        , Zwsl        , Cud         , Cud         , 8 Kud       , Xuc         , Xos         , Xuc         , Xos         , Xuc         , Xos         , Xos         , Xos         , Xuc         , Xos         , Xuc         , Xuc         , Cud         , Cud         , Zvw         , Zvw         , Zwsl        , Zvw         , Zwsl        , Zwsl        , Zwsl        , Zwsl        , Qxua        , Qxua        , Qxua        , Qxua        , Qxua        , Qxua        , Qxua        , Qxua        , Qxua        , Qxua        , Qxua        
Qxua        , Qxua        , Qxua        , Qxua        , Zwsl        , Zvw         , Zvw         , Zwsl        , Zwsl        , Zwsl        , Cud         , Cud         , Xuc         , Xuc         , Xos         , Xol         , Xol         , Xol         , Xol         , Xol         , Xol         , Xol         , Xol         , Xol         , Xos         , Xuc         , Zwsl        , Zwsl        , Zvw^Vzps     , Zvw         , Zvw         , Zwsl        , Zwsl        , Zwsl        , Zwsl        , Qxua        , Qxua        , Qxua        , Qxua        , Qxua        , Qxua        , Qxua        , Qxua        , Qxua        , Qxua        , Qxua        
Qxua        , Qxua        , Qxua        , Qxua        , Zwsl        , Zwsl        , Zwsl        , Zvw         , Zwsl        , Zwsl        , Cud         , Cud         , Xuc         , Xos         , Xos         , Xol         , Urb         , Urb         , Urb         , Xol         , Urb         , Urb         , Urb         , Xol         , Xos         , Xuc         , Zwsl        , Zvw         , Zvw         , Zwsl        , Zvw         , Zvw         , Zvw         , Zwsl        , Zwsl        , Zwsl        , Qxua        , Qxua        , Qxua        , Qxua        , Qxua        , Qxua        , Qxua        , Qxua        , Qxua        , Qxua        
Qxua        , Qxua        , Qxua        , Zwsl        , Zwsl        , Zwsl        , Zwsl        , Zvw         , Zvw         , Zwsl        , Zwsl        , Cud         , Xuc         , Xos         , Xos         , Xol         , Urb         , Xol         , Xol         , Xol         , Urb         , Xol         , Urb         , Xol         , Xos         , Xuc         , Cud         , Zwsl        , Zvw         , Zvw         , Zwsl        , Zvw         , Zvw^Vzps     , Zwsl        , Zwsl        , Zwsl        , Qxua        , Qxua        , Qxua        , Qxua        , Qxua        , Qxua        , Qxua        , Qxua        , Qxua        , Qxua        
Qxua        , Qxua        , Qxua        , Qxua        , Zwsl        , Zwsl        , Zvw         , Zvw         , Zwsl        , Zwsl        , Zwsl        , Xuc         , Xuc         , Xos         , Xos         , Xol         , Urb         , Xol         , Urb         , Urb         , Xol         , Xol         , Urb         , Xol         , Xos         , Xuc         , Cud         , Zwsl        , Zwsl        , Zwsl        , Zwsl        , Zvw         , Zvw         , Zvw         , Zwsl        , Zwsl        , Qxua        , Qxua        , Qxua        , Qxua        , Qxua        , Qxua        , Qxua        , Qxua        , Qxua        , Qxua        
Qxua        , Qxua        , Qxua        , Qxua        , Zwsl        , Zvw         , Zvw^Vzps     , Zvw         , Zvw         , Zwsl        , Zwsl        , Cud         , Xuc         , Xos         , Xos         , Xol         , Urb         , Urb         , Urb         , Xol         , Urb         , Urb         , Urb         , Xol         , Xuc         , Xuc         , Cud         , Cud         , Zwsl        , Zwsl        , Zwsl        , Zvw         , Zvw         , Zwsl        , Zwsl        , Zwsl        , Qxua        , Qxua        , Qxua        , Qxua        , Qxua        , Qxua        , Qxua        , Qxua        , Qxua        , Qxua        
Qxua        , Qxua        , Qxua        , Qxua        , Qxua        , Zwsl        , Zvw         , Zvw         , Zwsl        , Zvw         , Zvw         , Cud         , 7 Kud       , Xuc         , Xuc         , Xol         , Xol         , Xol         , Xol         , Xol         , Urb         , Xol         , Xol         , Xol         , Xuc         , 2 Kud       , Cud         , Zwsl        , Zwsl        , Zwsl        , Zvw         , Zwsl        , Zvw         , Zvw         , Zwsl        , Zwsl        , Qxua        , Qxua        , Qxua        , Qxua        , Qxua        , Qxua        , Qxua        , Qxua        , Qxua        , Qxua        
Qxua        , Qxua        , Qxua        , Qxua        , Qxua        , Zwsl        , Zwsl        , Zvw         , Zvw         , Zvw         , Zvw         , Cud         , Cud         , Xuc         , Cud         , Xuc         , Xuc         , Xos         , Xuc         , Xuc         , Zwsl        , Xuc         , Xuc         , Xuc         , Cud         , Cud         , Zwsl        , Zwsl        , Zvw         , Zvw         , Zwsl^Vzps    , Zvw         , Zwsl        , Zvw         , Zwsl        , Zwsl        , Zwsl        , Qxua        , Qxua        , Qxua        , Qxua        , Qxua        , Qxua        , Qxua        , Qxua        , Qxua        
Qxua        , Qxua        , Qxua        , Qxua        , Qxua        , Zwsl        , Zwsl        , Zwsl        , Zvw         , Zvw         , Zwsl        , Zwsl        , Cud         , Cud         , Cud         , Cud         , Zwsl        , Xuc         , Zwsl        , Zwsl        , Zwsl        , Cud         , Cud         , Cud         , Zwsl        , Zwsl        , Zvw         , Zvw         , Zwsl        , Zwsl        , Zwsl        , Zvw         , Zwsl        , Zvw         , Zwsl        , Zwsl        , Zwsl        , Qxua        , Qxua        , Qxua        , Qxua        , Qxua        , Qxua        , Qxua        , Qxua        , Qxua        
Qxua        , Qxua        , Qxua        , Qxua        , Qxua        , Zwsl        , Zwsl        , Zwsl        , Zvw         , Zwsl        , Zwsl        , Zwsl        , Zvw         , Zwsl        , Zwsl        , Zwsl        , Zwsl        , Zwsl        , Zwsl        , Zwsl        , Zwsl        , Zwsl        , Zwsl        , Zwsl        , Zwsl        , Zvw         , Zwsl        , Zwsl        , Cud         , Cud         , Cud         , Zwsl        , Zwsl        , Zvw         , Zwsl        , Zwsl        , Zwsl        , Qxua        , Qxua        , Qxua        , Qxua        , Qxua        , Qxua        , Qxua        , Qxua        , Qxua        
Qxua        , Qxua        , Qxua        , Qxua        , Qxua        , Qxua        , Zwsl        , Zwsl        , Zwsl        , Zvw         , Zwsl        , Zwsl        , Zwsl        , Zvw         , Zvw         , Zwsl        , Zvw         , Zwsl        , Zvw^Vzps     , Zvw         , Zvw         , Zwsl        , Zvw         , Zwsl        , Zvw         , Zwsl        , Zwsl        , Zwsl        , Cud         , 6 Kud       , Cud         , Zwsl        , Zwsl        , Zvw         , Zwsl        , Zwsl^Vzps    , Zwsl        , Qxua        , Qxua        , Qxua        , Qxua        , Qxua        , Qxua        , Qxua        , Qxua        , Qxua        
Qxua        , Qxua        , Qxua        , Qxua        , Qxua        , Qxua        , Qxua        , Zwsl        , Zwsl        , Qxua        , Qxua        , Qxua        , Qxua        , Qxua        , Qxua        , Zvw         , Zwsl        , Zvw         , Zwsl        , Zwsl        , Zwsl        , Zvw         , Zvw         , Zvw         , Zvw         , Zwsl^Vzps    , Zwsl        , Zwsl        , Zwsl        , Cud         , Zwsl        , Zwsl        , Zvw         , Zvw         , Zwsl        , Zwsl        , Zwsl        , Qxua        , Qxua        , Qxua        , Qxua        , Qxua        , Qxua        , Qxua        , Qxua        , Qxua        
Qxua        , Qxua        , Qxua        , Qxua        , Qxua        , Qxua        , Qxua        , Qxua        , Qxua        , Qxua        , Qxua        , Qxua        , Qxua        , Qxua        , Qxua        , Zwsl        , Qxua        , Zwsl        , Qxua        , Zvw         , Zvw         , Zvw         , Zvw         , Zvw         , Zvw         , Zvw         , Zwsl        , Zwsl        , Zwsl        , Zwsl        , Zvw         , Zvw         , Zwsl        , Zwsl        , Zwsl        , Zwsl        , Qxua        , Qxua        , Qxua        , Qxua        , Qxua        , Qxua        , Qxua        , Qxua        , Qxua        , Qxua        
Qxua        , Qxua        , Qxua        , Qxua        , Qxua        , Qxua        , Qxua        , Qxua        , Qxua        , Qxua        , Qxua        , Qxua        , Qxua        , Qxua        , Qxua        , Qxua        , Qxua        , Qxua        , Qxua        , Qxua        , Qxua        , Qxua        , Qxua        , Zwsl        , Zwsl        , Zvw         , Zvw         , Zvw         , Zvw         , Zvw         , Zwsl        , Zwsl        , Qxua        , Qxua        , Qxua        , Qxua^Bw\r   , Qxua^Bw\r   , Qxua        , Qxua        , Qxua        , Qxua        , Qxua        , Qxua        , Qxua        , Qxua        , Qxua        
Qxua        , Qxua        , Qxua        , Qxua        , Qxua        , Qxua        , Qxua        , Qxua        , Qxua        , Qxua        , Qxua        , Qxua        , Qxua        , Qxua        , Qxua        , Qxua        , Qxua        , Qxua        , Qxua        , Qxua        , Qxua        , Qxua        , Qxua        , Zwsl        , Qxua        , Zwsl        , Qxua        , Zwsl        , Qxua        , Zwsl        , Qxua        , Qxua        , Qxua        , Qxua        , Qxua        , Qxua        , Qxua        , Qxua^Bw\r   , Qxua^Bw\r   , Qxua        , Qxua        , Qxua        , Qxua        , Qxua        , Qxua        , Qxua        
Qxua        , Qxua        , Qxua        , Qxua        , Qxua        , Qxua        , Qxua        , Qxua        , Qxua        , Qxua        , Qxua        , Qxua        , Qxua        , Qxua        , Qxua        , Qxua        , Qxua        , Qxua        , Qxua        , Qxua        , Qxua        , Qxua        , Qxua        , Qxua        , Qxua        , Qxua        , Qxua        , Qxua        , Qxua        , Qxua        , Qxua        , Qxua        , Qxua        , Qxua        , Qxua        , Qxua        , Qxua        , Qxua        , Qxua        , Qxu         , Qxua        , Qxua        , Qxua        , Qxua        , Qxua        , Qxua        
Qxua        , Qxua        , Qxua        , Qxua        , Qxua        , Qxua        , Qxua        , Qxua        , Qxua        , Qxua        , Qxua        , Qxua        , Qxua        , Qxua        , Qxua        , Qxua        , Qxua        , Qxua        , Qxua        , Qxua        , Qxua        , Qxua        , Qxua        , Qxua        , Qxua        , Qxua        , Qxua        , Qxua        , Qxua        , Qxua        , Qxua        , Qxua        , Qxua        , Qxua        , Qxua        , Qxua        , Qxua        , Qxua        , Qxua        , Qxua        , Qxua        , Qxua        , Qxua        , Qxua        , Qxua        , Qxua        
Qxua        , Qxua        , Qxua        , Qxua        , Qxua        , Qxua        , Qxua        , Qxua        , Qxua        , Qxua        , Qxua        , Qxua        , Qxua        , Qxua        , Qxua        , Qxua        , Qxua        , Qxua        , Qxua        , Qxua        , Qxua        , Qxua        , Qxua        , Qxua        , Qxua        , Qxua        , Qxua        , Qxua        , Qxua        , Qxua        , Qxua        , Qxua        , Qxua        , Qxua        , Qxua        , Qxua        , Qxua        , Qxua        , Qxua        , Qxua        , Qxua        , Qxua        , Qxua        , Qxua        , Qxua        , Qxua        
