border_size=1
usage=map

Ai^Xo       , Ai^Xo       , Zaw         , Xos         , Xos         , Xos         , Xos         , Xos         , Xos         , Xos         , Xol         , Xol         , Xol         , Xol         , Xol         , Xol         , Xol         , Xol         , Xol         , Xol         , Xol         , Xol         , Xol         , Xol         , Xol         , Xol         , Xol         , Xol         , Xol         , Xol         , Urb         , Urb         , Urb         , Xol         , Xol         , Xol         , Xol         , Xol         , Xol         , Xol         , Xol         , Xol         , Xol         , Xol         , Xol         , Xol         
Ai^Xo       , Ai^Xo       , Zaw         , Xos         , Xos         , Xos         , Xos         , Xos         , Xos         , Xos         , Xol         , Xol         , Xol         , Xol         , Xol         , Xol         , Xol         , Xol         , Xol         , Xol         , Xol         , Xol         , Xol         , Xol         , Xol         , Xol         , Xol         , Xol         , Xol         , Xol         , Xol         , Urb         , Urb         , Urb         , Urb         , Xol         , Xol         , Xol         , Xol         , Xol         , Xol         , Xol         , Xol         , Xol         , Xol         , Xol         
Ai^Xo       , Ai^Xo       , Zaw         , Xos         , Xos         , Xos         , Xos         , Xos         , Xos         , Xol         , Xol         , Xol         , Xol         , Urb         , Urb         , Xol         , Xol         , Xol         , Xol         , Xol         , Xol         , Xol         , Urb         , Xol         , Xol         , Xol         , Xol         , Xol         , Xol         , Xol         , Xol         , Xol         , Xol         , Urb         , Xol         , Uu^Vu       , Xol         , Xol         , Xol         , Xol         , Xol         , Xol         , Xol         , Xol         , Xol         , Xol         
Ai^Xo       , Zaw         , Uu^Vu       , Xos         , Xos         , Xos         , Xos         , Xos         , Xol         , Xol         , Xol         , Xol         , Xol         , Urb         , Urb         , Xol         , Urb         , Xol         , Xol         , Xol         , Urb         , Urb         , Urb         , Xol         , Xol         , Xol         , Xol         , Xol         , Xol         , Xol         , Xol         , Xol         , Xol         , Urb         , Urb         , Urb         , Urb         , Xol         , Xol         , Xol         , Xol         , Xol         , Xol         , Xol         , Xol         , Xol         
Ai^Xo       , Zaw         , Zaw         , Zaw         , Zaw         , Xos         , Xos         , Xos         , Xol         , Xol         , Urb         , Xol         , Uu^Vu       , Urb         , Urb         , Urb         , Urb         , Urb         , Urb         , Urb         , Urb         , Urb         , Urb         , Xol         , Xol         , Xol         , Xol         , Xol         , Xol         , Xol         , Xol         , Xol         , Xol         , Urb         , Urb         , Xol         , Urb         , Xol         , Xol         , Xol         , Xol         , Xol         , Xol         , Xol         , Xol         , Xol         
Ai^Xo       , Zaw         , Xos         , Zaw         , Zaw         , Zaw         , Zaw         , Xol         , Urb         , Urb         , Urb         , Urb         , Urb         , Urb         , Urb         , Urb         , Urb         , Urb         , Urb         , Urb         , Xol         , Xol         , Urb         , Xol         , Xol         , Xol         , Xol         , Xol         , Xol         , Xol         , Xol         , Xol         , Xol         , Urb         , Xol         , Xol         , Urb         , Xol         , Xol         , Xol         , Xol         , Xol         , Xol         , Xol         , Xol         , Xol         
Zaw         , Zaw         , Xos         , Xos         , Xos         , Zaw         , Urb         , Urb         , Urb         , Urb         , Urb         , Urb         , 4 Urb       , Urb         , Urb         , Urb         , Urb         , Urb         , Xol         , Xol         , Xol         , Urb         , Urb         , Xol         , Xol         , Xol         , Xol         , Xol         , Xol         , Xol         , Xol         , Xol         , Xol         , Urb         , Urb         , Urb         , Urb         , Xol         , Xol         , Xol         , Xol         , Xol         , Xol         , Xol         , Xol         , Xol         
Zaw         , Xos         , Xos         , Xos         , Xos         , Xol         , Urb         , Urb         , Urb         , Urb         , Urb         , Urb         , Urb         , Urb         , Urb         , Urb         , Urb         , Urb         , Urb         , Xol         , Urb         , Urb         , Urb         , Xol         , Xol         , Xol         , Xol         , Xol         , Xol         , Xol         , Urb         , Urb         , Urb         , Urb         , Urb         , Urb         , Urb         , Xol         , Xol         , Xol         , Xol         , Xol         , Xol         , Xol         , Xol         , Xol         
Xos         , Xos         , Xos         , Xos         , Xol         , Xol         , Urb         , Urb         , Urb         , Urb         , Urb         , Urb         , Urb         , Urb         , Urb         , Urb         , Urb         , Urb         , Xol         , Xol         , Urb         , Urb         , Xol         , Xol         , Xol         , Xol         , Xol         , Xol         , Xol         , Xol         , Urb         , Urb         , 1 Urb       , Urb         , Xol         , Urb         , Xol         , Xol         , Xol         , Xol         , Xol         , Xol         , Xol         , Xol         , Xol         , Xol         
Xos         , Xos         , Xos         , Xol         , Xol         , Urb         , Urb         , Urb         , Urb         , Urb         , Xol         , Urb         , Urb         , Urb         , Urb         , Urb         , Urb         , Uu^Vu       , Xol         , Urb         , Urb         , Urb         , Xol         , Xol         , Xol         , Xol         , Xol         , Xol         , Xol         , Xol         , Urb         , Urb         , Urb         , Urb         , Urb         , Urb         , Urb         , Urb         , Xol         , Xol         , Xol         , Xol         , Xol         , Xol         , Xol         , Xol         
Xos         , Xos         , Xos         , Xol         , Xol         , Uu^Vu       , Xol         , Urb         , Xol         , Xol         , Xol         , Urb         , Urb         , Xol         , Xol         , Urb         , Xol         , Xol         , Xol         , Xol         , Xol         , Xol         , Xol         , Xol         , Xol         , Xol         , Xol         , Xol         , Xol         , Urb         , Xol         , Urb         , Urb         , Urb         , Urb         , Uu^Vu       , Xol         , Xol         , Xol         , Xol         , Xol         , Xol         , Xol         , Xol         , Xol         , Xol         
Xos         , Xos         , Xos         , Xol         , Xol         , Xol         , Xol         , Xol         , Xol         , Xol         , Xol         , Urb         , Urb         , Xol         , Xol         , Xol         , Xol         , Xol         , Xol         , Xol         , Xol         , Xol         , Xol         , Xol         , Xol         , Xol         , Xol         , Xol         , Xol         , Urb         , Urb         , Urb         , Urb         , Urb         , Urb         , Xol         , Xol         , Xol         , Xol         , Xol         , Xol         , Xol         , Xol         , Xol         , Xol         , Xol         
Xos         , Xos         , Xos         , Xos         , Xol         , Xol         , Xol         , Xol         , Xol         , Xol         , Xol         , _s          , _s          , Xol         , Xol         , Xol         , Xol         , Xol         , Xol         , Xol         , Xol         , Xol         , Xol         , Xol         , Xol         , Xol         , Xol         , Xol         , Urb         , Urb         , Urb         , Urb         , Xol         , Urb         , Urb         , Xol         , Xol         , Xol         , Xol         , Xol         , Xol         , Xol         , Xol         , Xol         , Xol         , Xol         
Xos         , Xos         , Xos         , Xos         , Xol         , Xol         , Xol         , Xol         , Xol         , Xol         , Urb         , Urb         , Urb         , Xol         , Xol         , Xol         , Xol         , Xol         , Xol         , Xol         , Xol         , Xol         , Xol         , Xol         , Xol         , Xol         , Xol         , Urb         , Urb         , Urb         , Urb         , Xol         , Urb         , Urb         , Xol         , Xol         , Xol         , Xol         , Xol         , Xol         , Xol         , Xol         , Xol         , Xol         , Xol         , Xol         
Xos         , Xos         , Xos         , Xos         , Xos         , Xol         , Xol         , Xol         , Uu^Vu       , Urb         , Urb         , Urb         , Urb         , Urb         , Urb         , Xol         , Urb         , Xol         , Xol         , Xol         , Xol         , Xol         , Xol         , Xol         , Xol         , Xol         , Urb         , Urb         , Urb         , Urb         , Urb         , Xol         , Urb         , Urb         , Xol         , Xol         , Xol         , Xol         , Xol         , Xol         , Xol         , Xol         , Xol         , Xol         , Xol         , Xol         
Xos         , Xos         , Xos         , Xos         , Zaw         , Urb         , Urb         , Urb         , Urb         , Urb         , Urb         , Urb         , Urb         , Urb         , Urb         , Urb         , Urb         , Xol         , Xol         , Xol         , Xol         , Xol         , Xol         , Xol         , Xol         , Urb         , Urb         , Urb         , Xol         , Urb         , Urb         , Urb         , Urb         , Urb         , Xol         , Xol         , Xol         , Xol         , Xol         , Xol         , Xol         , Xol         , Xol         , Xol         , Xol         , Xol         
Xos         , Xos         , Zaw         , Uu^Vu       , Zaw         , Urb         , Xol         , Urb         , Urb         , Urb         , Urb         , Urb         , Urb         , Urb         , Urb         , Urb         , Urb         , Uu^Vu       , Xol         , Xol         , Xol         , Xol         , Xol         , Xol         , Xol         , Cud         , Cud         , Urb         , Urb         , Urb         , Urb         , Xol         , Urb         , Urb         , Xol         , Xol         , Xol         , Xol         , Xol         , Xol         , Xol         , Xol         , Xol         , Xol         , Xol         , Xol         
Zaw         , Zaw         , Zaw         , Zaw         , Xos         , Xos         , Xol         , Xol         , Xol         , Uu^Vu       , Urb         , Urb         , Urb         , Urb         , Urb         , Urb         , Urb         , Urb         , Xol         , Xol         , Xol         , Xol         , Xol         , Xol         , Xol         , Cud         , 2 Kud       , Cud         , Cud         , Urb         , Urb         , Urb         , Xol         , Xol         , Xol         , Xol         , Xol         , Xol         , Xol         , Xol         , Xol         , Xol         , Xol         , Xol         , Xol         , Xol         
Ai^Xo       , Zaw         , Xos         , Xos         , Xos         , Xos         , Xos         , Xol         , Xol         , Urb         , Urb         , Urb         , Urb         , Urb         , Urb         , Urb         , Urb         , Urb         , Xol         , Xol         , Xol         , Xol         , Xol         , Xol         , Xol         , Xol         , Xol         , Cud         , Cud         , Xol         , Xol         , Xol         , Xol         , Xol         , Xol         , Xol         , Xol         , Xol         , Xol         , Xol         , Xol         , Xol         , Xol         , Xol         , Xol         , Xol         
Ai^Xo       , Zaw         , Xos         , Xos         , Xos         , Xos         , Zaw         , Xol         , Urb         , Urb         , Urb         , Urb         , Urb         , Urb         , 3 Urb       , Urb         , Urb         , Urb         , Urb         , Xol         , Xol         , Xol         , Xol         , Xol         , Xol         , Xol         , Xol         , Cud         , Urb         , Urb         , Urb         , Xol         , Xol         , Xol         , Xol         , Xol         , Xol         , Xol         , Xol         , Xol         , Xol         , Xol         , Xol         , Xol         , Xol         , Xol         
Ai^Xo       , Zaw         , Xos         , Xos         , Xos         , Zaw         , Zaw         , Zaw         , Urb         , Urb         , Urb         , Urb         , Urb         , Urb         , Urb         , Urb         , Urb         , Urb         , Urb         , Urb         , Xol         , Xol         , Xol         , Xol         , Xol         , Xol         , Xol         , Xol         , Uu^Vu       , Urb         , Urb         , Urb         , Urb         , Urb         , Urb         , Urb         , Urb         , Urb         , Urb         , Xol         , Xol         , Xol         , Xol         , Xol         , Xol         , Xol         
Ai^Xo       , Zaw         , Zaw         , Xos         , Zaw         , Zaw         , Zaw         , Zaw         , Xol         , Urb         , Urb         , Urb         , Urb         , Urb         , Urb         , Urb         , Urb         , Urb         , Urb         , Urb         , Urb         , Xol         , Xol         , Xol         , Urb         , Urb         , Urb         , Urb         , Urb         , Urb         , Urb         , Urb         , Urb         , Urb         , Urb         , Urb         , Urb         , Urb         , Xol         , Xol         , Xol         , Xol         , Xol         , Xol         , Xos         , Xos         
Ai^Xo       , Ai^Xo       , Zaw         , Zaw         , Zaw         , Uu^Vu       , Xos         , Xos         , Xol         , Xol         , Xol         , Uu^Vu       , Urb         , Urb         , Urb         , Urb         , Urb         , Urb         , Xol         , Urb         , Urb         , Urb         , Uu^Vu       , Xol         , Urb         , Urb         , Urb         , Urb         , Urb         , Urb         , Urb         , Urb         , Urb         , Urb         , Urb         , Urb         , Urb         , Urb         , Uu^Vu       , Xol         , Xol         , Xol         , Xos         , Xos         , Xos         , Xos         
Ai^Xo       , Ai^Xo       , Ai^Xo       , Zaw         , Xos         , Xos         , Xos         , Xos         , Xol         , Xol         , Xol         , Xol         , Xol         , Urb         , Urb         , Urb         , Xol         , Xol         , Xol         , Xol         , Xol         , Urb         , Urb         , Urb         , Urb         , Urb         , Urb         , Urb         , Urb         , Urb         , Urb         , Urb         , Urb         , Urb         , Urb         , Urb         , Urb         , Urb         , Xol         , Xol         , Xos         , Xos         , Xos         , Xos         , Xos         , Xos         
Ai^Xo       , Ai^Xo       , Ai^Xo       , Zaw         , Zaw         , Xos         , Xos         , Xos         , Xol         , Xol         , Xol         , Xol         , Urb         , Urb         , Xol         , Xol         , Xol         , Xol         , Xol         , Xol         , Xol         , Xol         , Urb         , Urb         , Urb         , Urb         , Urb         , Urb         , Urb         , Urb         , Urb         , Urb         , Urb         , Urb         , Xol         , Urb         , Urb         , Urb         , Zaw         , Xos         , Xos         , Xos         , Xos         , Xos         , Zaw         , Zaw         
Ai^Xo       , Ai^Xo       , Ai^Xo       , Ai^Xo       , Zaw         , Xos         , Xos         , Xos         , Xos         , Xol         , Xol         , Xol         , Urb         , Urb         , Xol         , Xol         , Xol         , Xol         , Xol         , Xol         , Xol         , Xol         , Xol         , Urb         , Urb         , Urb         , Urb         , Urb         , Urb         , Urb         , Urb         , Urb         , Urb         , Urb         , Xol         , Xol         , Xol         , Zaw         , Zaw         , Zaw         , Zaw         , Xos         , Xos         , Zaw         , Ai^Xo       , Ai^Xo       
Ai^Xo       , Ai^Xo       , Ai^Xo       , Ai^Xo       , Ai^Xo       , Zaw         , Xos         , Xos         , Xos         , Xos         , Xos         , Xol         , Urb         , Urb         , Xol         , Xol         , Xol         , Xol         , Xol         , Xol         , Xol         , Xol         , Xol         , Urb         , Urb         , Urb         , Urb         , Urb         , Urb         , Urb         , Urb         , Urb         , Urb         , Xol         , Xol         , Xol         , Xos         , Xos         , Xos         , Zaw         , Zaw         , Uu^Vu       , Zaw         , Zaw         , Ai^Xo       , Ai^Xo       
Ai^Xo       , Ai^Xo       , Ai^Xo       , Ai^Xo       , Ai^Xo       , Zaw         , Zaw         , Xos         , Xos         , Xos         , Xos         , Zaw         , Zaw         , Urb         , Xos         , Xol         , Xos         , Xol         , Xos         , Xol         , Xol         , Xol         , Xol         , Xol         , Urb         , Urb         , Urb         , Urb         , Urb         , Urb         , Urb         , Urb         , Xol         , Xol         , Xol         , Xol         , Xos         , Xos         , Xos         , Xos         , Zaw         , Zaw         , Ai^Xo       , Ai^Xo       , Ai^Xo       , Ai^Xo       
Ai^Xo       , Ai^Xo       , Ai^Xo       , Ai^Xo       , Ai^Xo       , Ai^Xo       , Ai^Xo       , Zaw         , Zaw         , Xos         , Xos         , Zaw         , Uu^Vu       , Xos         , Xos         , Xos         , Xos         , Xos         , Xos         , Xos         , Xos         , Xol         , Urb         , Urb         , Urb         , Urb         , Urb         , Urb         , Urb         , Uu^Vu       , Xol         , Xol         , Xol         , Xol         , Xos         , Xos         , Xos         , Xos         , Xos         , Xos         , Zaw         , Ai^Xo       , Ai^Xo       , Ai^Xo       , Ai^Xo       , Ai^Xo       
Ai^Xo       , Ai^Xo       , Ai^Xo       , Ai^Xo       , Ai^Xo       , Ai^Xo       , Ai^Xo       , Ai^Xo       , Ai^Xo       , Zaw         , Zaw         , Zaw         , Zaw         , Xos         , Xos         , Xos         , Xos         , Xos         , Xos         , Xos         , Xos         , Zaw         , Zaw         , Urb         , Xol         , Xol         , Xol         , Xol         , Xol         , Xol         , Xos         , Xol         , Xos         , Xos         , Xos         , Xos         , Xos         , Xos         , Zaw         , Zaw         , Ai^Xo       , Ai^Xo       , Ai^Xo       , Ai^Xo       , Ai^Xo       , Ai^Xo       
Ai^Xo       , Ai^Xo       , Ai^Xo       , Ai^Xo       , Ai^Xo       , Ai^Xo       , Ai^Xo       , Ai^Xo       , Ai^Xo       , Ai^Xo       , Ai^Xo       , Zaw         , Ai^Xo       , Zaw         , Zaw         , Xos         , Xos         , Xos         , Xos         , Xos         , Xos         , Zaw         , Zaw         , Xos         , Xos         , Xos         , Xos         , Xos         , Xos         , Xos         , Xos         , Xos         , Xos         , Xos         , Xos         , Xos         , Zaw         , Zaw         , Ai^Xo       , Ai^Xo       , Ai^Xo       , Ai^Xo       , Ai^Xo       , Ai^Xo       , Ai^Xo       , Ai^Xo       
Ai^Xo       , Ai^Xo       , Ai^Xo       , Ai^Xo       , Ai^Xo       , Ai^Xo       , Ai^Xo       , Ai^Xo       , Ai^Xo       , Ai^Xo       , Ai^Xo       , Ai^Xo       , Ai^Xo       , Ai^Xo       , Ai^Xo       , Zaw         , Zaw         , Xos         , Xos         , Xos         , Uu^Vu       , Zaw         , Zaw         , Xos         , Xos         , Xos         , Xos         , Xos         , Xos         , Xos         , Xos         , Xos         , Xos         , Xos         , Xos         , Zaw         , Ai^Xo       , Ai^Xo       , Ai^Xo       , Ai^Xo       , Ai^Xo       , Ai^Xo       , Ai^Xo       , Ai^Xo       , Ai^Xo       , Ai^Xo       
Ai^Xo       , Ai^Xo       , Ai^Xo       , Ai^Xo       , Ai^Xo       , Ai^Xo       , Ai^Xo       , Ai^Xo       , Ai^Xo       , Ai^Xo       , Ai^Xo       , Ai^Xo       , Ai^Xo       , Ai^Xo       , Ai^Xo       , Ai^Xo       , Ai^Xo       , Zaw         , Zaw         , Zaw         , Zaw         , Zaw         , Zaw         , Xos         , Xos         , Xos         , Xos         , Xos         , Xos         , Xos         , Xos         , Xos         , Xos         , Xos         , Zaw         , Zaw         , Ai^Xo       , Ai^Xo       , Ai^Xo       , Ai^Xo       , Ai^Xo       , Ai^Xo       , Ai^Xo       , Ai^Xo       , Ai^Xo       , Ai^Xo       
Ai^Xo       , Ai^Xo       , Ai^Xo       , Ai^Xo       , Ai^Xo       , Ai^Xo       , Ai^Xo       , Ai^Xo       , Ai^Xo       , Ai^Xo       , Ai^Xo       , Ai^Xo       , Ai^Xo       , Ai^Xo       , Ai^Xo       , Ai^Xo       , Ai^Xo       , Ai^Xo       , Ai^Xo       , Ai^Xo       , Ai^Xo       , Zaw         , Ai^Xo       , Zaw         , Zaw         , Xos         , Xos         , Xos         , Xos         , Xos         , Xos         , Xos         , Zaw         , Zaw         , Ai^Xo       , Ai^Xo       , Ai^Xo       , Ai^Xo       , Ai^Xo       , Ai^Xo       , Ai^Xo       , Ai^Xo       , Ai^Xo       , Ai^Xo       , Ai^Xo       , Ai^Xo       
Ai^Xo       , Ai^Xo       , Ai^Xo       , Ai^Xo       , Ai^Xo       , Ai^Xo       , Ai^Xo       , Ai^Xo       , Ai^Xo       , Ai^Xo       , Ai^Xo       , Ai^Xo       , Ai^Xo       , Ai^Xo       , Ai^Xo       , Ai^Xo       , Ai^Xo       , Ai^Xo       , Ai^Xo       , Ai^Xo       , Ai^Xo       , Ai^Xo       , Ai^Xo       , Ai^Xo       , Ai^Xo       , Zaw         , Zaw         , Xos         , Xos         , Xos         , Zaw         , Zaw         , Ai^Xo       , Ai^Xo       , Ai^Xo       , Ai^Xo       , Ai^Xo       , Ai^Xo       , Ai^Xo       , Ai^Xo       , Ai^Xo       , Ai^Xo       , Ai^Xo       , Ai^Xo       , Ai^Xo       , Ai^Xo       
