border_size=1
usage=map

Qxu         , Xu          , Uu          , Uu          , Qxu         , Xu          , Xos         , Xos         , Xos         , Xos         , Xos         , Xos         , Xos         , Xos         , Xos         , Xos         , Xos         , Xos         , Xos         , Xos         , Xos         , Xos         , Xos         , Xos         , Xos         , Xos         , Xos         , Xos         , Xos         , Xos         , Xos         , Xos         , Xos         , Xos         , Xos         , Xos         , Xos         , Xos         , Xos         , Xos         , Xu          , Xu          , Xu          , Xu          
Qxu         , Xu          , Qxu         , Qxu         , Uu          , Xu          , Cud         , Xos         , Xos         , Xos         , Xos         , Xos         , Xos         , Xos         , Xos         , Xos         , Xos         , Xos         , Xos         , Xos         , Xos         , Xos         , Xos         , Xos         , Xos         , Xos         , Xos         , Xos         , Xos         , Xos         , Xos         , Xos         , Xos         , Xos         , Xos         , Xos         , Xos         , Xos         , Cud         , Xu          , Ur          , Xu          , Ur          , Xu          
Qxu         , Qxu         , Qxu         , Uu          , Xu          , Uu          , Xos         , Cud         , Cud         , Xos         , Xos         , Xos         , Xos         , Xos         , Cud         , Cud         , Cud         , Xos         , Xos         , Xos         , Xos         , Xos         , Cud         , Xos         , Xos         , Xos         , Xos         , Xos         , Cud         , Cud         , Cud         , Xos         , Xos         , Xos         , Xos         , Xos         , Cud         , Cud         , Xu          , Cud         , Ur          , Ur          , Ur          , Xu          
Qxu         , Qxu         , Xu          , Qxu         , Xu          , Xu          , Xos         , Xos         , Xos         , Cud         , Cud         , Xos         , Cud         , Cud         , Xos         , Xos         , Xos         , Cud         , Cud         , Xos         , Cud         , Cud         , Cud^Ii      , Cud         , Cud         , Xos         , Cud         , Cud         , Xos         , Xos         , Xos         , Cud         , Cud         , Xos         , Cud         , Cud         , Xos         , Xos         , Xu          , Ur          , Ur          , Ur          , Ur          , Xu          
Xu          , Uu^Vu       , Qxu         , Qxu         , Xu          , Xos         , Xos         , Xos         , Xos         , Xos         , Xos         , Cud         , Xos         , Xos         , Xos         , Xos         , Xos         , Xos         , Gg^Fet      , Cud         , Xos         , Cud^Ii      , Kud^Ii      , Cud^Ii      , Xos         , Cud         , Gg^Fet      , Xos         , Xos         , Xos         , Xos         , Xos         , Xos         , Cud         , Xos         , Xos         , Xos         , Xos         , Xu          , Ur          , Ur          , Ur          , Ur          , Xu          
Qxu         , Uu^Ii       , Qxu         , Qxu         , Xu          , Xos         , Xos         , Xos         , Xos         , Xos         , Xos         , Xos         , Xos         , Xos         , Xos         , Xos         , Xos         , Xos         , Cud         , Cud         , Cud         , Cud^Ii      , Cud^Ii      , Cud^Ii      , Cud         , Cud         , Cud         , Xos         , Xos         , Xos         , Xos         , Xos         , Xos         , Xos         , Xos         , Xos         , Xos         , Xos         , Xu          , Ur          , Ur          , Ur          , Ur          , Xu          
Uu          , Qxu         , Qxu         , Uu          , Xu          , Xos         , Xos         , Xos         , Xos         , Xos         , Xos         , Xos         , Xos         , Xos         , Xos         , Xos         , Xos         , Xos         , Cud         , Cud         , Xos         , Cud^Ii      , 5 Cud^Ii    , Cud^Ii      , Xos         , Cud         , Cud         , Xos         , Xos         , Xos         , Xos         , Xos         , Xos         , Xos         , Xos         , Xos         , Xos         , Xos         , Xu          , Ur          , Ur          , Ur          , Ur          , Xu          
Uu          , Qxu         , Qxu         , Xu          , Xu          , Xos         , Xos         , Xos         , Xos         , Xos         , Xos         , Xos         , Xos         , Xos         , Xos         , Xos         , Xos         , Xos         , Gg^Fet      , Cud         , Cud         , Cud^Ii      , Cud^Ii      , Cud^Ii      , Cud         , Cud         , Gg^Fet      , Xos         , Xos         , Xos         , Xos         , Xos         , Xos         , Xos         , Xos         , Xos         , Xos         , Xos         , Xu          , Ur          , Ur          , Ur          , Ur          , Xu          
Qxu         , Xu          , Qxu         , Uu^Vu       , Xu          , Xos         , Xos         , Xos         , Xos         , Xos         , Xos         , Xos         , Xos         , Xos         , Xos         , Xos         , Xos         , Xos         , Xos         , Cud         , Cud         , Cud^Ii      , Cud^Ii      , Cud^Ii      , Cud         , Cud         , Xos         , Xos         , Xos         , Xos         , Xos         , Xos         , Xos         , Xos         , Xos         , Xos         , Xos         , Xos         , Xu          , Ur          , Ur          , Ur          , Ur          , Xu          
Qxu         , Qxu         , Qxu         , Qxu         , Xu          , Xos         , Xos         , Xos         , Xos         , Xos         , Xos         , Xos         , Xos         , Xos         , Xos         , Xos         , Xos         , Xos         , Xos         , Xos         , Xos         , Cud         , Cud^Ii      , Cud         , Xos         , Xos         , Xos         , Xos         , Xos         , Xos         , Xos         , Xos         , Xos         , Xos         , Xos         , Xos         , Xos         , Xos         , Xu          , Ur          , Ur          , Ur          , Ur          , Xu          
Qxu         , Uu          , Qxu         , Qxu         , Uu          , Xu          , Xos         , Xos         , Xos         , Xos         , Xos         , Xos         , Xos         , Xos         , Xos         , Xos         , Xos         , Xos         , Xos         , Xos         , Xos         , Xos         , Cud^Ii      , Xos         , Xos         , Xos         , Xos         , Xos         , Xos         , Xos         , Xos         , Xos         , Xos         , Xos         , Xos         , Xos         , Xos         , Xos         , Xos         , Xu          , Xu          , Ur          , Ur          , Xu          
Qxu         , Uu^Ii       , Xu          , Qxu         , Qxu         , Xu          , Xos         , Xos         , Xos         , Xos         , Xos         , Xos         , Xos         , Xos         , Xos         , Xos         , Xos         , Xos         , Gg^Fet      , Cud         , Cud^Ii      , Cud^Ii      , Cud^Ii      , Cud^Ii      , Cud^Ii      , Cud         , Gg^Fet      , Xos         , Xos         , Xos         , Xos         , Xos         , Xos         , Xos         , Xos         , Xos         , Xos         , Xos         , Xos         , Xos         , Xos         , Xu          , Ur          , Xu          
Qxu         , Qxu         , Qxu         , Qxu         , Uu          , Xu          , Xos         , Xos         , Xos         , Xos         , Xos         , Xos         , Xos         , Xos         , Xos         , Xos         , Xos         , Cud         , Cud^Ii      , Cud^Ii      , Rr^Ii       , Rr^Ii       , Rr^Ii       , Rr^Ii       , Rr^Ii       , Cud^Ii      , Cud^Ii      , Cud         , Xos         , Xos         , Xos         , Xos         , Xos         , Xos         , Xos         , Xos         , Xos         , Xos         , Xos         , Xos         , Xos         , Xu          , Ur          , Xu          
Xu          , Qxu         , Qxu         , Uu          , Uu          , Xu          , Xos         , Xos         , Xos         , Xos         , Xos         , Xos         , Xos         , Xos         , Xos         , Xos         , Xos         , Cud         , Xos         , Rr          , Rr^Ii       , Rr^Ii       , Rr^Ii       , Rr^Ii       , Rr^Ii       , Rr          , Xos         , Cud         , Xos         , Xos         , Xos         , Xos         , Xos         , Xos         , Xos         , Xos         , Xos         , Xos         , Xos         , Xos         , Xos         , Xu          , Ur          , Xu          
Qxu         , Uu^Vu       , Qxu         , Qxu         , Qxu         , Xu          , Xos         , Xos         , Xos         , Xos         , Xos         , Xos         , Xos         , Xos         , Xos         , Xos         , Xos         , Cud         , Rr          , Rr          , Rr^Ii       , Rr^Ii       , Rr^Ii       , Rr^Ii       , Rr^Ii       , Rr          , Rr          , Cud         , Xos         , Xos         , Xos         , Xos         , Xos         , Xos         , Xos         , Xos         , Xos         , Xos         , Xos         , Xos         , Xu          , Xu          , Ur          , Xu          
Qxu         , Qxu         , Uu          , Xu          , Qxu         , Xu          , Xos         , Xos         , Xos         , Xos         , Xos         , Xos         , Xos         , Xos         , Xos         , Xos         , Xos         , Cud         , Rr          , Rr          , Rr^Ii       , Rr^Ii       , Rr^Ii       , Rr^Ii       , Rr^Ii       , Rr          , Rr          , Cud         , Xos         , Xos         , Xos         , Xos         , Xos         , Xos         , Xos         , Xos         , Xos         , Xos         , Xu          , Xu          , Uu^Vu       , Ur          , Qxu         , Qxu         
Qxu         , Qxu         , Uu^Ii       , Qxu         , Qxu         , Xu          , Xos         , Xos         , Xos         , Xos         , Xos         , Xos         , Xos         , Xos         , Xos         , Xos         , Xos         , Cud         , Xos         , Rr          , Rr^Ii       , Rr^Ii       , Rr^Ii       , Rr^Ii       , Rr^Ii       , Rr          , Xos         , Cud         , Xos         , Xos         , Xos         , Xos         , Xos         , Xos         , Xos         , Xos         , Xos         , Xu          , Xu          , Qxu         , Qxu         , Ur          , Ur          , Qxu         
Qxu         , Xu          , Qxu         , Qxu         , Uu^Vu       , Xu          , Xos         , Xos         , Xos         , Xos         , Xos         , Xos         , Xos         , Xos         , Xos         , Xos         , Xos         , Cud         , Rr          , Rr          , Rr          , Rr^Ii       , Rr^Ii       , Rr^Ii       , Rr          , Rr          , Rr          , Cud         , Xos         , Xos         , Xos         , Xos         , Xos         , Xos         , Xos         , Xos         , Xu          , Xu          , Qxu         , Qxu         , Qxu         , Qxu         , Qxu^Bs|     , Qxu         
Qxu         , Qxu         , Qxu         , Qxu         , Qxu         , Xu          , Xu          , Xos         , Xos         , Xos         , Xos         , Xos         , Xos         , Xos         , Xos         , Xos         , Xos         , Cud         , Rr          , Rr          , Xos         , Rr^Ii       , Rr^Ii       , Rr^Ii       , Xos         , Rr          , Rr          , Cud         , Xos         , Xos         , Xos         , Xos         , Xos         , Xos         , Xos         , Xos         , Xu          , Qxu         , Qxu         , Qxu         , Ur          , Qxu         , Ur^Ii       , Qxu         
Xu          , Qxu         , Xu          , Qxu         , Qxu         , Qxu         , Xu          , Xos         , Xos         , Xos         , Xos         , Xos         , Xos         , Xos         , Xos         , Xos         , Xos         , Xos         , Xos         , Rr          , Rr          , Rr^Ii       , Rr^Ii       , Rr^Ii       , Rr          , Rr          , Xos         , Xos         , Xos         , Xos         , Xos         , Xos         , Xos         , Xos         , Xos         , Xos         , Xu          , Xu          , Ur          , Qxu^Bs/     , Qxu         , Ur          , Qxu         , Qxu         
Qxu         , Uu          , Qxu         , Qxu         , Qxu         , Xu          , Xu          , Xos         , Xos         , Xos         , Xos         , Xos         , Xos         , Xos         , Xos         , Xos         , Xos         , Xos         , Xos         , Xos         , Xos         , Rr^Ii       , Rr^Ii       , Rr^Ii       , Xos         , Xos         , Xos         , Xos         , Xos         , Xos         , Xos         , Xos         , Xos         , Xos         , Xos         , Xos         , Xu          , Uu^Vu       , Qxu         , Qxu         , Qxu         , Qxu         , Qxu         , Qxu         
Qxu         , Qxu         , Xu          , Uu          , Qxu         , Qxu         , Xu          , Xos         , Xos         , Xos         , Xos         , Xos         , Xos         , Xos         , Xos         , Xos         , Xos         , Xos         , Xos         , Xos         , Xos         , Xos         , Rr^Ii       , Xos         , Xos         , Xos         , Xos         , Xos         , Xos         , Xos         , Xos         , Xos         , Xos         , Xos         , Xos         , Xos         , Xu          , Ur          , Ur^Ii       , Qxu         , Qxu         , Qxu         , Xu          , Qxu         
Qxu         , Qxu         , Qxu         , Qxu         , Uu          , Qxu         , Qxu         , Xu          , Xu          , Xos         , Xos         , Xos         , Xos         , Xos         , Xos         , Xos         , Xos         , Xos         , Xos         , Xos         , Xos         , Xos         , Rr^Ii       , Xos         , Xos         , Xos         , Xos         , Xos         , Xos         , Xos         , Xos         , Xos         , Xos         , Xos         , Xos         , Xos         , Xu          , Xu          , Qxu         , Ur          , Qxu         , Qxu         , Xu          , Xu          
Qxu         , Qxu         , Uu^Vu       , Qxu         , Xu          , Qxu         , Qxu         , Qxu         , Xu          , Xos         , Xos         , Xos         , Xos         , Xos         , Xos         , Xos         , Xos         , Xos         , Xos         , Xos         , Xos         , Xos         , Rr^Ii       , Xos         , Xos         , Xos         , Xos         , Xos         , Xos         , Xos         , Xos         , Xos         , Xos         , Xos         , Xos         , Xos         , Xos         , Xu          , Xu          , Qxu^Bs|     , Xu          , Xu          , Xos         , Xos         
Qxu         , Xu          , Qxu         , Qxu         , Qxu         , Qxu         , Qxu         , Qxu         , Qxu         , Xu          , Xos         , Xos         , Xos         , Xos         , Xos         , Xos         , Xos         , Xos         , Xos         , Xos         , Rr          , Rr^Ii       , Rr^Ii       , Rr^Ii       , Rr          , Xos         , Xos         , Xos         , Xos         , Xos         , Xos         , Xos         , Xos         , Xos         , Xos         , Xos         , Xos         , Xos         , Xu          , Ur          , Xu          , Xos         , Xos         , Xos         
Qxu         , Qxu         , Qxu         , Qxu         , Xu          , Qxu         , Qxu         , Qxu         , Qxu         , Xu          , Xos         , Xos         , Xos         , Xos         , Xos         , Xos         , Xos         , Xos         , Xos         , Rr          , Xos         , Rr^Ii       , Rr^Ii       , Rr^Ii       , Xos         , Rr          , Xos         , Xos         , Xos         , Xos         , Xos         , Xos         , Xos         , Xos         , Xos         , Xos         , Xos         , Xos         , Xu          , Ur          , Xu          , Xos         , Xos         , Xos         
Qxu         , Qxu         , Qxu         , Qxu         , Qxu         , Qxu         , Uu^Vu       , Uu          , Qxu         , Xu          , Xos         , Xos         , Xos         , Xos         , Xos         , Xos         , Xos         , Xos         , Xos         , Rr          , Rr          , Rr^Ii       , Rr^Ii       , Rr^Ii       , Rr          , Rr          , Xos         , Xos         , Xos         , Xos         , Xos         , Xos         , Xos         , Xos         , Xos         , Xos         , Xos         , Xos         , Xu          , Ur          , Xu          , Xos         , Xos         , Xos         
Qxu         , Qxu         , Xu          , Qxu         , Qxu         , Qxu         , Uu          , Xu          , Qxu         , Xu          , Xos         , Xos         , Xos         , Xos         , Xos         , Xos         , Xos         , Xos         , Xos         , Rr          , Rr          , Rr^Ii       , Rr^Ii       , Rr^Ii       , Rr          , Rr          , Xos         , Xos         , Xos         , Xos         , Xos         , Xos         , Xos         , Xos         , Xos         , Xos         , Xos         , Xu          , Ur          , Ur          , Xu          , Xos         , Xos         , Xos         
Qxu         , Qxu         , Uu^Ii       , Uu^Ii       , Qxu         , Qxu         , Qxu         , Qxu         , Qxu         , Xu          , Xos         , Xos         , Xos         , Xos         , Xos         , Xos         , Xos         , Xos         , Xos         , Rr          , Xos         , Rr^Ii       , Rr^Ii       , Rr^Ii       , Xos         , Rr          , Xos         , Xos         , Xos         , Xos         , Xos         , Xos         , Xos         , Xos         , Xos         , Xos         , Xos         , Xu          , Ur          , Xu          , Xos         , Xos         , Xos         , Xos         
Qxu         , Qxu         , Qxu         , Qxu         , Qxu         , Xu          , Uu          , Qxu         , Qxu         , Xu          , Xos         , Xos         , Xos         , Xos         , Xos         , Xos         , Xos         , Xos         , Xos         , Rr          , Rr          , Rr^Ii       , Rr^Ii       , Rr^Ii       , Rr          , Rr          , Xos         , Xos         , Xos         , Xos         , Xos         , Xos         , Xos         , Xos         , Xos         , Xos         , Xos         , Xu          , Ur          , Xu          , Xos         , Xos         , Xos         , Xos         
Qxu         , Xu          , Uu^Vu       , Qxu         , Qxu         , Uu          , Qxu         , Qxu         , Qxu         , Xu          , Xos         , Xos         , Xos         , Xos         , Xos         , Xos         , Xos         , Xos         , Xos         , Xos         , Xos         , Rr^Ii       , Rr^Ii       , Rr^Ii       , Xos         , Xos         , Xos         , Xos         , Xos         , Xos         , Xos         , Xos         , Xos         , Xos         , Xos         , Xos         , Xos         , Xu          , Ur          , Xu          , Xos         , Xos         , Xos         , Xos         
Qxu         , Uu          , Qxu         , Qxu         , Qxu         , Qxu         , Qxu         , Qxu         , Qxu         , Xu          , Xu          , Xos         , Xos         , Xos         , Xos         , Xos         , Xos         , Xos         , Xos         , Xos         , Xos         , Xos         , Rr^Ii       , Xos         , Xos         , Xos         , Xos         , Xos         , Xos         , Xos         , Xos         , Xos         , Xos         , Xos         , Xos         , Xos         , Xos         , Xu          , Ur          , Xu          , Xos         , Xos         , Xos         , Xos         
Qxu         , Qxu         , Qxu         , Qxu         , Xu          , Xu          , Qxu         , Qxu         , Xu          , Xu          , Xu          , Xu          , Xu          , Xos         , Xos         , Xos         , Xos         , Xos         , Xos         , Xos         , Xos         , Xos         , Rr^Ii       , Xos         , Xos         , Xos         , Xos         , Xos         , Xos         , Xos         , Xos         , Xos         , Xos         , Xos         , Xos         , Xos         , Xos         , Xu          , Ur          , Xu          , Xos         , Xos         , Xos         , Xos         
Qxu         , Qxu         , Qxu         , Qxu         , Uu          , Uu          , Qxu         , Qxu         , Xu          , Xu          , Xu          , Xu          , Xu          , Xu          , Xu          , Xos         , Ur          , Ur          , Ur          , Xos         , Xos         , Xos         , Rr^Ii       , Xos         , Xos         , Xos         , Ur          , Ur          , Ur          , Xos         , Xos         , Xos         , Xos         , Xos         , Xos         , Xos         , Xos         , Xu          , Ur          , Xu          , Xu          , Xos         , Xos         , Xos         
Uu          , Uu          , Uu          , Qxu         , Xu          , Uu          , Xu          , Qxu         , Uu          , Xu          , Xu          , Xu          , Uu          , Uu          , Uu          , Uu          , Xos         , Xos         , Xos         , Cud         , Cud         , Rr^Ii       , Rr^Ii       , Rr^Ii       , Cud         , Cud         , Xos         , Xos         , Xos         , Ur          , Ur          , Xos         , Xos         , Xos         , Xos         , Xos         , Xos         , Xu          , Xu          , Ur          , Ur          , Xos         , Xos         , Xos         
Qxu         , Xu          , Qxu         , Qxu         , Qxu         , Uu          , Qxu         , Qxu         , Xu          , Uu          , Uu          , Uu          , Xu          , Xu          , Xos         , Xos         , Xos         , Xos         , Kud         , Cud         , Xos         , Rr^Ii       , Rr^Ii       , Rr^Ii       , Xos         , Cud         , Kud         , Xos         , Xos         , Xos         , Xos         , Ur          , Ur          , Xos         , Xos         , Xos         , Xos         , Xos         , Xos         , Xos         , Ur          , Xos         , Xos         , Xos         
Qxu         , Qxu         , Uu          , Uu^Vu       , Qxu         , Qxu         , Qxu         , Xu          , Xu          , Xu          , Xu          , Xu          , Xos         , Xos         , Xos         , Xos         , Xos         , Xos         , Cud         , Cud         , Cud         , Rr^Ii       , Rr^Ii       , Rr^Ii       , Cud         , Cud         , Cud         , Xos         , Xos         , Xos         , Xos         , Xos         , Xos         , Ur          , Ur          , Xos         , Ur          , Xos         , Ur          , Ur          , Xos         , Xos         , Xos         , Xos         
Qxu         , Qxu         , Qxu         , Xu          , Qxu         , Qxu         , Xu          , Xu          , Xu          , Xu          , Xu          , Xu          , Xos         , Xos         , Xos         , Xos         , Xos         , Xos         , Gg^Fet      , Cud         , Xos         , Rr^Ii       , Rr^Ii       , Rr^Ii       , Xos         , Cud         , Gg^Fet      , Xos         , Xos         , Xos         , Xos         , Xos         , Xos         , Xos         , Xos         , Ur          , Xos         , Ur          , Xos         , Xos         , Xos         , Xos         , Xos         , Xos         
Xu          , Qxu         , Xu          , Qxu         , Xu          , Xu          , Xu          , Xu          , Xu          , Xu          , Xu          , Xos         , Xos         , Xos         , Xos         , Xos         , Xos         , Xos         , Xos         , Cud         , Cud         , Rr^Ii       , 1 Rr^Ii     , Rr^Ii       , Cud         , Cud         , Xos         , Xos         , Xos         , Xos         , Xos         , Xos         , Xos         , Xos         , Xos         , Xos         , Xos         , Xos         , Xos         , Xos         , Xos         , Xos         , Xos         , Xos         
Xu          , Xu          , Xu          , Xu          , Xu          , Xu          , Xu          , Xu          , Xu          , Xu          , Xos         , Xos         , Xos         , Xos         , Xos         , Xos         , Xos         , Xos         , Xos         , Xos         , Xos         , Rr^Ii       , Rr^Ii       , Rr^Ii       , Xos         , Xos         , Xos         , Xos         , Xos         , Xos         , Xos         , Xos         , Xos         , Xos         , Xos         , Xos         , Xos         , Xos         , Xos         , Xos         , Xos         , Xos         , Xos         , Xos         
Xu          , Xu          , Xu          , Xu          , Xu          , Xu          , Xu          , Xu          , Xu          , Xu          , Xos         , Xos         , Xos         , Xos         , Xos         , Xos         , Xos         , Xos         , Xos         , Xos         , Xos         , Xos         , Rr^Ii       , Xos         , Xos         , Xos         , Xos         , Xos         , Xos         , Xos         , Xos         , Xos         , Xos         , Xos         , Xos         , Xos         , Xos         , Xos         , Xos         , Xos         , Xos         , Xos         , Xos         , Xos         
Xu          , Xu          , Xu          , Xu          , Xu          , Xu          , Xu          , Xu          , Xu          , Xu          , Xos         , Xos         , Xos         , Xos         , Xos         , Xos         , Xos         , Xos         , Xos         , Xos         , Xos         , Xos         , Rr^Ii       , Xos         , Xos         , Xos         , Xos         , Xos         , Xos         , Xos         , Xos         , Xos         , Xos         , Xos         , Xos         , Xos         , Xos         , Xos         , Xos         , Xos         , Xos         , Xos         , Xos         , Xos         
Xu          , Xu          , Xu          , Xu          , Xu          , Xu          , Xu          , Xu          , Xos         , Xos         , Xos         , Xos         , Xos         , Xos         , Xos         , Xos         , Xos         , Xos         , Xos         , Xos         , Xos         , Xos         , Rr          , Xos         , Xos         , Xos         , Xos         , Xos         , Xos         , Xos         , Xos         , Xos         , Xos         , Xos         , Xos         , Xos         , Xos         , Xos         , Xos         , Xos         , Xos         , Xos         , Xos         , Xos         
