border_size=1
usage=map

Xu          , Xu          , Xu          , Xu          , Xu          , Xu          , Xu          , Uu^Uf       , Uu^Uf       , Uu^Uf       , Uu^Uf       , Uu          , Uu          , Ur          , Uu          , Uu          , Uu          , Uu          , Uh^Em       , Uu^Uf       , Uu^Uf       , Uu^Uf       , Xu          , Xu          , Xu          , Xu          , Xu          , Xu          , Xu          , Xu          , Xu          , Xu          , Xu          , Xu          , Xu          , Xu          , Xu          , Xu          , Xu          , Xu          , Xu          , Xu          , Xu          , Xu          , Xu          , Xu          
Xu          , Xu          , Xu          , Xu          , Xu          , Xu          , Uu^Uf       , Uu^Uf       , Uu^Uf       , Uh^Emf      , Uu^Uf       , Uh^Em       , Uu^Es       , Ur          , Ur          , Uu          , Cud         , Cud         , Uh          , Uu^Uf       , Uu^Uf       , Uu^Uf       , Uu^Uf       , Xu          , Xu          , Xu          , Xu          , Xu          , Xu          , Xu          , Xu          , Xu          , Xu          , Xu          , Xu          , Xu          , Xu          , Xu          , Xu          , Xu          , Xu          , Xu          , Xu          , Xu          , Xu          , Xu          
Xu          , Xu          , Xu          , Xu          , Xu          , Xu          , Xu          , Uu^Uf       , Uu^Uf       , Uh^Emf      , Uu^Uf       , Uh^Em       , Uh          , Uu          , Ur          , Cud         , Cud         , 5 Kud       , Cud         , Uh^Em       , Uh^Dr       , Uu^Uf       , Uu^Uf       , Xu          , Xu          , Xu          , Xu          , Xu          , Xu          , Xu          , Xu          , Xu          , Xu          , Xu          , Xu          , Xu          , Xu          , Xu          , Xu          , Xu          , Xu          , Xu          , Xu          , Xu          , Xu          , Xu          
Xu          , Xu          , Xu          , Xu          , Xu          , Xu          , Xu          , Xu          , Uu^Uf       , Uu^Uf       , Uu^Uf       , Uh^Dr       , Uh          , Uu          , Uu          , Ur          , Cud         , Cud         , Cud         , Uh          , Uh          , Uu^Uf       , Uu^Uf       , Uh^Emf      , Uu^Uf       , Xu          , Xu          , Xu          , Xu          , Xu          , Xu          , Xu          , Xu          , Xu          , Xu          , Xu          , Xu          , Xu          , Xu          , Xu          , Xu          , Xu          , Xu          , Xu          , Xu          , Xu          
Xu          , Xu          , Xu          , Xu          , Xu          , Xu          , Xu          , Xu          , Xu          , Uu^Uf       , Uu^Uf       , Uu^Uf       , Uu^Uf       , Uh^Em       , Uu^Es       , Ur          , Uu          , Cud         , Uu^Em       , Uh          , Uh          , Uh          , Uh^Em       , Uh^Emf      , Uu^Uf       , Xu          , Xu          , Xu          , Xu          , Xu          , Xu          , Xu          , Xu          , Xu          , Xu          , Xu          , Xu          , Xu          , Xu          , Xu          , Xu          , Xu          , Xu          , Xu          , Xu          , Xu          
Xu          , Xu          , Xu          , Xu          , Xu          , Xu          , Xu          , Xu          , Xu          , Xu          , Xu          , Uu^Uf       , Uu^Uf       , Uh^Emf      , Uh          , Ur          , Uu          , Uu          , Uu          , Uu          , Uh^Dr       , Uh          , Uu^Uf       , Uu^Uf       , Xu          , Xu          , Xu          , Xu          , Xu          , Xu          , Xu          , Xu          , Xu          , Xu          , Xu          , Xu          , Xu          , Xu          , Xu          , Xu          , Xu          , Xu          , Xu          , Xu          , Xu          , Xu          
Xu          , Xu          , Xu          , Xu          , Xu          , Xu          , Xu          , Xu          , Xu          , Xu          , Xu          , Uu^Uf       , Uu^Uf       , Uu^Vu       , Uh^Es       , Ur          , Ur          , Uu          , Uu          , Uu^Es       , Uh          , Uh          , Xu          , Xu          , Xu          , Xu          , Xu          , Xu          , Xu          , Xu          , Xu          , Xu          , Xu          , Xu          , Xu          , Xu          , Xu          , Xu          , Xu          , Xu          , Xu          , Xu          , Xu          , Xu          , Xu          , Xu          
Xu          , Xu          , Xu          , Xu          , Xu          , Xu          , Xu          , Xu          , Xu          , Xu          , Xu          , Xu          , Xu          , Uu          , Uu^Dr       , Uu          , Ur          , Ur          , Uu^Em       , Uu          , Uh          , Uh          , Uu^Uf       , Xu          , Xu          , Xu          , Xu          , Xu          , Xu          , Xu          , Xu          , Xu          , Xu          , Xu          , Xu          , Xu          , Xu          , Xu          , Xu          , Xu          , Xu          , Xu          , Xu          , Xu          , Xu          , Xu          
Xu          , Xu          , Xu          , Xu          , Xu          , Xu          , Xu          , Xu          , Xu          , Xu          , Xu          , Xu          , Xu          , Uu          , Uu          , Uu          , Uu          , Ur          , Uu          , Uu          , Uh          , Uh          , Uh^Emf      , Uu^Uf       , Xu          , Xu          , Xu          , Xu          , Xu          , Xu          , Xu          , Xu          , Xu          , Xu          , Xu          , Xu          , Xu          , Xu          , Xu          , Xu          , Uh          , Uh          , Uh          , Xu          , Uh          , Xu          
Xu          , Xu          , Xu          , Xu          , Xu          , Xu          , Xu          , Xu          , Xu          , Xu          , Xu          , Xu          , Xu          , Uu          , Uu          , Uh          , Uu          , Ur          , Ur          , Uu          , Uu^Vu       , Uu          , Uh          , Uu^Uf       , Uu^Uf       , Xu          , Xu          , Xu          , Xu          , Xu          , Xu          , Xu          , Xu          , Xu          , Xu          , Xu          , Xu          , Xu          , Uu^Uf       , Uu^Uf       , Uu^Uf       , Uu^Emf      , Uh          , Uh^Dr       , Uh          , Uh          
Xu          , Xu          , Xu          , Xu          , Xu          , Xu          , Xu          , Xu          , Xu          , Xu          , Xu          , Xu          , Xu          , Xu          , Uu          , Uu^Em       , Uu^Dr       , Uu          , Ur          , Uu          , Uu          , Uu^Em       , Uu^Em       , Uh^Dr       , Uh^Dr       , Uu^Uf       , Xu          , Xu          , Xu          , Xu          , Xu          , Xu          , Xu          , Xu          , Xu          , Xu          , Uu^Uf       , Uu^Uf       , Uu^Uf       , Uu^Uf       , Uu^Uf       , Uu^Em       , Uh          , Uh          , Uh          , Uu          
Xu          , Xu          , Uu^Uf       , Xu          , Xu          , Xu          , Xu          , Xu          , Xu          , Xu          , Xu          , Xu          , Xu          , Xu          , Uu^Dr       , Uu          , Uh          , Uu          , Uu          , Ur          , Uu^Es       , Uu          , Uu          , Uu^Dr       , Uh          , Uh^Emf      , Uu^Uf       , Xu          , Xu          , Xu          , Uh^Emf      , Xu          , Xu          , Xu          , Uh^Emf      , Uu^Emf      , Uu^Vu       , Uu^Uf       , Uh^Dr       , Uu^Emf      , Uu^Uf       , Uh          , Cud         , 6 Kud       , Cud         , Uu          
Uu^Uf       , Uu^Uf       , Uh^Emf      , Uu^Uf       , Uu^Uf       , Xu          , Xu          , Xu          , Xu          , Xu          , Uu^Uf       , Uu^Em       , Uu          , Uu          , Uu          , Uu          , Uu          , Uu          , Uu          , Ur          , Ur          , Uu          , Uu^Vu       , Uh          , Uh          , Uu^Uf       , Uh^Em       , Uu^Uf       , Uh          , Uh          , Uh          , Uh^Em       , Uu          , Uh^Emf      , Uh^Em       , Uh^Dr       , Uu          , Uh^Em       , Uh          , Uh          , Uu          , Cud         , Cud         , Cud         , Ur          , Ur          
Uu          , Uu^Uf       , Uh          , Uh          , Uh^Em       , Uu^Uf       , Uu^Uf       , Xu          , Uu^Uf       , Uu^Uf       , Uu^Em       , Uu          , Uu          , Uh          , Uh          , Uu^Es       , Uh          , Uu^Em       , Uh          , Uu          , Uu          , Ur          , Uu          , Uh          , Uh          , Uh          , Cud         , Cud         , Cud         , Uu^Vu       , Uh          , Uh^Dr       , Uh          , Uh          , Uu          , Uh          , Uh          , Uu          , Uu          , Uu          , Ur          , Cud         , Ur          , Ur          , Uu^Es       , Ur          
Uu          , Uu^Em       , Uh          , Uh^Dr       , Uh          , Uu^Uf       , Uu^Uf       , Uu^Uf       , Uu^Uf       , Uh          , Uu^Vu       , Uh          , Uh^Dr       , Uh          , Uh^Dr       , Uu          , Uh          , Uh          , Uh          , Uh          , Uu          , Ur          , Uu          , Uu          , Cud         , Cud         , Ur          , Kud         , Cud         , Uh          , Uh          , Uh          , Uu          , Uu          , Uu^Dr       , Uu          , Uu          , Uu^Em       , Ur^Es       , Ur          , Ur          , Ur          , Uu          , Uu          , Uh^Dr       , Uu          
Ur          , Uu          , Uu          , Uu          , Cud         , Uh^Em       , Uu^Uf       , Uu^Uf       , Uh^Emf      , Uh^Emf      , Uu          , Uu          , Uu          , Uh          , Uu          , Uh          , Uu^Vu       , Uu          , Uh          , Uh          , Cud         , Ur^Em       , Ur          , Cud         , Ur          , Ur          , Uh          , Ur          , Ur          , Cud         , Uu          , Uu^Vu       , Uu          , Uu^Em       , Ur          , Ur          , Ur          , Ur          , Uu^Em       , Uu          , Uh          , Uh          , Uh^Dr       , Uh          , Uh          , Uh          
Uu          , Ur          , Ur          , Cud         , 4 Kud       , Uh          , Uh^Em       , Uh^Dr       , Uu^Uf       , Uu^Uf       , Uu^Em       , Uu          , Ur          , Uu          , Ur          , Ur          , Ur          , Uu          , Uh          , Cud         , Kud         , Cud         , Ur          , Ur          , Uu          , Uh          , Uh^Dr       , Uh          , Ur          , Cud         , Ur          , Uu          , Ur          , Ur          , Uu^Dr       , Uu          , Uu          , Uu^Dr       , Uu          , Uu^Vu       , Uh          , Uh^Em       , Uh^Emf      , Uh^Em       , Uh          , Xu          
Uu          , Uu          , Ur          , Cud         , Cud         , Uh          , Uh          , Uh          , Uu^Uf       , Uu^Uf       , Ur          , Ur          , Uu          , Ur          , Uu^Vu       , Uu          , Uu          , Ur          , Ur          , Cud         , Ur          , Ur          , Uh          , Ur^Es       , Ur          , Uh          , Uu^Vu       , Uh^Es       , Ur          , Ur          , Uu          , Ur^Em       , Uu          , Uu          , Uu          , Uu          , Uh^Em       , Uu          , Uh^Emf      , Uh^Em       , Uu^Uf       , Uu^Uf       , Uu^Uf       , Uu^Uf       , Xu          , Xu          
Uh          , Uu          , Ur          , Cud         , Cud         , Cud         , Uh          , Uu^Uf       , Uu^Uf       , Ur          , Uu          , Uu^Es       , Uh          , Uu          , Uh          , Uh          , Uu          , Uu          , Cud         , Ur          , Ur^Es       , Uu          , Uu^Vu       , Uu          , Cud         , Uu          , Ur          , Ur          , Ur          , Cud         , Cud         , Uu          , Uh          , Uu^Vu       , Uh^Em       , Uh          , Uh          , Uh          , Xu          , Uu^Uf       , Uu^Uf       , Uu^Uf       , Xu          , Xu          , Xu          , Xu          
Uu          , Uu^Dr       , Uu^Es       , Ur          , Uu          , Uu          , Uu          , Uu^Em       , Ur          , Ur          , Uu^Uf       , Uu^Em       , Uh          , Uh          , Uh          , Uh          , Cud         , Cud         , Ur          , Ur          , Uh          , Ur          , Cud         , Cud         , 2 Kud       , Cud         , 1 Cud       , Uu^Dr       , Uh^Dr       , Ur          , Cud         , Uh          , Uh          , Uh^Dr       , Uu          , Uu^Em       , Xu          , Xu          , Xu          , Xu          , Xu          , Xu          , Xu          , Xu          , Xu          , Xu          
Uu          , Uu          , Uh          , Ur          , Ur          , Uu^Es       , Ur          , Ur          , Uu^Em       , Uu^Uf       , Uu^Uf       , Uh^Emf      , Uh^Dr       , Uu          , Uh          , Uu          , Cud         , Kud         , Ur          , Uh          , Uu^Vu       , Uu          , Ur          , Cud         , Cud         , Cud         , Uu^Vu       , Uh          , Ur          , Ur          , Kud         , Cud         , Uh          , Uh          , Xu          , Xu          , Xu          , Xu          , Xu          , Xu          , Xu          , Xu          , Xu          , Xu          , Xu          , Xu          
Xu          , Uu          , Uh^Em       , Uu          , Uh^Em       , Ur          , Uh^Dr       , Uu          , Uh^Emf      , Uu^Uf       , Uh          , Uh^Em       , Uu          , Uh^Dr       , Uu          , Uh          , Uh          , Cud         , Ur          , Uh          , Ur          , Ur          , Uh          , Uu          , Uu          , Ur          , Ur          , Uh          , Ur          , Cud         , Cud         , Cud         , Uh^Em       , Uu^Em       , Xu          , Xu          , Xu          , Xu          , Xu          , Xu          , Xu          , Xu          , Xu          , Xu          , Xu          , Xu          
Xu          , Xu          , Uu^Uf       , Uu^Uf       , Uu^Uf       , Uh^Emf      , Uu^Uf       , Uu^Uf       , Uu^Uf       , Uu^Vu       , Xu          , Uu          , Xu          , Uu          , Uu^Vu       , Uu          , Uh          , Cud         , Cud         , Ur          , Uh          , Uh^Dr       , Uh          , Uu^Vu       , Uh          , Uu          , Ur^Es       , Ur          , Cud         , Cud         , Uh          , Uh          , Uh^Dr       , Uu^Uf       , Uu^Uf       , Xu          , Xu          , Xu          , Xu          , Xu          , Xu          , Xu          , Xu          , Xu          , Xu          , Xu          
Xu          , Xu          , Xu          , Uu^Uf       , Uu^Uf       , Uu^Uf       , Uu^Uf       , Uu^Uf       , Xu          , Xu          , Xu          , Xu          , Xu          , Uh          , Uu^Es       , Uu          , Uh          , Uu          , Ur          , Ur          , Ur          , Uh          , Ur          , Ur          , Ur          , Ur          , Cud         , Ur          , Ur          , Uu          , Uu          , Uh          , Uu^Emf      , Uu^Uf       , Uu^Uf       , Uu^Uf       , Uu^Uf       , Xu          , Xu          , Xu          , Xu          , Xu          , Xu          , Xu          , Xu          , Xu          
Xu          , Xu          , Xu          , Xu          , Xu          , Xu          , Xu          , Xu          , Xu          , Xu          , Xu          , Xu          , Uu^Uf       , Uh^Em       , Uu          , Uh          , Uh          , Uu          , Ur          , Cud         , Cud         , Ur          , Cud         , Kud         , Cud         , Cud         , Uu          , Uu          , Uu          , Ur          , Ur^Es       , Uu          , Uu          , Uh          , Uh^Emf      , Uu^Uf       , Uu^Uf       , Uu^Uf       , Xu          , Xu          , Xu          , Xu          , Xu          , Xu          , Xu          , Xu          
Xu          , Xu          , Xu          , Xu          , Xu          , Xu          , Xu          , Xu          , Xu          , Xu          , Uu^Uf       , Uu^Uf       , Uu^Uf       , Uu^Em       , Uh^Dr       , Uu          , Ur          , Ur          , Uh          , Uu          , Uh          , Cud         , Uh          , Cud         , Uh          , Uh          , Uh          , Uh          , Uh^Dr       , Uu          , Uu^Vu       , Ur          , Uh          , Uh^Dr       , Uu^Em       , Uu^Vu       , Uu^Em       , Uu^Uf       , Xu          , Xu          , Xu          , Xu          , Xu          , Xu          , Xu          , Xu          
Xu          , Xu          , Xu          , Xu          , Xu          , Xu          , Xu          , Xu          , Uu^Uf       , Uu^Uf       , Uu^Uf       , Uu^Uf       , Uu^Emf      , Uh          , Uu          , Ur          , Ur          , Uh          , Uh          , Uu          , Uh          , Uh          , Uu          , Uh          , Uu          , Uh          , Uh          , Uu          , Uh          , Uu          , Uh          , Ur          , Ur          , Uu          , Uu          , Uh^Es       , Uh^Emf      , Uu^Uf       , Uu^Uf       , Xu          , Xu          , Xu          , Xu          , Xu          , Xu          , Xu          
Xu          , Xu          , Xu          , Xu          , Xu          , Xu          , Xu          , Xu          , Uu^Uf       , Uu^Uf       , Uh^Em       , Uu^Vu       , Uu          , Uh          , Uu          , Ur^Dr       , Ur          , Uh          , Uh          , Uu          , Uu^Dr       , Uh          , Uu          , Uu^Vu       , Xu          , Uh          , Uh^Em       , Uh          , Uh^Em       , Uh          , Uh          , Uu          , Ur          , Uu          , Uu          , Uu          , Uh          , Uu^Uf       , Uu^Uf       , Xu          , Xu          , Xu          , Xu          , Xu          , Xu          , Xu          
Xu          , Xu          , Xu          , Xu          , Xu          , Xu          , Xu          , Uu^Uf       , Uu^Uf       , Uh^Em       , Uu          , Uu          , Uu          , Uu^Dr       , Uu          , Ur          , Ur          , Uu          , Uh          , Uh          , Uh^Em       , Uh          , Xu          , Xu          , Xu          , Xu          , Uu^Uf       , Uu^Uf       , Uu^Uf       , Uh^Em       , Uu          , Uu^Es       , Ur          , Uu          , Uu^Dr       , Uu          , Uu          , Uh^Em       , Uu^Uf       , Uu^Vu       , Xu          , Xu          , Xu          , Xu          , Xu          , Xu          
Xu          , Xu          , Xu          , Xu          , Xu          , Xu          , Uu^Uf       , Uu^Uf       , Uu^Uf       , Uh          , Uu          , Uh^Es       , Uu          , Uu          , Uu          , Uu          , Ur          , Uu          , Uu^Es       , Uh^Em       , Uu^Uf       , Uh^Emf      , Xu          , Xu          , Xu          , Xu          , Xu          , Uu^Uf       , Uh^Emf      , Uh^Dr       , Uu          , Uu^Es       , Uu          , Ur          , Uu          , Uu          , Uu          , Uh^Emf      , Uu^Uf       , Uu^Uf       , Xu          , Xu          , Xu          , Xu          , Xu          , Xu          
Xu          , Xu          , Xu          , Xu          , Xu          , Uu^Uf       , Uu^Uf       , Uu^Uf       , Uu^Emf      , Uh          , Uh^Dr       , Uh          , Cud         , Cud         , Ur          , Ur          , Uu          , Uu          , Uh^Dr       , Uu^Vu       , Uu^Uf       , Uu^Uf       , Xu          , Xu          , Xu          , Xu          , Xu          , Uu^Uf       , Uu^Uf       , Uu^Em       , Uu^Vu       , Uu          , Uu          , Ur          , Ur          , Uu^Es       , Uu          , Uh^Em       , Uu^Uf       , Uu^Uf       , Uu^Uf       , Xu          , Xu          , Xu          , Xu          , Xu          
Xu          , Xu          , Xu          , Xu          , Xu          , Uu^Uf       , Uu^Uf       , Uh^Emf      , Uu^Es       , Uu          , Uh          , Uh          , Cud         , Cud         , Ur          , Uu          , Uu          , Uu^Es       , Uh^Emf      , Uu^Uf       , Uu^Uf       , Uu^Uf       , Xu          , Xu          , Xu          , Xu          , Xu          , Xu          , Xu          , Uh          , Uh          , Uh          , Uu^Em       , Uu          , Ur          , Uu          , Cud         , Cud         , Uh          , Uu^Uf       , Uu^Uf       , Xu          , Xu          , Xu          , Xu          , Xu          
Xu          , Xu          , Xu          , Xu          , Xu          , Uu^Uf       , Uu^Uf       , Uh^Em       , Uh          , Uh          , Uu          , Cud         , 3 Kud       , Ur          , Uu          , Uh          , Uu^Es       , Uu^Em       , Uu^Uf       , Uu^Uf       , Xu          , Xu          , Xu          , Xu          , Xu          , Xu          , Xu          , Xu          , Xu          , Uh^Em       , Uh^Em       , Uu^Dr       , Uu^Uf       , Uu^Es       , Uu          , Ur          , Ur          , Cud         , Cud         , Uh          , Uh^Em       , Uu^Uf       , Xu          , Xu          , Xu          , Xu          
Xu          , Xu          , Xu          , Xu          , Xu          , Uu^Uf       , Uu^Uf       , Uh^Em       , Uu^Es       , Uu          , Uu          , Cud         , Cud         , Ur          , Uu          , Uh          , Uu^Em       , Uu^Em       , Uu^Uf       , Uu^Uf       , Xu          , Xu          , Xu          , Xu          , Xu          , Xu          , Xu          , Xu          , Xu          , Xu          , Uh^Em       , Uu^Uf       , Uu^Uf       , Uu^Em       , Uu^Dr       , Uu          , Ur^Es       , Ur          , Cud         , 7 Kud       , Cud         , Uh^Em       , Uu^Uf       , Xu          , Xu          , Xu          
Xu          , Xu          , Xu          , Xu          , Xu          , Uu^Uf       , Uu          , Uu          , Uu          , Uu          , Uh          , Uh          , Ur          , Ur          , Uu          , Uu^Dr       , Uu^Em       , Uu^Uf       , Xu          , Xu          , Xu          , Xu          , Xu          , Xu          , Xu          , Xu          , Xu          , Xu          , Xu          , Xu          , Xu          , Uu^Uf       , Uu^Uf       , Uu^Em       , Uu          , Uu          , Uu          , Ur          , Ur          , Cud         , Cud         , Uu^Uf       , Uu^Uf       , Uu^Uf       , Xu          , Xu          
