border_size=1
usage=map

Gg^Vh       , Gg          , Re^Gvs      , Gg          , Re^Gvs      , Gg          , Re^Gvs      , Gg          , Re^Gvs      , Gg          , Re^Gvs      , Gg          , Re^Gvs      , Gg          , Gg          , Gg          , Gg          , Gg          , Gg          , Gg          , Gg          , Rr          , Rr          , Rr          , Rp^Vhc      , Rr          , Ch          , Ch          , Ch          , Rr          , Rp^Vhc      , Rr          , Rp          , Rr          , Rr          , Rp          , Gg          , Gg          , Gg          , Gg^Vh       
Re^Gvs      , Re^Gvs      , Re^Gvs      , Re^Gvs      , Re^Gvs      , Re^Gvs      , Re^Gvs      , Re^Gvs      , Re^Gvs      , Re^Gvs      , Gg          , Re^Gvs      , Re^Gvs      , Re^Gvs      , Gg          , Gg          , Re^Gvs      , Gg          , Gg          , Gg          , Gg          , Ch          , Rp          , Rp          , Rp          , Rp          , Ch          , Kh^Xo       , Ch          , Rp          , Rp^Vhc      , Rr          , Rp          , Rp^Vhc      , Rr          , Gg          , Gg          , Gg          , Gg          , Gg          
Gg          , Re^Gvs      , Gg          , Re^Gvs      , Gg          , Gg          , Gg          , Gg          , Gg          , Gg          , Gg          , Gg          , Re^Gvs      , Re^Gvs      , Re^Gvs      , Re^Gvs      , Gg          , Gg          , Rr          , Gg          , Gg          , Ch          , Rr          , Rp^Vhc      , Rp          , Rp          , Rr          , Ch          , Rr^Xo       , Rr^Xo       , Rp^Xo       , Rr^Xo       , Rr^Xo       , Rp^Vhc      , Rr          , Ch          , Gg          , Gg          , Gg          , Gg          
Gg          , Gg          , Gg          , Gg          , Gg          , Gg          , Gg^Wm       , Gg          , Gg          , Gg          , Gg          , Re^Gvs      , Gg^Vh       , Re^Gvs      , Gg          , Gg          , Rr          , Rr          , Re^Gvs      , Rr          , Rr          , Rp          , Rp^Xo       , Rp^Xo       , Rr^Xo       , Rr          , Rp^Xo       , Rr^Xo       , Rp          , Rp          , Kh^Xo       , Rp          , Rr          , Rp^Xo       , Rr^Xo       , Ch          , Gg          , Gg          , Gg          , Gg          
Gg          , Gg          , Gg          , Gg          , Gg          , Gg          , Gg          , Gg          , Gg          , Gg          , Gg          , Re^Gvs      , Re^Gvs      , Re^Gvs      , Rr          , Rr          , Re^Gvs      , Re^Gvs      , Gg^Vh       , Re^Gvs      , Re^Gvs      , Ch^Xo       , Ch          , 2 Rp^Vhc    , Rr          , Rr^Xo       , Rr          , Rr          , Rp          , Ch          , Ch          , Ch          , Rp          , Rr^Xo       , Rr^Xo       , Ch          , Gg          , Gg          , Gg          , Gg          
Gg          , Gg^Vh       , Gg          , Gg          , Gg          , Gg          , Re^Gvs      , Gg          , Re^Gvs      , Re^Gvs      , Re^Gvs      , Re^Gvs      , Rr          , Rr          , Re^Gvs      , Re^Gvs      , Re^Gvs      , Re^Gvs      , Re^Gvs      , Re^Gvs      , Gg          , Gg^Xo       , Gg          , Gg          , Gg          , Rp          , Rp          , Rp^Vhc      , Rp          , Rr          , Rr          , Ch          , Rr          , 1 Rp^Vhc    , Gg          , Gg^Xo       , Gg^Xo       , Gg          , Gg          , Gg          
Gg          , Gg          , Gg          , Gg          , Gg          , Re^Gvs      , Re^Gvs      , Re^Gvs      , Re^Gvs      , Gg^Vh       , Rr          , Rr          , Re^Gvs      , Re^Gvs      , Re^Gvs      , Re^Gvs      , Gg          , Gg          , Gg          , Gg          , Gg^Xo       , Gg^Xo       , Gg          , Gg          , Gg          , Ch          , Ch          , Rr          , Rp          , Rr          , Rr          , Rr          , Ch          , Ch          , Gg          , Gg          , Re^Gvs      , Gg^Xo       , Gg^Xo       , Gg          
Gg          , Gg          , Gg          , Gg          , Gg          , Gg          , Re^Gvs      , Re^Gvs      , Rr          , Rr          , Re^Gvs      , Re^Gvs      , Re^Gvs      , Re^Gvs      , Gg          , Gg          , Gg          , Gg          , Gg^Xo       , Gg^Xo       , Re^Gvs      , Gg          , Gg          , Gg          , Gg          , Gg          , Gg          , Gg          , Rp          , Rp          , Gg          , Gg          , Gg^Wm       , Gg          , Re^Gvs      , Re^Gvs      , Re^Gvs      , Re^Xo       , Gg^Xo       , Gg          
Gg          , Gg          , Gg          , Gg          , Gg          , Gg          , Re^Gvs      , Rr          , Re^Gvs      , Re^Gvs      , Re^Gvs      , Re^Gvs      , Re^Gvs      , Re^Gvs      , Gg          , Gg          , Gg^Xo       , Gg^Xo       , Gg          , Re^Gvs      , Gg^Vh       , Re^Gvs      , Gg          , Gg          , Gg          , Gg          , Gg          , Gg          , Rp          , Gg          , Re^Gvs      , Gg          , Re^Gvs      , Re^Gvs      , Gg^Vh       , 8 Gg        , Re^Xo       , Gg^Xo       , Gg^Vh       , Gg          
Gg          , Gg          , Gg          , Gg          , Re^Gvs      , Re^Gvs      , Re^Gvs      , Rr          , Gg^Vh       , Re^Gvs      , Re^Gvs      , Re^Gvs      , Gg^Wm       , Re^Gvs      , Re^Gvs      , Gg^Xo       , Gg          , Gg          , Gg          , Re^Gvs      , Re^Gvs      , Re^Gvs      , Gg          , Gg          , Gg          , Gg          , Re^Gvs      , Re^Gvs      , Rp          , Re^Gvs      , Re^Gvs      , Re^Gvs      , Re^Gvs      , Re^Gvs      , Re^Gvs      , Re^Gvs      , Re^Gvs      , Gg^Xo       , Gg          , Gg          
Gg          , Gg          , Re^Gvs      , Re^Gvs      , Gg^Vh       , Re^Gvs      , Rr          , Rr          , Re^Gvs      , Re^Gvs      , Re^Gvs      , Re^Gvs      , Re^Gvs      , Re^Gvs      , Re^Xo       , Gg^Xo       , 3 Gg        , Gg          , Gg          , Gg          , Gg          , Gg          , Gg          , Gg          , Gg          , Re^Gvs      , Re^Gvs      , Rp          , Re^Gvs      , Gg          , Re^Gvs      , Re^Gvs      , Re^Gvs      , Gg          , Re^Gvs      , Re^Gvs      , Re^Gvs      , Gg^Xo       , Re^Gvs      , Gg          
Gg          , Gg          , Re^Gvs      , Re^Gvs      , Rr          , Rr          , Re^Gvs      , Gg          , Re^Gvs      , Re^Gvs      , Re^Gvs      , Re^Gvs      , Re^Gvs      , Re^Gvs      , Re^Xo       , Re^Gvs      , Re^Gvs      , Re^Gvs      , Re^Gvs      , Re^Gvs      , Gg          , Gg          , Gg          , Gg          , Gg          , Re^Gvs      , Re^Gvs      , Rp          , Gg          , Re^Gvs      , Re^Gvs      , Re^Gvs      , Re^Gvs      , Gg          , Gg          , Re^Gvs      , Gg          , Re^Xo       , Re^Xo       , Gg          
Rr          , Gg          , Rr          , Rr          , Re^Gvs      , Re^Gvs      , Re^Gvs      , Gg          , Re^Gvs      , Re^Gvs      , Gg          , Gg          , Gg          , Gg          , Gg^Xo       , Gg          , Re^Gvs      , Re^Gvs      , Gg          , Gg          , Gg          , Gg          , Re^Gvs      , Gg          , Gg          , Re^Gvs      , Re^Gvs      , Rp          , Rp          , Re^Gvs      , Re^Gvs      , Re^Gvs      , Re^Gvs      , Gg          , Gg          , Gg^Vh       , Re^Gvs      , Re^Xo       , Gg^Xo       , Gg          
Re^Gvs      , Rr          , Re^Gvs      , Gg^Vh       , Re^Gvs      , Re^Gvs      , Gg          , Re^Gvs      , Gg          , Re^Gvs      , Gg          , Gg          , Gg          , Gg^Xo       , Gg          , Gg          , Gg          , Gg          , Gg          , Gg          , Gg          , Re^Gvs      , Gg^Wm       , Re^Gvs      , Gg^Vh       , Gg          , Re^Gvs      , Re^Gvs      , Rp          , Re^Gvs      , Re^Gvs      , Re^Gvs      , Re^Gvs      , Gg          , Gg          , Gg          , Gg^Xo       , Gg^Xo       , Gg          , Gg          
Re^Gvs      , Gg          , Gg          , Re^Gvs      , Gg          , Gg          , Gg          , Gg          , Gg          , Gg          , Gg          , Gg          , Gg          , Gg^Xo       , 4 Gg        , Gg          , Gg          , Gg          , Re^Gvs      , Gg          , Gg          , Re^Gvs      , Gg          , Gg          , Gg          , Gg          , Rp          , Rp          , Re^Gvs      , Gg          , Re^Gvs      , Re^Gvs      , Re^Gvs      , Gg          , Re^Gvs      , 7 Gg        , Gg^Xo       , Gg          , Gg          , Gg          
Re^Gvs      , Gg          , Gg          , Gg          , Gg          , Gg          , Gg          , Gg          , Gg          , Gg          , Gg          , Gg          , Gg^Xo       , Gg^Xo       , Re^Gvs      , Gg          , Re^Gvs      , Re^Gvs      , Gg^Vh       , Re^Gvs      , Re^Gvs      , Gg          , Gg^Efm      , Gg          , Rp          , Rp          , Gg          , Re^Gvs      , Re^Gvs      , Gg^Wm       , Re^Gvs      , Re^Gvs      , Re^Gvs      , Re^Gvs      , Re^Gvs      , Re^Gvs      , Gg^Xo       , Gg^Vh       , Gg          , Gg          
Gg          , Gg          , Gs^Fds      , Gs^Fds      , Gg          , Gg          , Gg          , Gg          , Gg          , Gg^Wm       , Re^Xo       , Re^Xo       , Re^Gvs      , Re^Gvs      , Gg          , Gg          , Gg          , Re^Gvs      , Re^Gvs      , Re^Gvs      , Gg          , Gg          , Gg^Efm      , Rp          , Gg          , Gg          , Gg          , Re^Gvs      , Gg          , Gg          , Gg          , Re^Gvs      , Re^Gvs      , Re^Gvs      , Re^Gvs      , Re^Xo       , Re^Xo       , Gg          , Gg          , Gg          
Gs^Fds      , Gs^Fds      , Gs^Fds      , Gs^Fds      , Gg          , Gg          , Gg          , Gg          , Gg          , Re^Gvs      , Re^Xo       , Re^Xo       , Gg          , Gg          , Re^Gvs      , Gg          , Re^Gvs      , Re^Gvs      , Gg          , Gg          , Gg          , Gg          , Gg^Efm      , Rp          , Gg          , Gg          , Gg          , Gg          , Gg          , Gg          , Gg          , Gg          , Gs^Fds      , Gg          , Gg^Vh       , Gg          , Gg^Xo       , Gg^Xo       , Gg          , Gg          
Gs^Fds      , Gs^Fds      , Gs^Fds      , Gs^Fds      , Gs^Fds      , Gg          , Gg          , Gg          , Gg          , Re^Gvs      , Gg^Xo       , Gg^Vh       , Re^Gvs      , Re^Gvs      , Re^Gvs      , Re^Gvs      , Re^Gvs      , Re^Gvs      , Gg          , Gg          , 5 Gg        , Gg^Efm      , Gs^Fds      , Rp          , Re          , Gg          , Re^Gvs      , Re^Gvs      , Re^Gvs      , 6 Gg        , Gg          , Gg          , Gs^Fds      , Gg          , Gs^Fds      , Gg          , Gs^Fds      , Gg^Xo       , Gg          , Gg          
Gs^Fds      , Gs^Fds      , Gs^Fds      , Gs^Fds      , Gg^Vh       , Gs^Fds      , Gg          , Gg          , Gg          , Re^Gvs      , Re^Xo       , Re^Xo       , Re^Gvs      , Re^Gvs      , Re^Gvs      , Re^Gvs      , Gg          , Gg          , Gg          , Gg          , Gs^Fds      , Gs^Fds      , Gs^Fds      , Gs^Fds      , Re          , Re^Gvs      , Re^Gvs      , Gg^Vh       , Re^Gvs      , Re^Gvs      , Gg          , Gg          , Gs^Fds      , Gs^Fds      , Gs^Fds      , Gg^Xo       , Gs^Xo       , Gs^Xo       , Gs^Fds      , Gs^Fds      
Gs^Fds      , Gs^Fds      , Gs^Fds      , Gs^Fds      , Gs^Fds      , Gs^Fds      , Gg          , Gg          , Gg          , Gg          , Gg          , Re^Xo       , Gs^Fds      , Gs^Fds      , Gg^Wm       , Gg          , Gg          , Gg          , Gs^Fds      , Gs^Fds      , Gs^Fds      , Gs^Fds      , Gs^Fds      , Gs^Fds      , Re          , Gs^Fds      , Gg          , Re^Gvs      , Gg          , Gg          , Gs^Fds      , Gs^Fds      , Gs          , Gs^Fds      , Gs^Xo       , Gs^Xo       , Gs^Fds      , Gg          , Gs^Fds      , Gg          
Gs^Fds      , Gs^Fds      , Gs^Fds      , Gs^Fds      , Gs^Fds      , Gs^Fds      , Gg^Efm      , Gg          , Gg          , Gg          , Gs^Fds      , Gs^Xo       , Gs^Fds      , Gg          , Gg          , Gg          , Gg          , Gs^Fds      , Gs^Fds      , Gs^Fds      , Gg^Vh       , Gs^Fds      , Gs^Fds      , Re          , Gs^Fds      , Gs^Fds      , Gs^Xo       , Gg          , Gg^Xo       , Gs^Fds      , Gs^Xo       , Gs^Xo       , Gs^Xo       , Gs^Xo       , Gs^Fds      , Gs^Fds      , Gs^Fds      , Gg          , Gg          , Gg          
Gs^Fds      , Gs^Fds      , Gs^Fds      , Gs^Fds      , Gs^Fds      , Gs^Fds      , Gs^Fds      , Gg^Efm      , Gs^Fds      , Gs^Fds      , Gs^Fds      , Gs^Xo       , Gg^Xo       , Gg          , Gg          , Gg          , Gg          , Gs^Fds      , Gg^Efm      , Gs^Fds      , Re^Gvs      , Re^Gvs      , Re^Gvs      , Re          , Gg^Xo       , Gs^Xo       , Gs^Xo       , Gs^Xo       , Gs^Fds      , Gs^Xo       , Gs          , Gs^Fds      , Gs^Fds      , Gs^Fds      , Gs^Fds      , Gg^Efm      , Gs^Fds      , Gg          , Gg^Vh       , Gg          
Gs^Fds      , Gs^Fds      , Gs^Fds      , Gs^Fds      , Gs^Fds      , Gs^Fds      , Gs^Fds      , Gs^Fds      , Gs^Fds      , Gs^Fds      , Gs^Fds      , Gg          , Re^Gvs      , Gg^Xo       , Re^Xo       , Gg          , Gg          , Gs^Fds      , Gg^Xo       , Re^Gvs      , Re^Xo       , Re^Xo       , Re^Xo       , Re^Xo       , Re          , Gg^Efm      , Gg^Efm      , Gg^Efm      , Gg^Efm      , Gs^Fds      , Gs^Fds      , Gs^Fds      , Gs^Fds      , Gs^Fds      , Gs^Fds      , Gg^Efm      , Gs^Fds      , Gs^Fds      , Gs^Fds      , Gg          
Gs^Fds      , Gs^Fds      , Gs^Fds      , Gs^Fds      , Gs^Fds      , Gs^Fds      , Gs^Fds      , Gs^Fds      , Gs^Fds      , Gs^Fds      , Gs          , Gs          , Re^Gvs      , Re^Gvs      , Gg^Vh       , Re^Xo       , Gg^Xo       , Gs^Xo       , Gs^Fds      , Re^Xo       , Gg^Vh       , Re^Gvs      , Gs          , Gg^Efm      , Re          , Gs          , Gs          , Gs          , Gs          , Gg^Efm      , Gs^Fds      , Gs^Fds      , Gs^Fds      , Gs^Fds      , Gg^Efm      , Gg^Efm      , Gs^Fds      , Gs^Fds      , Gs^Fds      , Gg          
Gs^Fds      , Gs^Fds      , Gg^Vh       , Gs^Fds      , Gs^Fds      , Gs^Fds      , Gs^Fds      , Gs^Fds      , Gs^Fds      , Gs          , Gs          , Gg          , Gg          , Re^Gvs      , Re^Gvs      , Re^Gvs      , Gs^Fds      , Gs^Fds      , Gs^Fds      , Gs^Fds      , Gs^Fds      , Gg^Efm      , Gs          , Gg^Efm      , Gg^Efm      , Re          , Gs          , Gs          , Gs          , Gg^Efm      , Gs          , Gs^Fds      , Gg^Efm      , Gg^Efm      , Gg^Efm      , Gg^Efm      , Gs^Fds      , Gs^Fds      , Gs^Fds      , Gg          
Gs^Fds      , Gs^Fds      , Gs^Fds      , Gs^Fds      , Gs^Fds      , Gs^Fds      , Gs^Fds      , Gs^Fds      , Gs          , Gs          , Gg          , Gg          , Gg          , Gg          , Gg          , Gg          , Gs^Fds      , Gs^Fds      , Gs^Fds      , Gs^Fds      , Gs^Fds      , Gs^Fds      , Gs          , Re^Vct      , Gg^Efm      , Re          , Re          , Gs          , Gs          , Gs          , Gs^Fds      , Gs^Fds      , Gs^Fds      , Gg^Efm      , Gg^Efm      , Gs^Fds      , Gs^Fds      , Gs^Fds      , Gs^Fds      , Gs^Fds      
Gs^Fds      , Gs^Fds      , Gs^Fds      , Gs^Fds      , Gs^Fds      , Gs^Fds      , Gs^Fds      , Gs          , Gs          , Gs          , Re^Gvs      , Re^Gvs      , Re^Gvs      , Gg          , Gg          , Gg          , Gg          , Gs^Fds      , Gs^Fds      , Gs^Fds      , Gs^Fds      , Gs          , Gg^Efm      , Gg^Efm      , Gg^Efm      , Gg^Efm      , Gg^Efm      , Re          , Gg^Efm      , Gs          , Gs^Fds      , Gs^Fds      , Gs^Fds      , Gg^Efm      , Gs^Fds      , Gs^Fds      , Gs^Fds      , Gs^Fds      , Gg          , Gs^Fds      
Gs^Fds      , Gs^Fds      , Gs^Fds      , Gs^Fds      , Gs^Fds      , Gs^Fds      , Gs^Fds      , Gs          , Gs          , Re^Gvs      , Re^Gvs      , Re^Gvs      , Re^Gvs      , Gg          , Gg          , Gg          , Gg          , Gs^Fds      , Gs^Fds      , Gs^Fds      , Gs^Fds      , Gs^Fds      , Gg          , Gg^Efm      , Gg          , Gg^Efm      , Gg          , Re          , Gg^Efm      , Gs          , Gs          , Gs^Fds      , Gs          , Gs^Fds      , Gs^Fds      , Gs^Fds      , Gs^Fds      , Gs^Fds      , Gs^Fds      , Gg          
