border_size=1
usage=map

Ss, Ss, Gs^Fms, Gs^Fms, Ss^Bw|r, Gg, Gg, Gg, Gs^Fms, Gs^Ft, Ss, Ss, Ss, Ss, Gg, Gs^Fms, Gg, Gg, Gg, Gs^Ft, Gg, Ss, Gg, Gg, Gg, Ss, Ss, Ss, Gg, Gg, Gg, Gg, Ss
Gs^Fms, Gs^Fms, Gs^Fms, Gs^Fms, Ss^Bw|r, Ss, Chs, Chs, Gg, Gg, Chs, Gg, Gg, Gs^Fms, Gg, Gg, Ss, Gg, Gg, Ss, Gs^Fms, Gg, Gg, Gg, Gs^Fms, Gg, Gg, Gs^Fms, Gg, Gg, Gg, Ss, Ss
Ss, Ss, Gg, Ss, Rd, Chs, 3 Khs, Gs^Fms, Gg, Gg, Chs, Chs, Ss, Gs^Fms, Gg, Gg, Ss, Gs^Fms, Gs^Fms, Gg, Gs^Fms, Ss, Gg, Ss^Vm, Gg, Gs^Fms, Ss, Gs^Fms, Gs^Fms, Gg, Gg, Gg, Ss
Gg, Gg, Gg, Gg, Rd, Chs, Chs, Chs, Chs, Gs^Fms, Chs, Chs, Gs^Fms, Gg, Gg, Gg, Gg, Gg, Ss, Gg, Gs^Fms, Gs^Fms, Ss, Gg, Gg, Gs^Fms, Gs^Fms, Gg, Gg, Gg, Gg, Gg, Gg
Gg, Gg, Ss, Gg, Ss^Vhs, Rd, Chs, Chs, Chs, Chs, Ss, Ss, Gg, Gg, Gs^Fms, Gg, Gs^Fms, Ss, Ss, Ss, Gg, Ss, Gg, Gg, Gg, Gs^Fms, Ss, Ss, Gg, Gg, Gg, Gg, Gg
Ss, Ss, Ss, Ss, Ss, Ss^Bw|r, Chs, Chs, Ss, Gs^Fms, Gs^Fms, Gs^Fms, Gs^Fms, Gs^Fms, Ss, Gg, Gs^Fms, Ss^Vhs, Ss, Gs^Fms, Gs^Fms, Gg, Gg, Gg, Gg, Gg, Gg, Gg, Ss, Gg, Gg, Gg, Ss
Gs^Fms, Ss, Ss, Ss, Rd, Rd, Gs^Ft, Ss, Ss, Gs^Fms, Ss, Ss, Gs^Fms, Gs^Fms, Gs^Fms, Gs^Fms, Ss, Gg, Gg, Ss, Ss, Ss, Gg, Gg, Gg, Gg, Ss, Gs^Fms, Gs^Fms, Gg, Gg, Ss, Gg
Ss, Ss, Ss, Ss, Ss, Ss^Bw\r, Rd, Ss, Rd, Ss, Ss, Ss, Gs^Fms, Gs^Fms, Gg, Gs^Fms, Gg, Gg, Gs^Fms, Gg, Gg, Ss, Ss, Gg, Gs^Fms, Gs^Fms, Gg, Ss, Gg, Gg, Gg, Gg, Ss
Ss, Ss, Ss, Ss, Gg, Gg, Ss, Rd, Ss, Ss^Bw\r, Ss^Bw\r, Ss, Ss, Ss, Gs^Fms, Gs^Fms, Gs^Fms, Ss, Gs^Fms, Gs^Fms, Gs^Fms, Gs^Fms, Ss, Ss, Ss, Gs^Fms, Gs^Fms, Gg, Gg, Gg, Gg, Ss, Gg
Ss, Ss, Ss, Gg, Ss, Ss, Ss, Gs^Fms, Ss, Ss^Vhs, Ss, Ss^Bw\r, Rd, Ss, Gg, Ss, Ss, Ss, Gs^Fms, Ss, Gg, Gs^Fms, Gs^Fms, Ss, Gg, Ss, Ss, Ss, Gs^Fms, Gg, Ss, Gg, Ss
Ss, Gs^Fms, Gs^Fms, Ss, Ss, Ss, Gs^Fms, Gs^Fms, Ss, Ss, Ss, Ss, Ss, Rd, Rd, Gg, Gg, Ss, Gs^Fms, Gg, Ss, Gs^Fms, Ss, Gg, Gg, Ss, Gs^Fms, Gs^Fms, Gs^Fms, Gs^Fms, Gg, Gg, Ss
Ss, Ss, Gs^Fms, Gs^Fms, Ss, Gs^Fms, Gs^Fms, Ss, Gs^Fms, Gs^Fms, Gs^Fms, Ss, Gs^Fms, Gs^Fms, Rd, Gg, Gg, Gs^Fms, Ss, Gg, Gs^Fms, Ss^Vm, Gg, Gs^Fms, Gs^Fms, Gs^Fms, Gs^Fms, Ss, Gg, Gg, Gg, Gg, Gg
Ss, Ss, Ss, Gs^Fms, Gs^Fms, Gs^Fms, Ss, Gs^Fms, Gs^Fms, Gs^Fms, Gs^Fms, Gs^Fms, Gs^Fms, Ss, Rd, Gs^Fms, Gs^Fms, Gs^Fms, Ss, Ss, Ss, Ss, Gs^Fms, Ss, Gg, Gs^Fms, Ss, Gs^Fms, Gs^Fms, Gg, Gg, Gg, Ss
Ss, Ss, Ss, Ss, Gs^Fms, Gs^Fms, Ss, Gs^Fms, Gs^Fms, Ss, Ss, Gs^Fms, Gs^Fms, Gs^Fms, Ss, Rd, Rd, Gs^Fms, Gs^Fms, Gg, Gg, Ss, Ss, Ss, Gs^Fms, Gs^Fms, Gg, Gg, Ss, Ss, Gg, Ss, Gg
Gs^Fms, Ss, Ss, Ss, Gs^Fms, Gs^Fms, Gs^Fms, Ss, Ss, Ss, Ss^Vm, Ss, Gs^Fms, Ss, Ss, Gs^Fms, Gs^Fms, Rd, Rd, Gs^Fms, Gs^Fms, Ss, Ss, Gs^Fms, Gg, Gs^Fms, Ss, Ss, Gg, Gg, Gg, Gg, Ss
Gs^Fms, Gg, Gs^Fms, Gs^Fms, Gs^Fms, Gs^Fms, Gs^Fms, Gs^Fms, Gs^Fms, Ss, Ss, Ss, Gs^Fms, Ss, Ss, Ss, Ss, Ss, Ss, Rd, Gg, Gg, Ss, Gg, Ss, Ss, Gg, Ss, Gg, Gg, Gg, Gg, Gg
Ss, Gg, Ss, Gs^Fms, Gs^Fms, Gs^Fms, Ss, Gs^Fms, Ss, Gs^Fms, Ss, Ss, Gs^Fms, Ss, Ss, Ss, Ss, Ss, Ss, Rd, Ss, Ss, Gg, Gg, Gg, Gg, Gg, Gg, Ss, Gg, Ss, Gg, Ss
Ss, Ss, Ss, Gs^Fms, Gs^Fms, Gs^Fms, Gs^Fms, Ss, Gs^Fms, Gs^Fms, Ss, Ss, Gs^Fms, Ss, Ss, Gg, Ss, Ss, Ss^Vm, Rd, Rd, Ss, Rd, Gg, Gg, Chr, Gg, Gg, Gg, Ss, Gg, Gg, Gg
Ss, Ss, Ss, Ss, Ss, Ss, Ss, Gs^Fms, Ss, Ss, Gs^Fms, Gs^Fms, Ss, Ss, Ss, Gg, Gg, Ss, Ss, Gg, Ss, Rd, Gg, Rd, Rp, Chr, Chr, Gg, Gg, Gg, Ss, Gg, Gg
Gs^Fms, Gs^Fms, Ss, Ss, Chs, Ss, Ss^Vhs, Ss, Chs, Chs, Chs, Gs^Fms, Ss, Ss, Ss, Gg, Gg, Ss, Ss, Ss, Ss, Gg, Rp, Rp, Chr, Chr, 1 Khr, Chr, Chr, Gg, Gg, Gg, Rd
Ss, Ss, Chs, Chs, Gg, Chs, Chs, Gg, Chs, Chs, Chs, Chs, Ss, Ss, Ss, Ss, Ss, Gg, Gg, Ss, Ss^Bw/r, Rp, Gg, Gg, Gg, Chr, Chr, Chr, Chr, Rd, Rd, Rd, Gg
Gg, Chs, Chs, Gg, Ss, Gs^Fms, 2 Khs, Chs, Chs, Gg, Gg, Chs, Gg, Ss, Gg, Ss, Ss, Ss, Rp, Rp, Gg, Ss, Ss, Gg, Gg, Gg, Gg, Gg, Gg, Gg, Gg, Gg, Ss
Ss, Chs, Chs, Chs, Ss, Gs^Fms, Gs^Fms, Chs, Gg, Gg, Gg, Gg, Gg, Gg, Ss, Gg, Ss^Bw/r, Ss^Bw/r, Ss, Gg, Gg, Gg, Gg, Ss, Ss^Vhs, Ss, Ss, Gg, Gg, Gg, Gg, Gg, Ss
Ss, Ss, Ss, Ss, Ss, Ss, Gs^Fms, Chs, Ss^Vhs, Gg, Ss, Gg, Ss, Ss, Ss, Gg, Ss, Ss, Ss, Ss, Gs^Fms, Ss, Gg, Ss, Ss, Ss, Gg, Gg, Gg, Gg, Gg, Ss, Ss
Gg, Gs^Fms, Gs^Fms, Ss, Gs^Fms, Ss, Ss, Gs^Fms, Gs^Fms, Ss, Ss, Ss, Ss, Ss, Ss, Ss^Bw|r, Ss, Ss, Ss, Ss, Gs^Fms, Ss, Ss, Gg, Gg, Ss, Ss, Ss, Gg, Gg, Ss, Gg, Ss
