border_size=1
usage=map

Ss          , Ss          , Gs^Ft       , Gs^Ft       , Ss^Bw|r     , Gg          , Gg          , Gg          , Gs^Ft       , Gs^Ft       , Ss          , Ss          , Ss          , Ss          , Gg          , Gs^Ft       , Gg          , Gg          , Gg          , Gs^Ft       , Gg          , Ss          , Gg          , Gg          , Gg          , Ss          , Ss          , Ss          , Gg          , Gg          , Gg          , Gg          , Ss          
Gs^Ft       , Gs^Ft       , Gs^Ft       , Gs^Ft       , Ss^Bw|r     , Ss          , Ss          , Ss          , Gg          , Gg          , Ss          , Gg          , Gg          , Gs^Ft       , Gg          , Gg          , Ss          , Gg          , Gg          , Ss          , Gs^Ft       , Gg          , Gg          , Gg          , Gs^Ft       , Gg          , Gg          , Gs^Ft       , Gg          , Gg          , Gg          , Ss          , Ss          
Ss          , Ss          , Gg          , Ss          , Rd          , Chs         , 3 Khs       , Gs^Ft       , Gg          , Gg          , Ss          , Ss          , Ss          , Gs^Ft       , Gg          , Gg          , Ss          , Gs^Ft       , Gs^Ft       , Gg          , Gs^Ft       , Ss          , Gg          , Ss^Vm       , Gg          , Gs^Ft       , Ss          , Gs^Ft       , Gs^Ft       , Gg          , Gg          , Gg          , Ss          
Gg          , Gg          , Gg          , Gg          , Rd          , Chs         , Chs         , Chs         , Chs         , Gs^Ft       , Ss          , Ss          , Gs^Ft       , Gg          , Gg          , Gg          , Gg          , Gg          , Ss          , Gg          , Gs^Ft       , Gs^Ft       , Ss          , Gg          , Gg          , Gs^Ft       , Gs^Ft       , Gg          , Gg          , Gg          , Gg          , Gg          , Gg          
Gg          , Gg          , Ss          , Gg          , Ss^Vhs      , Rd          , Chs         , Chs         , Ss          , Ss          , Ss          , Ss          , Gg          , Gg          , Gs^Ft       , Gg          , Gs^Ft       , Ss          , Ss          , Ss          , Gg          , Ss          , Gg          , Gg          , Gg          , Gs^Ft       , Ss          , Ss          , Gg          , Gg          , Gg          , Gg          , Gg          
Ss          , Ss          , Ss          , Ss          , Ss          , Ss^Bw|r     , Ss          , Ss          , Ss          , Gs^Ft       , Gs^Ft       , Gs^Ft       , Gs^Ft       , Gs^Ft       , Ss          , Gg          , Gs^Ft       , Ss^Vhs      , Ss          , Gs^Ft       , Gs^Ft       , Gg          , Gg          , Gg          , Gg          , Gg          , Gg          , Gg          , Ss          , Gg          , Gg          , Gg          , Ss          
Gs^Ft       , Ss          , Ss          , Ss          , Rd          , Rd          , Gs^Ft       , Ss          , Ss          , Gs^Ft       , Ss          , Ss          , Gs^Ft       , Gs^Ft       , Gs^Ft       , Gs^Ft       , Ss          , Gg          , Gg          , Ss          , Ss          , Ss          , Gg          , Gg          , Gg          , Gg          , Ss          , Gs^Ft       , Gs^Ft       , Gg          , Gg          , Ss          , Gg          
Ss          , Ss          , Ss          , Ss          , Ss          , Ss^Bw\r     , Rd          , Ss          , Rd          , Ss          , Ss          , Ss          , Gs^Ft       , Gs^Ft       , Gg          , Gs^Ft       , Gg          , Gg          , Gs^Ft       , Gg          , Gg          , Ss          , Ss          , Gg          , Gs^Ft       , Gs^Ft       , Gg          , Ss          , Gg          , Gg          , Gg          , Gg          , Ss          
Ss          , Ss          , Ss          , Ss          , Gg          , Gg          , Ss          , Rd          , Ss          , Ss^Bw\r     , Ss^Bw\r     , Ss          , Ss          , Ss          , Gs^Ft       , Gs^Ft       , Gs^Ft       , Ss          , Gs^Ft       , Gs^Ft       , Gs^Ft       , Gs^Ft       , Ss          , Ss          , Ss          , Gs^Ft       , Gs^Ft       , Gg          , Gg          , Gg          , Gg          , Ss          , Gg          
Ss          , Ss          , Ss          , Gg          , Ss          , Ss          , Ss          , Gs^Ft       , Ss          , Ss^Vhs      , Ss          , Ss^Bw\r     , Rd          , Ss          , Gg          , Ss          , Ss          , Ss          , Gs^Ft       , Ss          , Gg          , Gs^Ft       , Gs^Ft       , Ss          , Gg          , Ss          , Ss          , Ss          , Gs^Ft       , Gg          , Ss          , Gg          , Ss          
Ss          , Gs^Ft       , Gs^Ft       , Ss          , Ss          , Ss          , Gs^Ft       , Gs^Ft       , Ss          , Ss          , Ss          , Ss          , Ss          , Rd          , Rd          , Gg          , Gg          , Ss          , Gs^Ft       , Gg          , Ss          , Gs^Ft       , Ss          , Gg          , Gg          , Ss          , Gs^Ft       , Gs^Ft       , Gs^Ft       , Gs^Ft       , Gg          , Gg          , Ss          
Ss          , Ss          , Gs^Ft       , Gs^Ft       , Ss          , Gs^Ft       , Gs^Ft       , Ss          , Gs^Ft       , Gs^Ft       , Gs^Ft       , Ss          , Gs^Ft       , Gs^Ft       , Rd          , Gg          , Gg          , Gs^Ft       , Ss          , Gg          , Gs^Ft       , Ss^Vm       , Gg          , Gs^Ft       , Gs^Ft       , Gs^Ft       , Gs^Ft       , Ss          , Gg          , Gg          , Gg          , Gg          , Gg          
Ss          , Ss          , Ss          , Gs^Ft       , Gs^Ft       , Gs^Ft       , Ss          , Gs^Ft       , Gs^Ft       , Gs^Ft       , Gs^Ft       , Gs^Ft       , Gs^Ft       , Ss          , Rd          , Gs^Ft       , Gs^Ft       , Gs^Ft       , Ss          , Ss          , Ss          , Ss          , Gs^Ft       , Ss          , Gg          , Gs^Ft       , Ss          , Gs^Ft       , Gs^Ft       , Gg          , Gg          , Gg          , Ss          
Ss          , Ss          , Ss          , Ss          , Gs^Ft       , Gs^Ft       , Ss          , Gs^Ft       , Gs^Ft       , Ss          , Ss          , Gs^Ft       , Gs^Ft       , Gs^Ft       , Ss          , Rd          , Rd          , Gs^Ft       , Gs^Ft       , Gg          , Gg          , Ss          , Ss          , Ss          , Gs^Ft       , Gs^Ft       , Gg          , Gg          , Ss          , Ss          , Gg          , Ss          , Gg          
Gs^Ft       , Ss          , Ss          , Ss          , Gs^Ft       , Gs^Ft       , Gs^Ft       , Ss          , Ss          , Ss          , Ss^Vm       , Ss          , Gs^Ft       , Ss          , Ss          , Gs^Ft       , Gs^Ft       , Rd          , Rd          , Gs^Ft       , Gs^Ft       , Ss          , Ss          , Gs^Ft       , Gg          , Gs^Ft       , Ss          , Ss          , Gg          , Gg          , Gg          , Gg          , Ss          
Gs^Ft       , Gg          , Gs^Ft       , Gs^Ft       , Gs^Ft       , Gs^Ft       , Gs^Ft       , Gs^Ft       , Gs^Ft       , Ss          , Ss          , Ss          , Gs^Ft       , Ss          , Ss          , Ss          , Ss          , Ss          , Ss          , Rd          , Gg          , Gg          , Ss          , Gg          , Ss          , Ss          , Gg          , Ss          , Gg          , Gg          , Gg          , Gg          , Gg          
Ss          , Gg          , Ss          , Gs^Ft       , Gs^Ft       , Gs^Ft       , Ss          , Gs^Ft       , Ss          , Gs^Ft       , Ss          , Ss          , Gs^Ft       , Ss          , Ss          , Ss          , Ss          , Ss          , Ss          , Rd          , Ss          , Ss          , Gg          , Gg          , Gg          , Gg          , Gg          , Gg          , Ss          , Gg          , Ss          , Gg          , Ss          
Ss          , Ss          , Ss          , Gs^Ft       , Gs^Ft       , Gs^Ft       , Gs^Ft       , Ss          , Gs^Ft       , Gs^Ft       , Ss          , Ss          , Gs^Ft       , Ss          , Ss          , Gg          , Ss          , Ss          , Ss^Vm       , Rd          , Rd          , Ss          , Rd          , Gg          , Gg          , Chr         , Gg          , Gg          , Gg          , Ss          , Gg          , Gg          , Gg          
Ss          , Ss          , Ss          , Ss          , Ss          , Ss          , Ss          , Gs^Ft       , Ss          , Ss          , Gs^Ft       , Gs^Ft       , Ss          , Ss          , Ss          , Gg          , Gg          , Ss          , Ss          , Gg          , Ss          , Rd          , Gg          , Rd          , Rp          , Chr         , Chr         , Gg          , Gg          , Gg          , Ss          , Gg          , Gg          
Gs^Ft       , Gs^Ft       , Ss          , Ss          , Ss          , Ss          , Ss^Vhs      , Ss          , Ss          , Ss          , Ss          , Gs^Ft       , Ss          , Ss          , Ss          , Gg          , Gg          , Ss          , Ss          , Ss          , Ss          , Gg          , Rp          , Rp          , Chr         , Chr         , 1 Khr       , Chr         , Chr         , Gg          , Gg          , Gg          , Rd          
Ss          , Ss          , Ss          , Ss          , Gg          , Chs         , Chs         , Gg          , Gg          , Ss          , Ss          , Ss          , Ss          , Ss          , Ss          , Ss          , Ss          , Gg          , Gg          , Ss          , Ss^Bw/r     , Rp          , Gg          , Gg          , Gg          , Chr         , Chr         , Chr         , Chr         , Rd          , Rd          , Rd          , Gg          
Gg          , Ss          , Ss          , Gg          , Ss          , Gs^Ft       , 2 Khs       , Chs         , Gg          , Gg          , Gg          , Ss          , Gg          , Ss          , Gg          , Ss          , Ss          , Ss          , Rp          , Rp          , Gg          , Ss          , Ss          , Gg          , Gg          , Gg          , Gg          , Gg          , Gg          , Gg          , Gg          , Gg          , Ss          
Ss          , Ss          , Ss          , Ss          , Ss          , Gs^Ft       , Gs^Ft       , Chs         , Gg          , Gg          , Gg          , Gg          , Gg          , Gg          , Ss          , Gg          , Ss^Bw/r     , Ss^Bw/r     , Ss          , Gg          , Gg          , Gg          , Gg          , Ss          , Ss^Vhs      , Ss          , Ss          , Gg          , Gg          , Gg          , Gg          , Gg          , Ss          
Ss          , Ss          , Ss          , Ss          , Ss          , Ss          , Gs^Ft       , Chs         , Ss^Vhs      , Gg          , Ss          , Gg          , Ss          , Ss          , Ss          , Gg          , Ss          , Ss          , Ss          , Ss          , Gs^Ft       , Ss          , Gg          , Ss          , Ss          , Ss          , Gg          , Gg          , Gg          , Gg          , Gg          , Ss          , Ss          
Gg          , Gs^Ft       , Gs^Ft       , Ss          , Gs^Ft       , Ss          , Ss          , Gs^Ft       , Gs^Ft       , Ss          , Ss          , Ss          , Ss          , Ss          , Ss          , Ss^Bw|r     , Ss          , Ss          , Ss          , Ss          , Gs^Ft       , Ss          , Ss          , Gg          , Gg          , Ss          , Ss          , Ss          , Gg          , Gg          , Ss          , Gg          , Ss          
