Xos, Xos, Xos, Xos, Xos, Xos, Xos, Xos, Xos, Xos, Xos, Xos, Xos, Xos, Xos, Xos, Xos, Xos, Xos, Xos, Xos, Xos, Xos, Xos, Xos, Xos, Xos, Xos, Xos, Xos, Xos, Xos, Xos, Xos, Xos, Xos, Xos, Xos, Xos, Xos, Xos, Xos, Xos, Xos, Xos, Xos, Xos, Xos, Xos, Xos, Xos, Xu, Xu, Xu, Xu
Xos, Xos, Xos, Xos, Xos, Xos, Xos, Xos, Xos, Xos, Xos, Xos, Xos, Xos, Xos, Xos, Xos, Xos, Xos, Xos, Xos, Xos, Xos, Xos, Xos, Xos, Xos, Xos, Xos, Xos, Xos, Xos, Xos, Xos, Xos, Xos, Urb, Xos, Urb, Xos, Urb, Urb, Urb, Xos, Xos, Xos, Xos, Xos, Xos, Xos, Xos, Xu, Xu, Xu, Xu
Xos, Xos, Xos, Xos, Urb, Urb, Urb, Xos, Xos, Xos, Xos, Xos, Xos, Xos, Xos, Xos, Urb, Xos, Xos, Xos, Xos, Xos, Xos, Xos, Xos, Xos, Xos, Xos, Xos, Xos, Xos, Xos, Xos, Xos, Xos, Xos, Uu^Vu, Urb, Urb, Urb, Urb, Urb, Urb, Urb, Urb, Xos, Xos, Xos, Xos, Xos, Xos, Xu, Xu, Xu, Xu
Xos, Xos, Xos, Xos, Urb, Urb, Urb, Urb, Urb, Xos, Xos, Xos, Urb, Urb, Urb, Urb, Urb, Urb, Urb, Xos, Urb, Urb, Urb, Xos, Uu^Vu, Xos, Xos, Xos, Xos, Xos, Urb, Xos, Urb, Urb, Urb, Urb, Urb, Urb, Urb, Urb, Urb, Urb, Urb, Urb, Urb, Xos, Xos, Xos, Xos, Xos, Xu, Xu, Xu, Xu, Uh^Dr
Xos, Xos, Xos, Urb, Urb, Urb, Urb, Urb, Urb, Urb, Urb, Urb, Urb, Urb, Urb, Urb, Urb, Urb, Urb, Urb, Xos, Urb, Urb, Urb, Urb, Urb, Urb, Xos, Urb, Urb, Urb, Urb, Urb, Urb, Urb, Urb, Urb, Urb, Xos, Urb, Xos, Xos, Urb, Urb, Urb, Uu^Vu, Xos, Xos, Xos, Xos, Xu, Xu, Uh^Dr, Uh^Dr, Uh^Dr
Xos, Xos, Xos, Urb, Urb, Urb, Urb, Urb, Urb, Urb, Urb, Urb, Urb, Urb, Urb, Urb, Urb, Xos, Xos, Xos, Xos, Urb, Urb, Urb, Urb, Urb, Urb, Urb, Urb, Urb, Xos, Xos, Xos, Urb, Urb, Urb, Urb, Urb, Xos, Xos, Xos, Xos, Xos, Urb, Urb, Urb, Urb, Xos, Xos, Xos, Uh^Dr, Uh^Dr, Uu^Dr, Uh^Dr, Uh^Dr
Xos, Xos, Urb, Urb, Urb, Urb, Urb, Urb, Urb, Urb, Urb, Urb, Urb, Urb, Urb, Urb, Urb, Xos, Xos, Xos, Xos, Urb, Urb, Urb, Xos, Xos, Urb, Urb, Urb, Xos, Xos, Xos, Xos, Xos, Xos, Xos, Urb, Urb, Xos, Xos, Xos, Xos, Urb, Urb, Urb, Urb, Urb, Urb, Uu, Uh, Uh, Uh^Dr, Uu^Dr, Uh^Dr, Xu
Xos, Urb, Cud, Cud, Cud, Uu^Vu, Urb, Urb, Urb, Urb, Urb, Urb, Xos, Xos, Xos, Urb, Urb, Urb, Urb, Xos, Xos, Urb, Urb, Urb, Xos, Xos, Xos, Urb, Urb, Urb, Urb, Xos, Xos, Xos, Xos, Urb, Uu^Vu, Urb, Urb, Xos, Xos, Urb, Urb, Urb, Xos, Urb, Urb, Urb, Uu, Uu, Cud, Cud, Cud, Xu, Xu
Urb, Urb, Cud, Cud, 1 Kud, Cud, Urb, Urb, Urb, Urb, Urb, Urb, Urb, Xos, Xos, Urb, Urb, Urb, Urb, Urb, Urb, Urb, Urb, Urb, Uu^Vu, Xos, Xos, Xos, Xos, Urb, Urb, Urb, Urb, Urb, Urb, Urb, Urb, Urb, Urb, Urb, Urb, Urb, Urb, Urb, Xos, Xos, Xos, Urb, Urb, Cud, Kud, Cud, Cud, Xu, Xu
Urb, Urb, Cud, Cud, Cud, Cud, Urb, Urb, Xos, Urb, Urb, Urb, Urb, Xos, Xos, Xos, Xos, Urb, Urb, Urb, Urb, Urb, Urb, Urb, Urb, Xos, Xos, Xos, Xos, Xos, Xos, Urb, Urb, Urb, Xos, Urb, Urb, Xos, Xos, Urb, Xos, Urb, Urb, Xos, Xos, Xos, Xos, Xos, Urb, Cud, Cud, Cud, Cud, Xu, Xu
Urb, Urb, Urb, Cud, Urb, Urb, Xos, Xos, Xos, Urb, Urb, Urb, Urb, Xos, Xos, Xos, Xos, Xos, Xos, Urb, Urb, Urb, Urb, Urb, Ai^_ml, Urb, Urb, Urb, Urb, Xos, Urb, Xos, Urb, Urb, Urb, Xos, Xos, Xos, Xos, Xos, Xos, Urb, Urb, Xos, Xos, Xos, Urb, Xos, Uu, Uu, Uu, Cud, Qxu, Xu, Xu
Urb, Urb, Urb, Urb, Xos, Xos, Xos, Xos, Xos, Xos, Urb, Urb, Urb, Uu^Vu, Xos, Xos, Xos, Xos, Xos, Xos, Urb, Urb, Ai^_ml, Ai^_ml, Ai^_mll, Ai^_ml, Ai^_ml, Ai^_ml, Ai^_ml, Urb, Urb, Urb, Urb, Urb, Urb, Xos, Xos, Xos, Xos, Xos, Xos, Urb, Urb, Urb, Urb, Xos, Urb, Urb, Ur, Uu, Uu, Uu, Qxu, Xu, Xu
Xos, Xos, Xos, Xos, Xos, Xos, Xos, Xos, Xos, Urb, Urb, Urb, Urb, Xos, Xos, Uu^Vu, Urb, Urb, Urb, Urb, Ai^Bw\r, Ai^_ml, Ai^_ml, Ai^_mll, Ai^_ml, Ai^_mll, Ai^_ml, Ai^_mll, Ai^_mll, Ai^_ml, Ai^Bw/r, Urb, Urb, Urb, Urb, Urb, Urb, Xos, Urb, Xos, Urb, Urb, Urb, Urb, Urb, Urb, Uu, Uu, Uu, Ur, Ur, Qxu, Qxu, Xu, Xu
Xos, Xos, Xos, Xos, Xos, Xos, Xos, Xos, Urb, Urb, Urb, Urb, Xos, Xos, Xos, Urb, Urb, Urb, Ai^_ml, Ai^_ml, Ai^_ml, Ai^Bw\r, Rra, Ai^_ml, Ha^Ii, Ai^_ml, Ha^Ii, Ai^_ml, Ai^Bw/r, Ai^Bw/r, Ai^_ml, Ai^_ml, Uu, Uh, Uu, Urb, Urb, Urb, Urb, Urb, Urb, Urb, Uu, Urb, Uu, Uu, Uh, Uh, Qxu, Qxu, Qxu, Qxu^Bw\r, Qxu^Bw\r, Xu, Xu
Xos, Xos, Xos, Xos, Xos, Xos, Urb, Urb, Urb, Urb, Urb, Urb, Urb, Xos, Urb, Urb, Urb, Urb, Ai^_ml, Ai^_ml, Ai^_mll, Ai^_ml, Ai^_ml, Rra^Ii, Aa^Ii, Aa^Ii, Aa^Ii, Rra^Ii, Aa^Ii, Ai^_ml, Ai^_mll, Ai^_ml, Uu, Uu, Uu, Uu, Ur, Urb, Urb, Urb, Uu, Uu, Xu, Uu^Vu, Xu, Uh, Qxu, Qxu, Qxu, Qxu, Qxu, Qxu, Ur, Ur, Xu
Xos, Xos, Xos, Xos, Urb, Urb, Urb, Urb, Urb, Urb, Urb, Urb, Xos, Urb, Urb, Urb, Urb, Ai^_ml, Ai, Ai^_mll, Ai^_mll, Ai^_ml, Ai^_ml, Aa^Ii, Ha^Cov, Ms^Xm, Ms^Xm, Aa^Ii, Aa^Ii, Ai^_ml, Ai^_mll, Ai^_ml, Uu, Uu^Vu, Uh, Uu, Ur, Uu, Uu, Uu, Uh, Xu, Xu, Xu, Qxu, Qxu, Qxu, Qxe, Qxu, Uu, Ur, Ur, Uh, Uu^Vu, Xos
Xos, Xos, Urb, Urb, Urb, Urb, Urb, Urb, Xos, Xos, Xos, Urb, Xos, Xos, Xos, Urb, Urb, Ai^_ml, Ai^_ml, Ai^_mll, Ai^_mll, Ai^_mll, Ai^_ml, Aa^Ii, Ha^Cov, 3 Ms^Kov, Ha^Cov, Ha^Cov, Aa^Ii, Ai^_ml, Ai^_mll, Ai^_ml, Uu, Xu, Xu, Uh, Ur, Ur, Ur, Uu, Uu, Uh, Qxu, Qxu, Qxe, Qxu, Uu, Qxu, Ur, Ur, Xos, Xos, Xos, Xos, Xos
Xos, Xos, Urb, Urb, Urb, Urb, Urb, Urb, Xos, Xos, Xos, Xos, Xos, Xos, Xos, Urb, Urb, Urb, Ai^_ml, Ai^_mll, Ai^_mll, Ai^_ml, Ai^_ml, Aa^Ii, Aa^Ii, Ha^Cov, Aa^Ii, Aa^Ii, Rra^Ii, Ai^_ml, Ai^_ml, Ai^_ml, Uu, Xu, Uu, Uu, Ur, Uu, Uu, Ur, Uu, Qxu, Qxu, Qxe, Qxu, Qxu, Uu, Uu, Ur, Xos, Xos, Xos, Xos, Xos, Xos
Xu, Uu^Vu, Uu, Urb, Urb, Urb, Urb, Urb, Xos, Xos, Xos, Xos, Xos, Xos, Urb, Urb, Xos, Urb, Urb, Ai^_ml, Ai^_ml, Ai^_ml, Ai^Bw/r, Rra^Ii, Ai^_ml, Aa^Ii, Ai^_ml, Ai^_ml, Ai^Bw|r, Ai^_ml, Ai^_ml, Ur, Ur, Uu, Ur, Uu, Ur, Uu, Uu, Qxu, Qxu^Bw|r, Qxu^Bw\r, Qxu^Bw\r, Qxu, Uu, Uu, Uh, Uu, Urb, Urb, Urb, Urb, Urb, Xos, Xos
Xu, Xu, Xu, Uu, Uh, Uu, Uu, Urb, Urb, Xos, Xos, Xos, Xos, Xos, Urb, Urb, Xos, Urb, Urb, Ai^_ml, Ai^Bw/r, Ai^Bw/r, Ai^_ml, Ai^_ml, Ai^_ml, Ai^_ml, Ai^_mll, Ai^_ml, Ai^Bw|r, Ai^_ml, Ai^_ml, Ai^_ml, Ai^_ml, Ur, Uh, Ur, Uh, Ur, Qxu^Bw\r, Qxu, Qxu^Bw|r, Qxu, Uu^Vu, Ur, Uu, Uh, Xos, Urb, Urb, Urb, Urb, Urb, Urb, Urb, Xos
Xu, Xu, Xu, Xu, Uu^Uf, Uu, Uu, Urb, Urb, Urb, Urb, Xos, Urb, Urb, Urb, Xos, Xos, Xos, Urb, Urb, Uu, Ai^_ml, Ai^_ml, Ai^_mll, Ai^_ml, Ai^_mll, Ai^_mll, Ai^_ml, Ur, Uu, Uu, Ai^_ml, Ai^_ml, Ai^_ml, Qxu, Uh, Qxu, Qxu, Qxu, Qxu^Bw\r, Ur, Uu, Uu, Ur, Xos, Xos, Xos, Xos, Urb, Urb, Urb, Urb, Urb, Xos, Xos
Xu, Xu, Xu, Xu, Uu^Uf, Uu^Uf, Cud, Uu, Uu^Vu, Urb, Urb, Urb, Urb, Urb, Xos, Xos, Xos, Xos, Uh, Urb, Uh, Uu, Uh, Ai^_ml, Uh, Ai^_ml, Ai^_ml, Ai^_ml, Ur, Uu^Vu, Xu, Uh, Ai^_ml, Qxu, Qxu, Qxu, Qxu, Qxu, Qxu, Qxu, Uu, Ur, Ur, Ur, Xos, Xos, Xos, Xos, Urb, Urb, Urb, Urb, Urb, Xos, Xos
Xu, Xu, Xu, Xu, Cud, Cud, Kud, Cud, Cud, Uh, Uh, Uh, Uh, Uu, Uh, Uu, Uh, Uh, Uh, Uh, Uh, Uh, Xu, Uh, Uh, Uh, Ur, Ur, Uu, Xu, Xu, Uh, Qxu, Qxe, Qxe, Qxe, Qxu, Qxu, Qxu, Uh, Uh, Uu, Uu, Ur, Urb, Xos, Urb, Urb, Urb, Urb, Urb, Uu^Vu, Urb, Xos, Xos
Xu, Xu, Xu, Uh, Cud, Cud, Cud, Cud, Uh, Uh, Xu, Xu, Uh, Uh, Uh, Uh, Xu, Uh, Uh, Uh, Uue, Uh, Uue, Xu, Uu, Ur, Uue, Uu, Uue, Uh, Uh, Qxu, Qxu, Qxe, Qxe, Qxe, Qxu, Xu, Xu, Uh, Uu, Uu, Urb, Urb, Urb, Urb, Urb, Urb, Urb, Urb, Urb, Urb, Xos, Xos, Xos
Xu, Xu, Uh, Uh, Ur, Cud, Uu^Uf, Uh, Xu, Xu, Xu, Xu, Uh, Uh, Uh, Xu, Xu, Uh, Uu^Vu, Uue, Uue, Uue, Uue, Uue, Uue, Rb, Uue, Uue, Uue, Uue, Uue, Qxu, Qxu, Qxe, Qxu, Qxu, Uh, Xu, Uu, Uu, Uu, Urb, Urb, Urb, Urb, Urb, Urb, Urb, Urb, Urb, Urb, Urb, Xos, Xos, Xos
Xu, Xu, Uu^Uf, Uu, Uu, Uu, Uh, Xu, Xu, Xu, Xu, Xu, Xu, Uh, Uh, Uh, Uh, Uh, Ai^_ml, Ai^_ml, Ai^_ml, Uue, Ai^_ml, Ai^_ml, Ai^_ml, Ai^Bw|r, Ai^_ml, Uue, Uue, Uue, Ai^_ml, Ai^_ml, Ai^_ml, Qxu, Uu, Uu, Uu, Uu, Uh, Uu, Xos, Xos, Urb, Urb, Urb, Urb, Urb, Urb, Urb, Urb, Urb, Urb, Cud, Xos, Xos
Xu, Uh, Uu, Ur, Uh, Uh, Xu, Xu, Xu, Xu, Xu, Xu, Xu, Xu, Uh, Uh, Ai^_ml, Ai^_ml, Ai^_mll, Ai^_mll, Ai^_ml, Ai^_ml, Ai^_ml, Ai^_ml, Ai^_ml, Ai^Bw|r, Ai^_ml, Ai^_ml, Ai^Bw|r, Ai^Bw\r, Ai^Bw\r, Ai^_ml, Uue, Uh, Uu, Uu^Vu, Uu, Uh, Uh, Uh, Xos, Xos, Urb, Urb, Urb, Urb, Urb, Xos, Xos, Urb, Cud, Cud, Cud, Cud, Urb
Urb, Uh, Ur, Uh, Xu, Xu, Xu, Xu, Xu, Xu, Xu, Xu, Xu, Xu, Xu, Ai^_ml, Ai^_ml, Ai^_ml, Ai^_ml, Ai^_ml, Xue, Ai^_ml, Xue, Uue, Uue, Rb, Uue, Ai^_ml, Uue, Ai^_ml, Uue, Rb, Rb, Uu, Xu, Xu, Xu, Xu, Xu, Xu, Xu, Xos, Xos, Urb, Xos, Urb, Xos, Xos, Cud, Cud, Cud, Kud, Cud, Cud, Urb
Ur, Ur, Xu, Xu, Xu, Xu, Xu, Xu, Xu, Xu, Xu, Xu, Xu, Xu, Xu, Xu, Xu, Xu, Xu, Xue, Xu, Xue, Xue, Xue, Xue, Xue, Xue, Xue, Xue, Xue, Xue, Xue, Xue, Xu, Xu, Xu, Xu, Xu, Xu, Xu, Xu, Xu, Xos, Xos, Xos, Xos, Xos, Xos, Urb, Urb, Urb, Urb, Urb, Urb, Urb
