border_size=1
usage=map

Xos         , Xos         , Xos         , Xos         , Xos         , Xos         , Xos         , Xos         , Xos         , Xos         , Xos         , Xos         , Xos         , Xos         , Xos         , Xos         , Xos         , Xos         , Xos         , Xos         , Xos         , Xos         , Xos         , Xos         , Xos         , Xos         , Xos         , Xos         , Xos         , Xos         , Xos         , Xos         , Xos         , Xos         , Xos         , Xos         , Xos         , Xos         , Xos         , Xos         , Xos         , Xos         , Xos         , Xos         , Xos         , Xos         , Xos         , Xos         , Xos         , Xos         , Xos         , Xu          , Xu          , Xu          , Xu          
Xos         , Xos         , Xos         , Xos         , Xos         , Xos         , Xos         , Xos         , Xos         , Xos         , Xos         , Xos         , Xos         , Xos         , Xos         , Xos         , Xos         , Xos         , Xos         , Xos         , Xos         , Xos         , Xos         , Xos         , Xos         , Xos         , Xos         , Xos         , Xos         , Xos         , Xos         , Xos         , Xos         , Xos         , Xos         , Xos         , Urb         , Xos         , Urb         , Xos         , Urb         , Urb         , Urb         , Xos         , Xos         , Xos         , Xos         , Xos         , Xos         , Xos         , Xos         , Xu          , Xu          , Xu          , Xu          
Xos         , Xos         , Xos         , Xos         , Urb         , Urb         , Urb         , Xos         , Xos         , Xos         , Xos         , Xos         , Xos         , Xos         , Xos         , Xos         , Urb         , Xos         , Xos         , Xos         , Xos         , Xos         , Xos         , Xos         , Xos         , Xos         , Xos         , Xos         , Xos         , Xos         , Xos         , Xos         , Xos         , Xos         , Xos         , Xos         , Uu^Vu       , Urb         , Urb         , Urb         , Urb         , Urb         , Urb         , Urb         , Urb         , Xos         , Xos         , Xos         , Xos         , Xos         , Xos         , Xu          , Xu          , Xu          , Xu          
Xos         , Xos         , Xos         , Xos         , Urb         , Urb         , Urb         , Urb         , Urb         , Xos         , Xos         , Xos         , Urb         , Urb         , Urb         , Urb         , Urb         , Urb         , Urb         , Xos         , Urb         , Urb         , Urb         , Xos         , Uu^Vu       , Xos         , Xos         , Xos         , Xos         , Xos         , Urb         , Xos         , Urb         , Urb         , Urb         , Urb         , Urb         , Urb         , Urb         , Urb         , Urb         , Urb         , Urb         , Urb         , Urb         , Xos         , Xos         , Xos         , Xos         , Xos         , Xu          , Xu          , Xu          , Xu          , Uh^Dr       
Xos         , Xos         , Xos         , Urb         , Urb         , Urb         , Urb         , Urb         , Urb         , Urb         , Urb         , Urb         , Urb         , Urb         , Urb         , Urb         , Urb         , Urb         , Urb         , Urb         , Xos         , Urb         , Urb         , Urb         , Urb         , Urb         , Urb         , Xos         , Urb         , Urb         , Urb         , Urb         , Urb         , Urb         , Urb         , Urb         , Urb         , Urb         , Xos         , Urb         , Xos         , Xos         , Urb         , Urb         , Urb         , Uu^Vu       , Xos         , Xos         , Xos         , Xos         , Xu          , Xu          , Uh^Dr       , Uh^Dr       , Uh^Dr       
Xos         , Xos         , Xos         , Urb         , Urb         , Urb         , Urb         , Urb         , Urb         , Urb         , Urb         , Urb         , Urb         , Urb         , Urb         , Urb         , Urb         , Xos         , Xos         , Xos         , Xos         , Urb         , Urb         , Urb         , Urb         , Urb         , Urb         , Urb         , Urb         , Urb         , Xos         , Xos         , Xos         , Urb         , Urb         , Urb         , Urb         , Urb         , Xos         , Xos         , Xos         , Xos         , Xos         , Urb         , Urb         , Urb         , Urb         , Xos         , Xos         , Xos         , Uh^Dr       , Uh^Dr       , Uu^Dr       , Uh^Dr       , Uh^Dr       
Xos         , Xos         , Urb         , Urb         , Urb         , Urb         , Urb         , Urb         , Urb         , Urb         , Urb         , Urb         , Urb         , Urb         , Urb         , Urb         , Urb         , Xos         , Xos         , Xos         , Xos         , Urb         , Urb         , Urb         , Xos         , Xos         , Urb         , Urb         , Urb         , Xos         , Xos         , Xos         , Xos         , Xos         , Xos         , Xos         , Urb         , Urb         , Xos         , Xos         , Xos         , Xos         , Urb         , Urb         , Urb         , Urb         , Urb         , Urb         , Uu          , Uh          , Uh          , Uh^Dr       , Uu^Dr       , Uh^Dr       , Xu          
Xos         , Urb         , Urb         , Urb         , Urb         , Uu^Vu       , Urb         , Urb         , Urb         , Urb         , Urb         , Urb         , Xos         , Xos         , Xos         , Urb         , Urb         , Urb         , Urb         , Xos         , Xos         , Urb         , Urb         , Urb         , Xos         , Xos         , Xos         , Urb         , Urb         , Urb         , Urb         , Xos         , Xos         , Xos         , Xos         , Urb         , Uu^Vu       , Urb         , Urb         , Xos         , Xos         , Urb         , Urb         , Urb         , Xos         , Urb         , Urb         , Urb         , Uu          , Uu          , Uu          , Uh          , Uh          , Xu          , Xu          
Urb         , Urb         , Urb         , Urb         , 1 Urb       , Urb         , Urb         , Urb         , Urb         , Urb         , Urb         , Urb         , Urb         , Xos         , Xos         , Urb         , Urb         , Urb         , Urb         , Urb         , Urb         , Urb         , Urb         , Urb         , Uu^Vu       , Xos         , Xos         , Xos         , Xos         , Urb         , Urb         , Urb         , Urb         , Urb         , Urb         , Urb         , Urb         , Urb         , Urb         , Urb         , Urb         , Urb         , Urb         , Urb         , Xos         , Xos         , Xos         , Urb         , Urb         , Uu          , Uu          , Uu          , Uh          , Xu          , Xu          
Urb         , Urb         , Urb         , Urb         , Urb         , Urb         , Urb         , Urb         , Xos         , Urb         , Urb         , Urb         , Urb         , Xos         , Xos         , Xos         , Xos         , Urb         , Urb         , Urb         , Urb         , Urb         , Urb         , Urb         , Urb         , Xos         , Xos         , Xos         , Xos         , Xos         , Xos         , Urb         , Urb         , Urb         , Xos         , Urb         , Urb         , Xos         , Xos         , Urb         , Xos         , Urb         , Urb         , Xos         , Xos         , Xos         , Xos         , Xos         , Urb         , Uu          , Uu^Vu       , Uu          , Uh          , Xu          , Xu          
Urb         , Urb         , Urb         , Urb         , Urb         , Urb         , Xos         , Xos         , Xos         , Urb         , Urb         , Urb         , Urb         , Xos         , Xos         , Xos         , Xos         , Xos         , Xos         , Urb         , Urb         , Urb         , Urb         , Urb         , Qxu         , Urb         , Urb         , Urb         , Urb         , Xos         , Urb         , Xos         , Urb         , Urb         , Urb         , Xos         , Xos         , Xos         , Xos         , Xos         , Xos         , Urb         , Urb         , Xos         , Xos         , Xos         , Urb         , Xos         , Uu          , Uu          , Uu          , Uu          , Qxu         , Xu          , Xu          
Urb         , Urb         , Urb         , Urb         , Xos         , Xos         , Xos         , Xos         , Xos         , Xos         , Urb         , Urb         , Urb         , Uu^Vu       , Xos         , Xos         , Xos         , Xos         , Xos         , Xos         , Urb         , Urb         , Qxu         , Qxu         , Qxua        , Qxu         , Qxu         , Qxu         , Qxu         , Urb         , Urb         , Urb         , Urb         , Urb         , Urb         , Xos         , Xos         , Xos         , Xos         , Xos         , Xos         , Urb         , Urb         , Urb         , Urb         , Xos         , Urb         , Urb         , Ur          , Uu          , Uu          , Uu          , Qxu         , Xu          , Xu          
Xos         , Xos         , Xos         , Xos         , Xos         , Xos         , Xos         , Xos         , Xos         , Urb         , Urb         , Urb         , Urb         , Xos         , Xos         , Uu^Vu       , Urb         , Urb         , Urb         , Urb         , Qxu^Bs\     , Qxu         , Qxua        , Qxua        , Qxua        , Qxua        , Qxua        , Qxua        , Qxua        , Qxu         , Qxu^Bs/     , Urb         , Urb         , Urb         , Urb         , Urb         , Urb         , Xos         , Urb         , Xos         , Urb         , Urb         , Urb         , Urb         , Urb         , Urb         , Uu          , Uu          , Uu          , Ur          , Ur          , Qxu         , Qxu         , Xu          , Xu          
Xos         , Xos         , Xos         , Xos         , Xos         , Xos         , Xos         , Xos         , Urb         , Urb         , Urb         , Urb         , Xos         , Xos         , Xos         , Urb         , Urb         , Urb         , Qxu         , Qxu         , Qxu         , Qxu^Bs\     , Qxu^Bs\     , Qxua        , Uu          , Qxua        , Uh          , Qxua        , Qxu^Bs/     , Qxu^Bs/     , Qxua        , Qxu         , Uu          , Uh          , Uu          , Urb         , Urb         , Urb         , Urb         , Urb         , Urb         , Urb         , Uu          , Urb         , Uu          , Uu          , Uh          , Uh          , Qxu         , Qxu         , Qxu         , Qxu^Bs\     , Qxu^Bs\     , Xu          , Xu          
Xos         , Xos         , Xos         , Xos         , Xos         , Xos         , Urb         , Urb         , Urb         , Urb         , Urb         , Urb         , Urb         , Xos         , Urb         , Urb         , Urb         , Urb         , Qxu         , Qxu         , Qxua        , Qxua        , Qxua        , Ur          , Ur^Ii       , Ur          , Ur          , Ur          , Qxua        , Qxua        , Qxua        , Qxu         , Uu          , Uu          , Uu          , Uu          , Ur          , Urb         , Urb         , Urb         , Uu          , Uu          , Xu          , Uu^Vu       , Xu          , Uh          , Qxu         , Qxu         , Qxu         , Qxu         , Qxu         , Qxu         , Ur          , Ur          , Xu          
Xos         , Xos         , Xos         , Xos         , Urb         , Urb         , Urb         , Urb         , Urb         , Urb         , Urb         , Urb         , Xos         , Urb         , Urb         , Urb         , Urb         , Qxu         , Qxe         , Qxu         , Qxua        , Qxua        , Qxua        , Uu^Ii       , Ur^Ii       , Xu          , Xu          , Ur          , Uh          , Qxua        , Qxua        , Qxu         , Uu          , Uu^Vu       , Uh          , Uu          , Ur          , Uu          , Uu          , Uu          , Uh          , Xu          , Xu          , Xu          , Qxu         , Qxu         , Qxu         , Qxe         , Qxu         , Uu          , Ur          , Ur          , Uh          , Uu^Vu       , Xos         
Xos         , Xos         , Urb         , Urb         , Urb         , Urb         , Urb         , Urb         , Xos         , Xos         , Xos         , Urb         , Xos         , Xos         , Xos         , Urb         , Urb         , Qxu         , Qxu         , Qxua        , Qxua        , Qxua        , Qxua        , Uu^Ii       , Ur^Ii       , 3 Urb^Ii    , Ur^Ii       , Ur^Ii       , Ur          , Qxua        , Qxua        , Qxu         , Uu          , Xu          , Xu          , Uh          , Ur          , Ur          , Ur          , Uu          , Uu          , Uh          , Qxu         , Qxu         , Qxe         , Qxu         , Uu          , Qxu         , Ur          , Ur          , Xos         , Xos         , Xos         , Xos         , Xos         
Xos         , Xos         , Urb         , Urb         , Urb         , Urb         , Urb         , Urb         , Xos         , Xos         , Xos         , Xos         , Xos         , Xos         , Xos         , Urb         , Urb         , Urb         , Qxu         , Qxu         , Qxua        , Qxua        , Qxua        , Uu^Ii       , Ur^Ii       , Ur^Ii       , Uu^Ii       , Uu^Ii       , Qxu^Bs|     , Qxua        , Qxua        , Qxu         , Uu          , Xu          , Uu          , Uu          , Ur          , Uu          , Uu          , Ur          , Uu          , Qxu         , Qxu         , Qxe         , Qxu         , Qxu         , Uu          , Uu          , Ur          , Xos         , Xos         , Xos         , Xos         , Xos         , Xos         
Xu          , Uu^Vu       , Uu          , Urb         , Urb         , Urb         , Urb         , Urb         , Xos         , Xos         , Xos         , Xos         , Xos         , Xos         , Urb         , Urb         , Xos         , Urb         , Urb         , Qxu         , Qxu         , Qxua        , Qxu^Bs/     , Qxu^Bs/     , Qxua        , Uu^Ii       , Qxua        , Qxua        , Qxu^Bs|     , Qxua        , Qxu         , Ur          , Ur          , Uu          , Ur          , Uu          , Ur          , Uu          , Uu          , Qxu         , Qxu^Bs|     , Qxu^Bs\     , Qxu^Bs\     , Qxu         , Uu          , Uu          , Uh          , Uu          , Urb         , Urb         , Urb         , Urb         , Urb         , Xos         , Xos         
Xu          , Xu          , Xu          , Uu          , Uh          , Uu          , Uu          , Urb         , Urb         , Xos         , Xos         , Xos         , Xos         , Xos         , Urb         , Urb         , Xos         , Urb         , Urb         , Qxu         , Qxu^Bs/     , Qxu^Bs/     , Qxu         , Qxua        , Qxua        , Qxua        , Qxua        , Qxua        , Qxu^Bs|     , Qxu         , Qxu         , Qxu         , Qxu         , Ur          , Uh          , Ur          , Uh          , Ur          , Qxu^Bs\     , Qxu         , Qxu^Bs|     , Qxu         , Uu^Vu       , Ur          , Uu          , Uh          , Xos         , Urb         , Urb         , Urb         , Urb         , Urb         , Urb         , Urb         , Xos         
Xu          , Xu          , Xu          , Xu          , Uu^Uf       , Uu          , Uu          , Urb         , Urb         , Urb         , Urb         , Xos         , Urb         , Urb         , Urb         , Xos         , Xos         , Xos         , Urb         , Urb         , Uu          , Qxu         , Qxu         , Qxua        , Qxu         , Qxua        , Qxua        , Qxu         , Ur          , Uu          , Uu          , Qxu         , Qxu         , Qxu         , Qxu         , Uh          , Qxu         , Qxu         , Qxu         , Qxu^Bs\     , Ur          , Uu          , Uu          , Ur          , Xos         , Xos         , Xos         , Xos         , Urb         , Urb         , Urb         , Urb         , Urb         , Xos         , Xos         
Xu          , Xu          , Xu          , Xu          , Uu^Uf       , Uu^Uf       , Uu          , Uu          , Uu^Vu       , Urb         , Urb         , Urb         , Urb         , Urb         , Xos         , Xos         , Xos         , Xos         , Uh          , Urb         , Uh          , Uu          , Uh          , Qxu         , Uh          , Qxu         , Qxu         , Qxu         , Ur          , Uu^Vu       , Xu          , Uh          , Qxu         , Qxu         , Qxu         , Qxu         , Qxu         , Qxu         , Qxu         , Qxu         , Uu          , Ur          , Ur          , Ur          , Xos         , Xos         , Xos         , Xos         , Urb         , Urb         , Urb         , Urb         , Urb         , Xos         , Xos         
Xu          , Xu          , Xu          , Xu          , Uh          , Ur          , Uh          , Uh          , Uh          , Uh          , Uh          , Uh          , Uh          , Uu          , Uh          , Uu          , Uh          , Uh          , Uh          , Uh          , Uh          , Uh          , Xu          , Uh          , Uh          , Uh          , Ur          , Ur          , Uu          , Xu          , Xu          , Uh          , Qxu         , Qxe         , Qxe         , Qxe         , Qxu         , Qxu         , Qxu         , Uh          , Uh          , Uu          , Uu          , Ur          , Urb         , Xos         , Urb         , Urb         , Urb         , Urb         , Urb         , Uu^Vu       , Urb         , Xos         , Xos         
Xu          , Xu          , Xu          , Uh          , Uh          , Uu          , Uh          , Uh          , Uh          , Uh          , Xu          , Xu          , Uh          , Uh          , Uh          , Uh          , Xu          , Uh          , Uh          , Uh          , Uue         , Uh          , Uue         , Xu          , Uu          , Ur          , Uue         , Uu          , Uue         , Uh          , Uh          , Qxu         , Qxu         , Qxe         , Qxe         , Qxe         , Qxu         , Xu          , Xu          , Uh          , Uu          , Uu          , Urb         , Urb         , Urb         , Urb         , Urb         , Urb         , Urb         , Urb         , Urb         , Urb         , Xos         , Xos         , Xos         
Xu          , Xu          , Uh          , Uh          , Ur          , Ur          , Uu^Uf       , Uh          , Xu          , Xu          , Xu          , Xu          , Uh          , Uh          , Uh          , Xu          , Xu          , Uh          , Uu^Vu       , Uue         , Uue         , Uue         , Uue         , Uue         , Uue         , Rb          , Uue         , Uue         , Uue         , Uue         , Uue         , Qxu         , Qxu         , Qxe         , Qxu         , Qxu         , Uh          , Xu          , Uu          , Uu          , Uu          , Urb         , Urb         , Urb         , Urb         , Urb         , Urb         , Urb         , Urb         , Urb         , Urb         , Urb         , Xos         , Xos         , Xos         
Xu          , Xu          , Uu^Uf       , Uu          , Uu          , Uu          , Uh          , Xu          , Xu          , Xu          , Xu          , Xu          , Xu          , Uh          , Uh          , Uh          , Uh          , Uh          , Qxu         , Qxe         , Qxe         , Uue         , Qxe         , Qxe         , Qxe         , Qxu^Bs|     , Qxe         , Uue         , Uue         , Uue         , Qxe         , Qxe         , Qxu         , Qxu         , Uu          , Uu          , Uu          , Uu          , Uh          , Uu          , Xos         , Xos         , Urb         , Urb         , Urb         , Urb         , Urb         , Urb         , Urb         , Urb         , Urb         , Urb         , Urb         , Xos         , Xos         
Xu          , Uh          , Uu          , Ur          , Uh          , Uh          , Xu          , Xu          , Xu          , Xu          , Xu          , Xu          , Xu          , Xu          , Uh          , Uh          , Qxu         , Qxu         , Qxu         , Qxu         , Qxe         , Qxe         , Qxe         , Qxe         , Qxe         , Qxu^Bs|     , Qxe         , Qxe         , Qxu^Bs|     , Qxu^Bs\     , Qxu^Bs\     , Qxe         , Uue         , Uh          , Uu          , Uu^Vu       , Uu          , Uh          , Uh          , Uh          , Xos         , Xos         , Urb         , Urb         , Urb         , Urb         , Urb         , Xos         , Xos         , Urb         , Urb         , Urb         , Urb         , Urb         , Urb         
Urb         , Uh          , Ur          , Uh          , Xu          , Xu          , Xu          , Xu          , Xu          , Xu          , Xu          , Xu          , Xu          , Xu          , Xu          , Qxu         , Qxu         , Qxu         , Qxu         , Qxu         , Xue         , Qxe         , Xue         , Uue         , Uue         , Rb          , Uue         , Qxe         , Uue         , Qxe         , Uue         , Rb          , Rb          , Uu          , Xu          , Xu          , Xu          , Xu          , Xu          , Xu          , Xu          , Xos         , Xos         , Urb         , Xos         , Urb         , Xos         , Xos         , Urb         , Urb         , Urb         , Urb         , Urb         , Urb         , Urb         
Ur          , Ur          , Xu          , Xu          , Xu          , Xu          , Xu          , Xu          , Xu          , Xu          , Xu          , Xu          , Xu          , Xu          , Xu          , Xu          , Xu          , Xu          , Xu          , Xue         , Xu          , Xue         , Xue         , Xue         , Xue         , Xue         , Xue         , Xue         , Xue         , Xue         , Xue         , Xue         , Xue         , Xu          , Xu          , Xu          , Xu          , Xu          , Xu          , Xu          , Xu          , Xu          , Xos         , Xos         , Xos         , Xos         , Xos         , Xos         , Urb         , Urb         , Urb         , Urb         , Urb         , Urb         , Urb         
