border_size=1
usage=map

Uh          , Uh          , Uh          , Uh          , Uu          , Uu          , Uu          , Uu^Uf       , Uu^Uf       , Uu          , Uu          , Ur          , Uh          , Ur          , Ur          , Ur          , Ur          , Xu          , Xu          , Xu          , Xu          , Xu          , Xu          , Xu          , Xu          , Xu          , Xu          , Xu          , Xu          , Xu          , Xu          , Xu          , Xu          , Xu          , Xu          , Xu          , Xu          , Xu          , Xu          , Xu          , Xu          , Xu          , Xu          , Xu          , Xu          , Xu          
Uh          , Cud         , Cud         , Cud         , Cud         , Uu^Uf       , Uu          , Uu^Vud      , Uh          , Uh          , Uh          , Uu^Uf       , Uu^Uf       , Ur          , Ur          , Xu          , Ur          , Xu          , Xu          , Xu          , Xu          , Xu          , Xu          , Xu          , Xu          , Xu          , Xu          , Xu          , Xu          , Xu          , Xu          , Xu          , Xu          , Xu          , Xu          , Xu          , Xu          , Xu          , Xu          , Xu          , Xu          , Xu          , Xu          , Xu          , Xu          , Xu          
Ur          , Cud         , Uh          , Kud         , Ur          , Cud         , Uh          , Uh          , Uu          , Uh          , Uh          , Uu          , Uh^Dr       , Ur          , Uh          , Ur          , Ur          , Xu          , Xu          , Xu          , Xu          , Xu          , Xu          , Xu          , Xu          , Xu          , Xu          , Xu          , Xu          , Xu          , Xu          , Xu          , Xu          , Xu          , Xu          , Xu          , Xu          , Xu          , Uu          , Uu^Vu       , Ur          , Xu          , Xu          , Xu          , Xu          , Xu          
Uh          , Uh          , Uh          , Cud         , Uh          , Cud         , Ur          , Uh          , Uu^Uf       , Uh          , Uu          , Uu          , Uh^Dr       , Uh^Dr       , Uh          , Uh          , Uu          , Uu          , Ur          , Xu          , Xu          , Xu          , Xu          , Xu          , Xu          , Xu          , Xu          , Xu          , Xu          , Xu          , Uu^Vu       , Uu^Uf       , Uu          , Uu^Vu       , Xu          , Xu          , Xu          , Uu^Vu       , Xu          , Uu          , Ur          , Uu^Uf       , Xu          , Xu          , Xu          , Xu          
Uu^Uf       , Uh          , Uh          , Uh          , Uh          , Uu^Uf       , Uu^Uf       , Uu          , Ur          , Uu^Uf       , Uu^Uf       , Uu^Dr       , Ur          , Uh^Dr       , Uu          , Xu          , Xu          , Uu          , Uu          , Xu          , Uu          , Xu          , Xu          , Xu          , Xu          , Xu          , Xu          , Xu          , Xu          , Xu          , Xu          , Uu          , Ur          , Ur          , Uu          , Uu^Vu       , Xu          , Xu          , Uu^Vu       , Uu          , Uu^Vu       , Ur          , Ur          , Xu          , Xu          , Xu          
Uu          , Uh          , Uu^Uf       , Uu^Uf       , Uu          , Uu          , Uu^Uf       , Uu^Uf       , Uu^Uf       , Ur          , Ww^Dr       , Ur          , Xu          , Ur          , Ur          , Uu          , Xu          , Xu          , Xu          , Uu^Vud      , Xu          , Uu          , Uu          , Xu          , Xu          , Xu          , Xu          , Xu          , 5 Kud       , Xu          , Xu          , Ur          , Xu          , Xu          , Xu          , Xu          , Xu          , Xu          , Xu          , Xu          , Xu          , Xu          , Ur          , Xu          , Xu          , Xu          
Uu          , Ur          , Uh          , Uu          , Uh          , Uh          , Uu          , Uu          , Uu^Vu       , Ur          , Ww          , Xu          , Uh          , Xu          , Uu          , Uu          , 1 Uu        , Xu          , Xu          , Xu          , Xu          , Ur          , Ur          , Uu          , Ur          , Xu          , Cud         , Cud         , Cud         , Cud         , Xu          , Ur          , Uu^Uf       , Uu^Uf       , Uu^Uf       , Uu^Uf       , Ur          , Ur          , Ur          , Ur          , Ur          , Ur          , Ur          , Xu          , Xu          , Xu          
Uu          , Uu^Vud      , Xu          , Ur          , Ur          , Uh          , Uh          , Uu          , Uu^Uf       , Ur          , Ww          , Ww          , Ww^Dr       , Uh          , Uu          , Uu          , Uu^Vud      , Xu          , Xu          , Xu          , Xu          , Xu          , Xu          , Ur          , Ur          , Ur          , Ur          , Uu          , Ur          , Uu          , Ur          , Ur          , Uu          , Uu^Uf       , Ur          , Ur          , Ur          , Ur          , Ur          , Xu          , Xu          , Ur          , Xu          , Xu          , Xu          , Xu          
Uh          , Uu          , Uu          , Xu          , Ur          , Ur          , Uu          , Uu          , Uu          , Ur          , Ur          , Ww          , Ww^Dr       , Ww^Dr       , Xu          , Xu          , Uu          , Xu          , Xu          , Xu          , Xu          , Xu          , Xu          , Xu          , Xu          , Uu          , Uu          , Ur          , Ur          , Ur          , Uu          , Ur          , Ur          , Ur          , Uu          , Uu^Uf       , Uu^Uf       , Xu          , Ur          , Xu          , Xu          , Ur          , Xu          , Xu          , Xu          , Xu          
Ur          , Uu          , Uu          , Ur          , Ur          , Ur          , Ur          , Uh          , Ur          , Ur          , Ur          , Ww          , Ww          , Xu          , Ww          , Ww          , Xu          , Xu          , Xu          , Xu          , Xu          , Xu          , Xu          , Xu          , Xu          , Xu          , Xu          , Uu          , Ur          , Uu          , Ur          , Ur          , Ur          , Uu          , Uu          , Uu^Uf       , Uu^Uf       , Xu          , Ur          , Cud         , Cud         , Xu          , Xu          , Xu          , Xu          , Xu          
Uh          , Uu          , Uu          , Xu          , Uu          , Uu^Vud      , Xu          , Ur          , Ur          , Ur          , Ur          , Ww^Dr       , Xu          , Ww          , Xu          , Xu          , Xu          , Xu          , Xu          , Xu          , Xu          , Xu          , Xu          , Xu          , Xu          , Xu          , Uu^Vu       , Xu          , Ur          , Ur          , Xu          , Uu          , Ur          , Uu          , Uu          , Uu          , Uu          , Xu          , Ur          , Cud         , Cud         , Cud         , Xu          , Xu          , Xu          , Xu          
Xu          , Uu^Vud      , Uu          , Xu          , Xu          , Uu          , Uu          , Uu          , Uu          , Ur          , Xu          , Xu          , Xu          , Xu          , Xu          , Xu          , Xu          , Xu          , Xu          , Xu          , Xu          , Xu          , Xu          , Xu          , Xu          , Xu          , Uu          , Uu          , Ur          , Xu          , Xu          , Uu          , Ur          , Uu          , Uu          , Uu          , Ur          , Ur          , Uu          , Cud         , 2 Kud       , Xu          , Xu          , Xu          , Xu          , Xu          
Uh          , Uu          , Xu          , Xu          , Xu          , Xu          , Xu          , Xu          , Xu          , Xu          , Xu          , Xu          , Xu          , Xu          , Xu          , Xu          , Xu          , Xu          , Xu          , Xu          , Xu          , Xu          , Xu          , Xu          , Xu          , Uu^Uf       , Uu^Uf       , Uu          , Ur          , Xu          , Uu          , Ur          , Xu          , Uu^Vu       , Uu          , Ur          , Uu          , Uu          , Xu          , Xu          , Xu          , Xu          , Xu          , Xu          , Xu          , Xu          
Xu          , Xu          , Xu          , Xu          , Xu          , Xu          , Xu          , Xu          , Xu          , Xu          , Xu          , Xu          , Xu          , Xu          , Xu          , Xu          , Xu          , Xu          , Xu          , Xu          , Xu          , Xu          , Xu          , Xu          , Uu^Uf       , Uu^Uf       , Ur          , Ur          , Ur          , Ur          , Ur          , Ur          , Uu          , Uu          , Uu          , Ur          , Xu          , Xu          , Uu^Vu       , Xu          , Xu          , Xu          , Xu          , Xu          , Xu          , Xu          
Xu          , Xu          , Xu          , Xu          , Xu          , Xu          , Xu          , Xu          , Xu          , Xu          , Xu          , Xu          , Xu          , Xu          , Xu          , Xu          , Xu          , Xu          , Xu          , Xu          , Xu          , Xu          , Xu          , Xu          , Ur          , Ur          , Uu^Uf       , Uu^Uf       , Xu          , Uu^Uf       , Uu^Uf       , Ur          , Uu          , Uu^Uf       , Uu^Uf       , Ur          , Uu          , Xu          , Uu          , Uu          , Uu^Vu       , Xu          , Xu          , Xu          , Xu          , Xu          
Xu          , Xu          , Xu          , Xu          , Xu          , Xu          , Xu          , Xu          , Xu          , Xu          , Xu          , Xu          , Xu          , Xu          , Xu          , Xu          , Xu          , Xu          , Xu          , Xu          , Xu          , Xu          , Uu^Uf       , Uu^Uf       , Ur          , Xu          , Uu^Uf       , Uu^Uf       , Uu^Uf       , Uu^Uf       , Uu^Uf       , Ur          , Ur          , Uu^Uf       , Uu^Uf       , Ur          , Ur          , Uu          , Uu          , Uu          , Xu          , Xu          , Xu          , Xu          , Xu          , Xu          
Xu          , Xu          , Xu          , Xu          , Xu          , Xu          , Xu          , Xu          , Xu          , Xu          , Xu          , Xu          , Xu          , Xu          , Xu          , Xu          , Xu          , Xu          , Xu          , Xu          , Xu          , Uu^Uf       , Ur          , Ur          , Uu^Uf       , Uu^Uf       , Uu^Uf       , Uu^Uf       , Uu^Uf       , Uu^Uf       , Ur          , Ur          , Uu          , Ur          , Ur          , Ur          , Uu          , Ur          , Ur          , Xu          , Xu          , Xu          , Xu          , Xu          , Xu          , Xu          
Xu          , Xu          , Xu          , Xu          , Xu          , Xu          , Xu          , Xu          , Xu          , Xu          , Xu          , Xu          , Xu          , Xu          , Xu          , Xu          , Xu          , Xu          , Uu          , Xu          , Xu          , Uu^Uf       , Ur          , Xu          , Xu          , Uu^Vu       , Xu          , Uu^Uf       , Xu          , Uu^Uf       , Ur          , Uu          , Xu          , Uu          , Ur          , Uu          , Uu^Uf       , Uu          , Xu          , Ur          , Xu          , Xu          , Xu          , Xu          , Xu          , Xu          
Xu          , Xu          , Xu          , Xu          , Xu          , Xu          , Xu          , Xu          , Xu          , Xu          , Xu          , Xu          , Xu          , Xu          , Xu          , Xu          , Uu          , Uu          , Uu          , Uu          , Ur          , Ur          , Xu          , Ur          , Ur          , Xu          , Xu          , Xu          , Uu          , Uu          , Ur          , Xu          , Uu          , Uu          , Ur          , Uu^Uf       , Uu^Uf       , Xu          , Xu          , Ur          , Ur          , Uu          , Uu          , Xu          , Xu          , Xu          
Xu          , Xu          , Xu          , Xu          , Xu          , Xu          , Xu          , Xu          , Xu          , Xu          , Xu          , Xu          , Xu          , Xu          , Xu          , Xu          , Uu          , Uu          , Uu          , Uu          , Ur          , Uu          , Xu          , Uu          , Uu          , Ur          , Ur          , Uu          , Ur          , Ur          , Ur          , Uu          , Ur          , Ur          , Uu          , Uu^Uf       , Xu          , Xu          , Xu          , Xu          , Ur          , Uu          , Uu          , Xu          , Xu          , Xu          
Xu          , Xu          , Xu          , Xu          , Xu          , Xu          , Xu          , Xu          , Cud         , Xu          , Cud         , 3 Kud       , Cud         , Xu          , Xu          , Xu          , Uu^Uf       , Uu          , Ur          , Ur          , Ur          , Uu          , Xu          , Uu          , Uu^Vu       , Uu          , Uu          , Ur          , Uu          , Uu          , Uu          , Ur          , Xu          , Uu          , Xu          , Xu          , Uu          , Uu^Vu       , Uu          , Xu          , Ur          , Uu          , Xu          , Xu          , Xu          , Xu          
Xu          , Xu          , Xu          , Xu          , Xu          , Xu          , Xu          , Xu          , Cud         , Cud         , Cud         , Cud         , Ur          , Uu          , Uu          , Uu^Uf       , Uu^Uf       , Uu^Uf       , Ur          , Uu          , Uu          , Ur          , Ur          , Xu          , Xu          , Xu          , Xu          , Uu^Uf       , Uu^Uf       , Uu^Uf       , Uu          , Ur          , Ur          , Xu          , Xu          , Uu^Vu       , Uu          , Uu          , Ur          , Ur          , Xu          , Xu          , Xu          , Xu          , Xu          , Xu          
Xu          , Xu          , Xu          , Xu          , Xu          , Xu          , Xu          , Xu          , Uu^Uf       , Uu          , Uu          , Ur          , Ur          , Uu          , Uu          , Uu^Uf       , Uu          , Ur          , Uu          , Uu          , Uu^Uf       , Uu          , Uu          , Ur          , Uu          , Xu          , Xu          , Xu          , Uu^Uf       , Uu          , Ur          , Ur          , Uu          , Ur          , Xu          , Xu          , Xu          , Uu          , Ur          , Uu^Ii       , Uu^Ii       , Xu          , Xu          , Xu          , Xu          , Xu          
Xu          , Xu          , Xu          , Xu          , Xu          , Xu          , Xu          , Uu^Uf       , Uu^Uf       , Uu^Uf       , Uu          , Uu          , Ur          , Uu          , Uu          , Uu          , Ur          , Ur          , Uu^Uf       , Uu^Uf       , Uu^Uf       , Uu          , Uu          , Ur          , Uu^Uf       , Uu^Uf       , Uu          , Xu          , Xu          , Uu          , Ur          , Uu          , Uu          , Ur          , Ur          , Uu          , Uu          , Uu          , Ur^Ii       , Ur^Ii       , Ur^Ii       , Xu          , Xu          , Xu          , Mm^Xm       , Mm^Xm       
Xu          , Xu          , Xu          , Xu          , Xu          , Xu          , Xu          , Xu          , Xu          , Uu^Uf       , Uu          , Uu          , Ur          , Ur          , Ur          , Uu          , Ur          , Uu^Uf       , Uu^Uf       , Uu^Uf       , Uu          , Uu          , Ur          , Ur          , Ur          , Uu^Uf       , Uu          , Uu          , Ur          , Ur          , Uu          , Uu          , Uu          , Uu          , Uu          , Ur          , Ur          , Ur          , Xu          , Xu          , Xu          , Ur^Ii       , Aa^Ii       , Mm^Xm       , Ms^Ii       , Ms^Ii       
Xu          , Xu          , Xu          , Xu          , 6 Kud       , Xu          , Xu          , Xu          , Xu          , Xu          , Ur          , Ur          , Xu          , Ur          , Xu          , Ur          , Xu          , Ur          , Ur          , Uu          , Ur          , Ur          , Uu          , Ur          , Uu          , Ur          , Ur          , Ur          , Uu          , Uu          , Xu          , Xu          , Xu          , Xu          , Uu          , Ur          , Ur          , Uu          , Xu          , Xu          , Xu          , Aa^Ii       , Aa^Ii       , Aa^Ii       , Aa^Ii       , Ms^Ii       
Xu          , Xu          , Xu          , Xu          , Xu          , Cud         , Cud         , Xu          , Xu          , Xu          , Ur          , Xu          , Xu          , Xu          , Xu          , Xu          , Xu          , Xu          , Uu          , Ur          , Uu          , Uu          , Uu          , Ur          , Uu          , Uu          , Uu          , Uu          , Uu          , Xu          , Cud         , 4 Kud       , Xu          , Xu          , Ur          , Ur          , Uu          , Uu          , Xu          , Xu          , Xu          , Aa^Ii       , Mm^Xm       , Mm^Xm       , Ms^Ii       , Aa^Ii       
Xu          , Xu          , Xu          , Xu          , Xu          , Cud         , Ur          , Uu          , Uu          , Ur          , Uu          , Xu          , Xu          , Xu          , Xu          , Xu          , Xu          , Xu          , Uu^Uf       , Ur          , Ur          , Uu          , Ur          , Ur          , Uu          , Uu          , Uu^Uf       , Uu^Uf       , Xu          , Xu          , Cud         , Xu          , Uu          , Uu          , Ur          , Ur          , Uu          , Uu          , Xu          , Xu          , Xu          , Xu          , Mm^Xm       , Mm^Xm       , Ms^Ii       , Aa^Ii       
Xu          , Xu          , Xu          , Xu          , Uu^Uf       , Uu          , Ur          , Ur          , Ur          , Ur          , Uu          , Uu          , Uu^Vu       , Xu          , Uu^Uf       , Xu          , Uu^Uf       , Uu^Uf       , Uu          , Uu          , Uu          , Ur          , Ur          , Uu          , Uu          , Uu          , Uu^Uf       , Uu^Uf       , Uu          , Cud         , Xu          , Xu          , Ur          , Ur          , Uu^Uf       , Xu          , Xu          , Uu          , Uu          , Xu          , Xu          , Xu          , Xu          , Mm^Xm       , Mm^Xm       , Ms^Ii       
Xu          , Xu          , Xu          , Xu          , Uu^Uf       , Uu^Uf       , Ur          , Uu          , Uu^Uf       , Ur          , Ur          , Uu          , Xu          , Xu          , Xu          , Uu^Uf       , Uu^Uf       , Uu^Uf       , Ur          , Uu          , Ur          , Ur          , Ur          , Ur          , Ur          , Uu          , Uu          , Uu^Uf       , Uu          , Uu          , Ur          , Ur          , Uu          , Uu          , Uu^Uf       , Uu^Uf       , Xu          , Uu          , Uu^Vu       , Xu          , Xu          , Xu          , Xu          , Xu          , Xu          , Mm^Xm       
Xu          , Xu          , Xu          , Xu          , Uu^Uf       , Uu^Uf       , Ur          , Uu^Uf       , Uu          , Ur          , Uu^Uf       , Uu^Uf       , Xu          , Xu          , Xu          , Uu^Uf       , Uu^Uf       , Ur          , Ur          , Ur          , Ur          , Ur          , Uu          , Ur          , Ur          , Ur          , Ur          , Ur          , Ur          , Ur          , Uu^Vu       , Uu          , Uu          , Uu          , Uu          , Uu^Uf       , Xu          , Xu          , Xu          , Xu          , Xu          , Xu          , Xu          , Xu          , Xu          , Xu          
Xu          , Xu          , Xu          , Xu          , Uu^Uf       , Uu          , Ur          , Ur          , Ur          , Ur          , Ur          , Uu^Uf       , Ur          , Xu          , Ur          , Uu          , Ur          , Ur          , Uu          , Ur          , Uu          , Uu          , Uu          , Uu          , Uu          , Uu          , Uu          , Uu          , Uu^Uf       , Uu          , Xu          , Xu          , Uu          , Uu          , Uu          , Uu          , Uu          , Uu^Vu       , Xu          , Xu          , Xu          , Xu          , Xu          , Xu          , Xu          , Xu          
Xu          , Xu          , Xu          , Xu          , Uu^Vu       , Uu          , Uu          , Uu          , Uu          , Uu          , Uu          , Ur          , Xu          , Ur          , Xu          , Ur          , Xu          , Uu          , Xu          , Uu^Vu       , Xu          , Xu          , Xu          , Uu          , Xu          , Uu^Uf       , Uu^Uf       , Uu^Uf       , Uu^Uf       , Uu^Uf       , Uu          , Uu          , Uu          , Uu          , Xu          , Xu          , Xu          , Xu          , Xu          , Xu          , Xu          , Xu          , Xu          , Xu          , Xu          , Xu          
Xu          , Xu          , Xu          , Xu          , Xu          , Xu          , Xu          , Xu          , Xu          , Xu          , Xu          , Xu          , Xu          , Xu          , Xu          , Xu          , Xu          , Xu          , Xu          , Xu          , Xu          , Xu          , Xu          , Xu          , Xu          , Xu          , Xu          , Xu          , Xu          , Xu          , Xu          , Xu          , Xu          , Xu          , Xu          , Xu          , Xu          , Xu          , Xu          , Xu          , Xu          , Xu          , Xu          , Xu          , Xu          , Xu          
Xu          , Xu          , Xu          , Xu          , Xu          , Xu          , Xu          , Xu          , Xu          , Xu          , Xu          , Xu          , Xu          , Xu          , Xu          , Xu          , Xu          , Xu          , Xu          , Xu          , Xu          , Xu          , Xu          , Xu          , Xu          , Xu          , Xu          , Xu          , Xu          , Xu          , Xu          , Xu          , Xu          , Xu          , Xu          , Xu          , Xu          , Xu          , Xu          , Xu          , Xu          , Xu          , Xu          , Xu          , Xu          , Xu          
