border_size=1
usage=map

Qxua, Qxua, Qxua, Qxua, Qxua, Qxua, Qxua, Qxua, Qxua, Qxua, Qxua, Qxua, Qxua, Qxua, Qxua, Qxua, Qxua, Qxua, Qxua, Qxua, Qxua, Qxua, Qxua, Qxua, Qxua, Qxua, Qxua, Qxua, Qxua, Qxua, Qxua, Qxua, Qxua, Qxua, Qxua, Qxua, Qxua, Qxua, Qxua, Qxua, Zwsl, Zwsl, Zwsl, Zwsl, Zwsl, Zwsl, Zwsl, Zwsl, Zwsl, Zwsl, Zwsl, Zwsl, Zwsl, Zwsl, Uu, Uu, Uh, Md, Md, Md, Md^Xm
Qxua, Qxua, Qxua, Qxua, Qxua, Qxua, Qxua, Qxua, Qxua, Qxua, Qxua, Qxua, Qxua, Qxua, Qxua, Qxua, Qxua, Qxua, Qxua, Qxua, Qxua, Qxua, Qxua, Qxua, Qxua, Qxua, Qxua, Qxua, Qxua, Qxua, Qxua, Qxua, Qxua, Qxua, Qxua, Qxua, Qxua, Qxua, Qxua, Qxua, Zwsl, Zwsl, Zwsl, Zwsl, Zvw, Zwsl, Zvw, Zwsl, Zwsl, Zwsl, Zwsl, Zwsl, Zwsl, Uu, Uu, Uh, Uh, Md, Md, Md^Xm, Md^Xm
Qxua, Qxua, Qxua, Qxua, Qxua, Qxua, Qxua, Qxua, Qxua, Qxua, Qxua, Qxua, Qxua, Qxua, Qxua, Qxua, Qxua, Qxua, Qxua, Qxua, Qxua, Qxua, Qxua, Qxua, Qxua, Qxua, Qxua, Qxua, Qxua, Qxua, Qxua, Qxua, Qxua, Qxua, Qxua, Qxua, Qxua, Zwsl, Zwsl, Zwsl, Zvw, Zvw, Zvw, Zvw, Zwsl, Zvw, Zwsl, Zwsl, Zwsl, Zwsl, Zwsl, Zwsl, Zwsl, Uu, Uh, Uh, Md, Md, Md, Md^Xm, Md^Xm
Qxua, Qxua, Qxua, Qxua, Qxua, Qxua, Qxua, Qxua, Qxua, Qxua, Qxua, Qxua, Qxua, Qxua, Qxua, Qxua, Qxua, Qxua, Qxua, Qxua, Qxua, Qxua, Qxua, Qxua, Qxua, Qxua, Qxua, Qxua, Qxua, Qxua, Qxua, Qxua, Qxua, Qxua, Zwsl, Qxua, Zwsl, Zwsl, Zwsl, Zvw, Zwsl, Zwsl, Zwsl, Zwsl, Zwsl, Zwsl, Uu, Zwsl, Zwsl, Zwsl, Zwsl, Zwsl, Uu, Uu, Uh, Uh, Uh, Md, Md, Md^Xm, Md^Xm
Qxua, Qxua, Qxua, Qxua, Qxua, Qxua, Qxua, Qxua, Qxua, Qxua, Qxua, Qxua, Qxua, Qxua, Qxua, Qxua, Qxua, Qxua, Qxua, Qxua, Qxua, Qxua, Qxua, Qxua, Qxua, Qxua, Qxua, Qxua, Qxua, Qxua, Zwsl, Zwsl, Uu, Uu, Zwsl, Zwsl, Zwsl^Ziff, Zwsl, Zwsl, Zwsl, Zwsl, Zwsl, Zwsl, Zwsl, Uu, Uu, Uu, Zwsl, Zwsl, Zvw, Zwsl^Zdcm, Zwsl^Zdcm, Uu^Zdcm, Uu, Uh, Uh, Uh, Md, Md, Md^Xm, Md^Xm
Qxua, Qxua, Qxua, Qxua, Qxua, Qxua, Qxua, Qxua, Qxua, Qxua, Qxua, Qxua, Qxua, Qxua, Qxua, Qxua, Qxua, Qxua, Zwsl, Qxua, Zwsl, Zwsl, Qxua, Qxua, Qxua, Qxua, Qxua, Qxua, Qxua, Zwsl, Uu, Uu, Zwsl, Zwsl, Zwsl^Ziff, Zwsl^Ziff, Zwsl^Ziff, Zwsl^Ziff, Zwsl, Zwsl, Zwsl, Zwsl, Zwsl, Uu, Zwsl^Ziff, Uu, Zwsl^Ziff, Zwsl, Zwsl, Zwsl^Zdcm, Zwsl^Zdcm, Zwsl^Zdcm, Uu^Zdcm, Uu, Uh, Uh, Uh, Md, Md, Md^Xm, Md^Xm
Qxua, Qxua, Qxua, Qxua, Qxua, Qxua, Qxua, Qxua, Qxua, Qxua, Qxua, Qxua, Qxua, Qxua, Qxua, Qxua, Qxua^Bw/r, Zwsl, Qxua^Bw|r, Qxua^Bw\r, Zwsl, Zvw, Qxua^Bw\r, Qxua, Qxua, Qxua, Qxua, Qxua, Zwsl, Zwsl, Uu, Zwsl, Zwsl, Zwsl^Ziff, Zwsl, Zwsl^Ziff, Zwsl, Zwsl, Zwsl^Vzps, Zwsl, Zwsl, Zwsl, Uu, Uu, Zwsl^Ziff, Zwsl^Ziff, Zwsl^Ziff, Zwsl, Zwsl, Zwsl^Zdcm, Zwsl^Zdcm, Zwsl^Zdcm, Zwsl^Zdcm, Uu^Zdcm, Uu, Uh, Uh, Uh, Md, Md, Md^Xm
Qxua, Qxua, Qxua, Qxua, Qxua, Qxua, Qxua, Qxua, Qxua, Qxua, Qxua, Qxua, Qxua, Qxua, Zwsl, Zwsl, Qxua, Qxua, Zwsl, Qxua, Qxua, Qxua, Zwsl, Zwsl, Qxua, Qxua, Qxua, Zwsl, Zwsl, Zwsl, Zwsl, Zwsl, Zvw, Zvw, Zwsl, Zwsl, Zwsl, Zwsl, Zwsl, Zwsl, Zwsl^Ziff, Uu^Ziff, Uu^Ziff, Uh, Zwsl^Ziff, Zwsl^Ziff, Zwsl, Zwsl, Zwsl, Zvw, Zwsl, Zwsl^Zdcm, Zwsl, Uu, Uu, Uh, Uh, Md, Md, Md^Xm, Md^Xm
Qxua, Qxua, Qxua, Qxua, Qxua, Qxua, Qxua, Qxua, Qxua, Qxua, Qxua, Qxua, Qxua, Zwsl, Zvw, Qxua, Zwsl, Zwsl, Qxua^Bw\r, Qxua, Zvw, Qxua^Bw/r, Qxua, Qxua^Bw\r, Zwsl, Zwsl, Zwsl, Zwsl, Zwsl^Vzps, Zwsl, Zwsl, Zwsl, Zwsl, Zwsl, Zwsl, Zwsl, Zwsl, Zwsl, Zwsl, Zwsl, Uu, Uu^Ziff, Uu, Zwsl^Ziff, Zwsl, Zwsl, Zwsl, Zwsl, Zvw, Zvw, Zwsl^Vzps, Zwsl, Uu, Uu, Uh, Uh, Md, Md, Md, Md^Xm, Md^Xm
Qxua, Qxua, Qxua, Qxua, Qxua, Qxua, Qxua, Qxua, Qxua, Qxua, Qxua, Qxua, Zwsl, Qxua^Bw/r, Qxua, Qxua, Zwsl, Zvw, Qxua, Zwsl, Zwsl, Zwsl, Qxua, Zwsl, Zwsl, Zwsl, Zwsl, Zwsl, Zvw, Zwsl, Zwsl, Zwsl, Uu, Zwsl, Zwsl^Ziff, Zwsl^Ziff, Zwsl, Zwsl, Zvw, Zwsl, Uu, Zwsl, Zwsl, Zwsl, Zwsl, Zwsl, Zwsl, Zwsl, Zvw, Zwsl, Zwsl, Zwsl, Uu, Uh, Uh, Uh, Md, Md, Md^Xm, Md^Xm, Md^Xm
Qxua, Qxua, Qxua, Qxua, Qxua, Qxua, Qxua, Qxua, Qxua, Zwsl, Zwsl, Zwsl, Zwsl, Qxua, Qxua, Qxua, Qxua^Bw/r, Zwsl, Qxua, Zwsl, Qxua, Qxua^Bw\r, Zwsl, Zwsl, Zwsl, Zwsl, Zvw, Zvw, Zwsl, Zwsl, Uu, Uu, Uu, Zwsl^Ziff, Zwsl^Ziff, Zwsl^Ziff, Zwsl, Zwsl, Zvw, Zwsl, Zwsl, Zwsl, Zwsl, Zwsl, Zwsl^Ziff, Zwsl^Ziff, Zwsl, Zwsl, Zwsl, Zwsl, Uu, Uu, Uh, Uh, Md, Md, Md, Md^Xm, Md^Xm, Md^Xm, Md^Xm
Qxua, Qxua, Qxua, Qxua, Qxua, Qxua, Qxua, Qxua, Zwsl, Zwsl, Zwsl, Zvw, Qxua, Qxua^Bw\r, Zwsl, Zwsl, Zwsl, Qxua, Qxua, Qxua, Zwsl, Zwsl, Zwsl, Zwsl, Zvw, Zvw, Zwsl, Zwsl, Zwsl, Zwsl, Uh, Uu, Uu^Ziff, Zwsl^Ziff, Zwsl^Ziff, Zwsl^Ziff, Zwsl, Zwsl, Zwsl, Zwsl, Zwsl, Zwsl, Zwsl^Ziff, Zwsl^Ziff, Zwsl^Ziff, Zwsl^Ziff, Zwsl, Zwsl, Zwsl, Zwsl, Uu, Uu, Uh, Uh, Md, Md, Md, Md, Md^Xm, Md^Xm, Md^Xm
Qxua, Qxua, Qxua, Qxua, Qxua, Qxua, Zwsl, Qxua^Bw/r, Qxua, Qxua^Bw|r, Qxua, Qxua^Bw\r, Zwsl, Qxua, Qxua, Zvw^Vzps, Zwsl, Qxua^Bw\r, Zwsl^Zdcm, Zwsl^Zdcm, Zwsl^Zdcm, Zwsl, Zvw, Zvw, Zwsl, Zwsl, Zwsl, Zwsl, Zwsl, Uu, Uh, Uu, Zwsl, Zwsl, Zwsl, Zwsl, Zwsl^Zdcm, Zwsl, Zwsl, Zwsl^Vzps, Uu, Uu, Zwsl^Ziff, Zwsl^Ziff, Zwsl, Zwsl, Zwsl, Zwsl, Uu, Uu, Uh, Uh, Uh, Uh, Md, Md, Md, Md, Md^Xm, Md^Xm, Md^Xm
Qxua, Qxua, Zwsl, Zwsl, Zwsl, Qxua^Bw/r, Zwsl, Zwsl^Vzps, Zvw, Zwsl, Qxua^Bw\r, Zwsl, Zvw, Zwsl, Qxua, Qxua, Qxua, Qxua, Zwsl^Zdcm, Zwsl^Zdcm, Zwsl^Zdcm, Zwsl^Zdcm, Zvw, Zwsl, Zwsl, Zwsl^Emf, Zwsl^Emf, Zwsl, Uu, Uu, Uu, Uu, Zwsl, Zwsl, Zwsl^Zdcm, Zvw^Zdcm, Zwsl^Zdcm, Zwsl^Zdcm, Zwsl^Zdcm, Zwsl, Uh, Uu, Zwsl, Zwsl, Zwsl, Zwsl, Zwsl, Zwsl, Uu, Uu, Uh, Uh, Md, Md, Md, Md, Md, Md^Xm, Md^Xm, Md^Xm, Md^Xm
Zwsl, Qxua, Qxua^Bw/r, Zwsl, Qxua, Qxua, Qxua^Bw/r, Zwsl, Qxua^Bw\r, Qxua, Qxua, Zwsl, Zwsl, Qxua^Bw\r, Zwsl, Zwsl, Zwsl, Qxua, Zwsl^Zdcm, Zwsl^Zdcm, Zwsl^Zdcm, Zwsl^Zdcm, Zwsl, Zwsl^Emf, Zwsl^Emf, Zwsl^Emf, Zwsl, Zwsl, Zwsl, Uu, Uu, Zwsl, Zwsl, Zvw^Zdcm, Zwsl^Zdcm, Zwsl^Zdcm, Zwsl^Zdcm, Zwsl^Zdcm, Uu, Uu, Uh, Uu, Zwsl, Zvw, Zwsl, Zwsl, Uu, Uu, Uh, Uh, Uh, Md, Md, Md, Md, Md, Md^Xm, Md^Xm, Md^Xm, Md^Xm, Md^Xm
Zwsl, Zwsl, Zwsl, Qxua, Qxua, Zwsl, Zwsl, Qxua, Qxua, Zwsl, Zvw, Qxua^Bw/r, Qxua, Qxua, Zwsl, Zvw, Qxua^Bw\r, Qxua, Zwsl, Zwsl^Zdcm, Zwsl, Zwsl, Zwsl^Emf, Zwsl^Emf, Zwsl^Emf, Zwsl^Emf, Zwsl, Zwsl, Zwsl, Uu, Zwsl, Zwsl, Zwsl, Zvw, Zwsl^Zdcm, Zwsl^Zdcm, Zwsl^Zdcm, Zwsl^Zdcm, Uu, Uh, Uu, Zwsl, Zvw, Zvw, Zwsl, Zwsl^Vzps, Uu, Uu, Uh, Uh, Md, Md, Md, Md, Md^Xm, Md^Xm, Md^Xm, Md^Xm, Md^Xm, Md^Xm, Md^Xm
Zwsl, Zwsl, Zwsl, Qxua, Qxua^Bw/r, Zwsl, Zwsl, Qxua^Bw\r, Zwsl, Zwsl, Zvw, Zwsl, Qxua, Qxua, Qxua^Bw/r, Zwsl, Qxua, Zwsl, Zwsl, Zwsl, Zwsl, Zwsl, Zwsl, Zwsl, Zwsl^Emf, Zwsl^Emf, Zwsl, Zwsl, Zvw, Zvw, Zvw, Zvw, Zwsl^Vzps, Zwsl, Zwsl, Zwsl, Zwsl, Zwsl, Uu, Uu, Zwsl, Zwsl, Zwsl, Zwsl, Uu, Uu, Uh, Uh, Uh, Md, Md, Md, Md, Md, Md^Xm, Md^Xm, Md^Xm, Md^Xm, Md^Xm, Md^Xm, Md^Xm
Zvw, Zvw, Zwsl, Zwsl, Qxua, Qxua, Qxua, Qxua, Qxua, Qxua^Bw|r, Qxua, Qxua^Bw\r, Zwsl, Zvw, Qxua, Qxua, Qxua, Zwsl, Zwsl, Zwsl, Zvw, Zvw, Zvw, Zvw, Zwsl, Zwsl, Zwsl, Zwsl, Zvw, Zvw, Zwsl, Zwsl, Zvw, Zvw, Zwsl, Zwsl, Zwsl^Ziff, Uu, Zwsl, Zwsl, Zvw, Zwsl, Uu, Uu, Uu, Uh, Uh, Uh, Md, Md, Md, Md^Xm, Md^Xm, Md^Xm, Md^Xm, Md^Xm, Md^Xm, Md^Xm, Md^Xm, Md^Xm, Md^Xm
Zwsl, Zvw, Zvw, Zwsl, Zwsl, Qxua, Qxua, Zwsl, Qxua^Bw/r, Zwsl, Zwsl, Qxua^Bw/r, Qxua, Qxua^Bw\r, Zwsl, Qxua, Qxua, Zwsl, Zwsl, Zwsl, Zvw^Vzps, Zvw, Zwsl, Zwsl, Zwsl, Zwsl, Zwsl, Zvw, Zwsl, Zwsl, Uu, Zwsl, Zvw, Zvw, Zwsl, Zwsl^Ziff, Zwsl^Ziff, Zwsl, Zvw, Zvw, Zwsl, Zwsl, Uu, Uu, Uh, Uh, Md, Md, Md, Md, Md^Xm, Md^Xm, Md^Xm, Md^Xm, Md^Xm, Md^Xm, Md^Xm, Md^Xm, Md^Xm, Md^Xm, Md^Xm
Zwsl, Zvw, Zvw, Zwsl, Zwsl, Qxua, Qxua, Zwsl, Qxua, Zwsl, Zvw, Zwsl, Qxua, Zwsl, Zvw, Zwsl, Qxua, Zwsl, Zwsl, Zvw, Zwsl, Zwsl, Zwsl, Zwsl, Zwsl, Zwsl, Zwsl, Zwsl, Uu, Uu, Uu^Zdcm, Zwsl, Zwsl^Zdcm, Zwsl, Zwsl, Zwsl^Ziff, Zwsl^Ziff, Zwsl, Zvw, Zvw, Zwsl, Uu^Vzps, Uu, Uh, Uh, Md, Md, Md, Md, Md^Xm, Md^Xm, Md^Xm, Md^Xm, Md^Xm, Md^Xm, Md^Xm, Md^Xm, Md^Xm, Md^Xm, Md^Xm, Md^Xm
Zwsl, Zvw, Zwsl, Zwsl, Zwsl, Qxua^Bw\r, Zwsl, Zwsl, Qxua^Bw/r, Zwsl, Zwsl^Vzps, Zwsl, Qxua^Bw\r, Qxua, Qxua, Zwsl, Qxua^Bw\r, Zwsl, Zwsl, Zvw, Zwsl, Zwsl, Zwsl, Zwsl^Ziff, Zwsl^Ziff, Uu, Uu, Uu, Uh, Uu, Zwsl^Zdcm, Zwsl^Zdcm, Zwsl^Zdcm, Zwsl, Zwsl, Zwsl, Zwsl, Zvw, Zwsl, Zwsl, Zwsl, Uu, Uh, Uh, Md, Md, Md, Md, Md^Xm, Md^Xm, Md^Xm, Md^Xm, Md^Xm, Md^Xm, Md^Xm, Md^Xm, Md^Xm, Md^Xm, Md^Xm, Md^Xm, Md^Xm
Zwsl, Zvw, Zwsl, Zwsl, Qxua, Qxua, Zwsl, Zwsl, Qxua, Qxua, Qxua, Qxua, Zwsl, Zwsl, Qxua, Zwsl, Qxua, Zwsl, Zwsl, Zvw, Zwsl, Zwsl, Zwsl, Zwsl^Ziff, Zwsl^Ziff, Uu^Ziff, Uu, Uu, Uu, Uu^Zdcm, Zwsl^Zdcm, Zwsl^Zdcm, Zwsl^Zdcm, Zwsl^Zdcm, Zvw, Zwsl, Zvw, Zvw, Zwsl, Zwsl, Uu, Uu, Uh, Uh, Md, Md, Md, Md, Md^Xm, Md^Xm, Md^Xm, Md^Xm, Md^Xm, Md^Xm, Md^Xm, Md^Xm, Md^Xm, Md^Xm, Md^Xm, Md^Xm, Md^Xm
Zwsl, Zwsl, Zwsl, Qxua, Qxua, Qxua, Qxua, Qxua^Bw\r, Zwsl, Zwsl, Zwsl, Qxua, Zwsl, Zvw, Qxua, Qxua, Qxua, Zwsl, Zwsl, Zwsl, Zwsl, Zwsl, Zwsl^Ziff, Zwsl^Ziff, Zwsl^Ziff, Uu^Ziff, Uu, Uu, Uu, Zwsl, Zwsl, Zwsl^Zdcm, Zvw^Zdcm, Zvw, Zvw, Zvw, Zwsl, Zwsl, Zwsl, Zwsl, Uu, Uh, Md, Md, Md, Md, Md^Xm, Md^Xm, Md^Xm, Md^Xm, Md^Xm, Md^Xm, Md^Xm, Md^Xm, Md^Xm, Md^Xm, Md^Xm, Md^Xm, Md^Xm, Md^Xm, Md^Xm
Zwsl, Zwsl, Qxua, Qxua^Bw\r, Zwsl, Zwsl, Qxua^Bw/r, Zwsl, Zwsl, Zwsl, Qxua, Qxua^Bw\r, Zwsl, Zwsl, Qxua^Bw\r, Zwsl, Zvw, Qxua, Zwsl, Zwsl, Zwsl, Zwsl, Zwsl^Ziff, Zwsl^Ziff, Zwsl^Ziff, Uu, Uu, Zwsl, Zwsl, Zwsl, Zwsl, Zvw, Zvw, Zvw, Zwsl, Zwsl, Zwsl, Zwsl, Uu, Uu, Uh, Uh, Md, Md, Md, Md, Md^Xm, Md^Xm, Md^Xm, Md^Xm, Md^Xm, Md^Xm, Md^Xm, Md^Xm, Md^Xm, Md^Xm, Md^Xm, Md^Xm, Md^Xm, Md^Xm, Md^Xm
Qxua, Qxua, Qxua, Qxua, Zwsl, Zwsl, Qxua, Qxua, Qxua^Bw|, Qxua, Qxua, Zwsl, Qxua, Qxua, Qxua, Zwsl, Zwsl, Qxua, Zwsl, Zwsl, Zwsl, Zwsl, Zwsl, Zwsl, Uu, Uu, Zwsl, Zwsl, Zwsl^Vzps, Zwsl, Zvw, Zwsl, Zwsl, Zwsl, Zwsl^Ziff, Zwsl, Zwsl, Zwsl, Uu, Uu, Uh, Md, Md, Md^Xm, Md^Xm, Md^Xm, Md^Xm, Md^Xm, Md^Xm, Md^Xm, Md^Xm, Md^Xm, Md^Xm, Md^Xm, Md^Xm, Md^Xm, Md^Xm, Md^Xm, Md^Xm, Md^Xm, Md^Xm
Qxua, Qxua, Qxua, Qxua, Qxua, Zwsl, Qxua^Bw\r, Qxua, Zwsl, Qxua, Zwsl, Qxua, Zwsl, Zwsl, Qxua^Bw/r, Zwsl, Qxua, Qxua^Bw\r, Zwsl, Zwsl, Zwsl, Zwsl^Vzps, Zvw, Zwsl, Uu, Uu, Zwsl, Zwsl, Zvw, Zvw, Zwsl, Zwsl, Zwsl, Zwsl^Ziff, Zwsl^Ziff, Zwsl, Zwsl, Uu, Uh, Uh, Md, Md, Md^Xm, Md^Xm, Xu, Xu, Xu, Xu, Xu, Xu, Xu, Xu, Xu, Xu, Xu, Xu, Xu, Xu, Xu, Xu, Xu
Qxua, Qxua, Qxua, Qxua, Qxua, Qxua, Qxua, Zwsl, Zwsl, Zwsl, Zwsl, Qxua^Bw\r, Zvw, Zwsl, Qxua, Qxua, Zwsl, Qxua, Zwsl, Zwsl, Zvw, Zvw, Zwsl, Zwsl, Zwsl, Zwsl, Zwsl, Zwsl, Zvw, Zwsl, Zwsl, Zwsl, Zwsl, Zwsl^Ziff, Zwsl^Ziff, Zwsl, Uu, Uu^Vzps, Uh, Md, Md, Md, Md^Xm, Md^Xm, Xu, Xu, Xu, Xu, Xu, Xu, Xu, Xu, Cud, Cud, Cud, Uh, Uh, Xu, Xu, Xu, Xu
Qxua, Qxua, Qxua, Qxua, Qxua, Qxua, Qxua, Qxua, Zwsl, Zvw, Zwsl^Vzps, Qxua, Zwsl, Zwsl, Qxua^Bw\r, Zwsl, Zvw, Qxua, Qxua, Zwsl, Zvw, Zwsl, Zwsl, Zwsl, Zwsl, Zwsl, Zwsl, Zvw, Zwsl, Zwsl, Uu, Zwsl, Zwsl^Ziff, Zwsl^Ziff, Zwsl^Ziff, Zwsl, Uu, Uh, Uh, Md, Md, Md, Md^Xm, Md^Xm, Xu, Xu, Xu, Xu, Xu, Xu, Xu, 2 Kud, Cud, Cud, Ur, Uu, Uu^Uf, Uu^Uf, Uu^Uf, Xu, Xu
Qxua, Qxua, Qxua, Qxua, Qxua, Qxua, Qxua, Qxua, Qxua, Qxua, Qxua, Qxua, Qxua^Bw|r, Qxua, Qxua, Zwsl, Zwsl, Zwsl, Qxua^Bw\r, Zwsl, Zwsl, Zvw, Zwsl, Zwsl, Zwsl^Ziff, Zwsl^Ziff, Zwsl, Zvw, Zwsl, Uu, Uu, Zwsl, Zwsl, Zwsl^Ziff, Zwsl, Zwsl, Uu, Uu, Uh, Md, Md, Md, Md, Md^Xm, Xu, Xu, Xu, Xu, Uu, Xu, Xu, Xu, Cud, Cud, Ur, Uu, Xu, Uu^Uf, Uu^Uf, Xu, Xu
Qxua, Qxua, Qxua, Qxua, Qxua, Qxua, Qxua, Qxua, Qxua, Qxua, Qxua, Qxua, Zwsl, Qxua, Qxua, Zwsl, Zwsl, Zwsl, Qxua, Zwsl, Zwsl, Zwsl, Zwsl, Zwsl, Zwsl^Ziff, Zwsl^Ziff, Zwsl^Ziff, Zwsl, Zwsl, Uu, Uu^Vzps, Zwsl, Zvw, Zwsl, Zwsl, Zwsl, Zwsl, Uu, Uu, Uh, Uh, Md, Md, Md^Xm, Xu, Xu, Uu, Uu, Ur, Uu, Xu, Xu, Xu, Uu, Ur, Xu, Xu, Uu^Uf, Uh, Xu, Xu
Qxua, Qxua, Qxua, Qxua, Qxua, Qxua, Qxua, Qxua, Qxua, Qxua, Zwsl, Zwsl, Zvw, Zwsl, Qxua^Bw\r, Qxua^Bw|r, Qxua, Qxua, Qxua, Zwsl, Zvw, Zvw, Zwsl, Zwsl, Zwsl^Ziff, Zwsl^Ziff, Zwsl^Ziff, Zwsl, Uu, Uh, Uu^Zdcm, Zwsl, Zwsl, Zvw, Zwsl, Zwsl, Zwsl, Zwsl, Zwsl, Uh, Zwsl, Zwsl, Uu, Md^Xm, Uu, Xu, Ur, Xu, Ur, Ur, Ur, Xu, Xu, Xu, Ur, Xu, Xu, Xu, Uu, Xu, Xu
Qxua, Qxua, Qxua, Qxua, Qxua, Qxua, Qxua, Qxua, Qxua, Qxua, Qxua, Qxua, Qxua, Qxua, Qxua, Zwsl, Zwsl, Qxua, Qxua^Bw/r, Zwsl, Zwsl, Zvw, Zwsl, Zwsl, Zwsl, Zwsl, Zwsl, Uu, Uh^Zdcm, Uh^Zdcm, Uu^Zdcm, Zwsl, Zwsl^Ziff, Zwsl, Zwsl^Ziff, Zwsl, Uu, Zwsl, Uu, Zwsl, Md, Md, Md, Uu, Xu, Uu, Xu, Ur, Uh, Xu, Ur, Ur, Xu, Uu^Uf, Ur, Xu, Xu, Xu, Uu, Xu, Xu
Qxua, Qxua, Qxua, Qxua, Qxua, Qxua, Qxua, Qxua, Qxua, Qxua, Qxua, Qxua, Qxua, Qxua, Zwsl, Zwsl, Zvw, Zwsl, Qxua, Zwsl, Zwsl, Zvw, Zvw, Zwsl, Zwsl, Zwsl, Uu^Zdcm, Uu^Zdcm, Uh^Zdcm, Uu^Zdcm, Zwsl, Zwsl, Zwsl^Ziff, Zwsl^Ziff, Zwsl, Zwsl, Uu, Uu^Vzps, Uh, Uh, Md, Md, Md^Xm, Md^Xm, Xu, Xu, Xu, Xu, Uh, Xu, Ur, Ur, Xu, Xu, Ur, Xu, Uu^Vzps, Uh, Xu, Xu, Xu
Qxua, Qxua, Qxua, Qxua, Qxua, Qxua, Qxua, Qxua, Qxua, Qxua, Qxua, Qxua, Qxua, Qxua, Qxua, Zwsl, Qxua^Bw\r, Qxua, Qxua, Qxua, Zwsl, Zvw, Zwsl, Zwsl, Zwsl^Vzps, Zwsl, Zwsl^Zdcm, Uu^Zdcm, Uu^Zdcm, Uu^Zdcm, Zwsl, Zwsl^Ziff, Zwsl^Ziff, Zwsl^Ziff, Zwsl, Zwsl, Uu, Uu, Uh, Md, Md, Md, Md^Xm, Md^Xm, Xu, Xu, Xu, Xu, Uu^Uf, Uu^Uf, Ur, Xu, Xu, Xu, Uu^Uf, Ur, Ur, Xu, Xu, Xu, Xu
Qxua, Qxua, Qxua, Qxua, Qxua, Qxua, Qxua, Qxua, Qxua, Qxua, Qxua, Qxua, Qxua, Qxua, Qxua, Qxua, Qxua, Zwsl, Zwsl, Qxua, Zwsl, Zvw, Zvw, Zwsl, Zwsl, Zwsl, Zwsl, Uu^Zdcm, Uu, Uu, Zwsl, Zwsl^Ziff, Zwsl^Ziff, Zwsl, Zwsl, Zwsl, Uu, Uu, Uh, Md, Md, Md^Xm, Md^Xm, Md^Xm, Xu, Xu, Uh, Uu^Uf, Uu^Uf, Xu, Xu, Ur, Xu, Xu, Xu, Uu^Uf, Xu, Ur, Uu^Uf, Xu, Xu
Qxua, Qxua, Qxua, Qxua, Qxua, Qxua, Qxua, Qxua, Qxua, Qxua, Qxua, Qxua, Qxua, Qxua, Qxua, Qxua, Qxua, Zvw, Qxua, Qxua^Bw\r, Zwsl, Zwsl, Zvw, Zwsl, Zwsl^Ziff, Zwsl, Zwsl, Uu, Zwsl, Zwsl, Zwsl, Zwsl, Zwsl, Uu, Uu, Uu, Uh, Uh, Md, Md, Md, Md, Md^Xm, Md^Xm, Xu, Xu, Uu, Xu, Xu, Uu, Ur, Ur, Uu, Xu, Uu^Uf, Uu^Uf, Uu, Ur, Uu, Xu, Xu
Qxua, Qxua, Qxua, Qxua, Qxua, Qxua, Qxua, Qxua, Qxua, Qxua, Qxua, Qxua, Qxua, Qxua, Qxua, Qxua, Qxua, Qxua, Qxua, Qxua, Zwsl, Zvw, Zwsl, Zwsl, Zwsl^Ziff, Zwsl^Ziff, Zwsl^Ziff, Zwsl, Zwsl, Zwsl, Zwsl, Zwsl, Uu, Uu^Vzps, Uh, Uh, Uh, Md, Md, Md, Md, Md, Md^Xm, Md^Xm, Xu, Uh, Uu, Ur, Ur, Ur, Uu, Uh^Vzps, Xu, Xu, Xu, Uu^Uf, Xu, Uu, Ur, Xu, Xu
Qxua, Qxua, Qxua, Qxua, Qxua, Qxua, Qxua, Qxua, Qxua, Qxua, Qxua, Qxua, Qxua, Qxua, Qxua, Qxua, Qxua, Qxua, Qxua, Qxua, Zwsl, Zvw, Zwsl, Zwsl, Zwsl^Ziff, Zwsl^Ziff, Zwsl, Zwsl, Zvw, Zwsl, Zwsl, Zwsl, Uu, Uu, Uh, Uh, Uh, Md, Md, Md, Md, Md^Xm, Md^Xm, Md^Xm, Xu, Xu, Uu^Uf, Ur, Xu, Uu, Uh, Xu, Xu, Uh, Xu, Uh, Xu, Xu, Ur, Xu, Xu
Qxua, Qxua, Qxua, Qxua, Qxua, Qxua, Qxua, Qxua, Qxua, Qxua, Qxua, Qxua, Qxua, Qxua, Qxua, Qxua, Qxua, Qxua, Qxua, Qxua, Qxua, Zvw, Zvw, Zwsl, Zwsl, Zwsl, Zwsl, Zwsl, Zvw, Zvw, Zwsl, Zwsl, Uu, Uh, Uh, Uh, Uh, Uh, Md, Md, Md^Xm, Md^Xm, Md^Xm, Md^Xm, Xu, Xu, Xu, Ur, Xu, Uu, Xu, Xu, Xu, Uu, Uh, Uh^Vzps, Uu^Uf, Ur, Xu, Xu, Xu
Qxua, Qxua, Qxua, Qxua, Qxua, Qxua, Qxua, Qxua, Qxua, Qxua, Qxua, Qxua, Qxua, Qxua, Qxua, Qxua, Qxua, Qxua, Qxua, Qxua, Qxua, Zwsl, Zwsl, Zvw, Zvw, Zwsl, Zwsl, Zwsl, Zwsl, Zwsl, Zwsl, Uu, Uu, Uh, Uh, Uh, Md, Md, Md, Md, Md^Xm, Md^Xm, Md^Xm, Md^Xm, Xu, Xu, Xu, Uu, Ur, Uh, Xu, Xu, Uu, Ur, Xu, Xu, Xu, Uu, Xu, Xu, Xu
Qxua, Qxua, Qxua, Qxua, Qxua, Qxua, Qxua, Qxua, Qxua, Qxua, Qxua, Qxua, Qxua, Qxua, Qxua, Qxua, Qxua, Qxua, Qxua, Qxua, Qxua, Zwsl, Zwsl, Zvw, Zvw, Zwsl, Zvw, Zwsl, Zwsl, Zwsl, Uu, Uu, Uh, Uh, Uh, Md, Md, Md, Md, Md, Md^Xm, Md^Xm, Md^Xm, Md^Xm, Xu, Xu, Xu, Xu, Uh, Uu, Xu, Ur, Xu, Ur, Ur, Xu, Ur, Ur, Xu, Xu, Xu
Qxua, Qxua, Qxua, Qxua, Qxua, Qxua, Qxua, Qxua, Qxua, Qxua, Qxua, Qxua, Qxua, Qxua, Qxua, Qxua, Qxua, Qxua, Qxua, Qxua, Qxua, Zwsl, Zwsl, Zwsl, Zvw, 1 Zvw, Zvw, Zwsl, Zwsl, Zwsl, Uu, Uu, Uh, Uh, Md, Md, Md, Md, Md, Md^Xm, Md^Xm, Md^Xm, Md^Xm, Md^Xm, Xu, Xu, Xu, Xu, Xu, Ur, Ur, Ur, Uu^Uf, Xu, Uh, Ur, Uu^Uf, Uu^Uf, Xu, Xu, Xu
Qxua, Qxua, Qxua, Qxua, Qxua, Qxua, Qxua, Qxua, Qxua, Qxua, Qxua, Qxua, Qxua, Qxua, Qxua, Qxua, Qxua, Qxua, Qxua, Qxua, Qxua, Zwsl, Zwsl, Zwsl, Zvw, Zvw, Zwsl, Zwsl, Zwsl, Zwsl, Uu, Uh, Uh, Md, Md, Md, Md, Md, Md^Xm, Md^Xm, Md^Xm, Md^Xm, Md^Xm, Md^Xm, Xu, Xu, Xu, Xu, Xu, Xu, Uu^Uf, Uu^Uf, Xu, Uu^Uf, Xu, Xu, Xu, Xu, Xu, Xu, Xu
Qxua, Qxua, Qxua, Qxua, Qxua, Qxua, Qxua, Qxua, Qxua, Qxua, Qxua, Qxua, Qxua, Qxua, Qxua, Qxua, Qxua, Qxua, Qxua, Qxua, Qxua, Zwsl, Zwsl, Zwsl, Zwsl, Zwsl, Zwsl, Zwsl, Zwsl, Uu, Uh, Uh, Md, Md, Md, Md, Md, Md^Xm, Md^Xm, Md^Xm, Md^Xm, Md^Xm, Md^Xm, Md^Xm, Xu, Xu, Xu, Xu, Xu, Xu, Xu, Xu, Xu, Xu, Xu, Xu, Xu, Xu, Xu, Xu, Xu
