border_size=1
usage=map

Gg          , Gg          , Gg          , Gg          , Gg          , Gg          , Gg          , Rrc         , Gg          , Gg          , Rb^Gvs      , Gg          , Rb^Gvs      , Gg          , Gg          , Gg          , Rb^Gvs      , Rb^Gvs      , Rb^Gvs      , Gg          , Gg          , Gg          , Ch          , Ch          , Rrc         , Rrc         , Rrc         , Rrc         , Rr^Vhc      , Rrc         , Rrc         , Rrc         , Rrc         , Rr^Vhc      , Rrc         , Rrc         , Rr^Vhc      , Rrc         , Rrc         , Rrc         , Rrc         , Rrc         , Rrc         , Rrc         , Rr^Vhc      , Rrc         
Gg          , Gg          , Rb^Gvs      , Gg          , Gg          , Gg          , Gg          , Rrc         , Rrc         , Rb^Gvs      , Rb^Gvs      , Rb^Gvs      , Rb^Gvs      , Gg          , Rb^Gvs      , Rb^Gvs      , Rb^Gvs      , Rb^Gvs      , Rb^Gvs      , Gg          , Gg          , Ch          , Gg          , Ch          , Rrc         , Rrc         , Rr^Vhc      , Rrc         , Rrc         , Rrc         , Rrc         , Rr^Vhc      , Ch          , Kh          , Rr^Vhc      , Rrc         , Rrc         , Rrc         , Ch          , Ch          , Ch          , Ch          , Ch          , Rrc         , Rrc         , Rrc         
Gg          , Rb^Gvs      , Rb^Gvs      , Rb^Gvs      , Rb^Gvs      , Gs^Vh       , Rb^Gvs      , Gg          , Rrc         , Rb^Gvs      , Rb^Gvs      , Rb^Gvs      , Rb^Gvs      , Rb^Gvs      , Gg          , Rb^Gvs      , Rb^Gvs      , Rb^Gvs      , Gs^Vh       , Rb^Gvs      , Rrc         , Gg          , Rrc         , Rrc         , Rrc         , Rr^Vhc      , Rrc         , Rrc         , Rr^Vhc      , Rr^Vhc      , Rrc         , Rrc         , Ch          , Ch          , Rrc         , Rrc         , Ch          , Ch          , Ch          , Ch          , Kh          , Ch          , Ch          , Ch          , Ch          , Rrc         
Gg          , Rb^Gvs      , Rb^Gvs      , Rb^Gvs      , Rb^Gvs      , Rb^Gvs      , Rb^Gvs      , Gg          , Rrc         , Gs^Vh       , Gg          , Gg          , Gg          , Gg          , Rrc         , Gg          , Rrc         , Rrc         , Rrc         , Rrc         , Gg          , Rrc         , Gg          , Ch          , Ch          , Rrc         , Rrc         , Rrc         , Ch          , Ch          , Kh          , Rr^Vhc      , Rrc         , Rr^Vhc      , Rrc         , Rrc         , Ch          , Ch          , Kh          , Ch          , Ch          , Ch          , Kh          , Ch          , Ch          , Rrc         
Gg          , Rb^Gvs      , Gg          , Rb^Gvs      , Gg          , Rb^Gvs      , Gg          , Gg          , Rrc         , Gg          , Gg          , Gg          , Rrc         , Rrc         , Gg          , Rrc         , Gg          , Rb^Gvs      , Rb^Gvs      , Gs^Vh       , Gg          , Gg          , Ch          , Ch          , Kh          , Ch          , Ch          , Rrc         , Rrc         , Ch          , Rrc         , Rrc         , Rrc         , Rrc         , Rrc         , Rrc         , Ch          , Ch          , Ch          , Ch          , Ch          , Ch          , Ch          , Ch          , Ch          , Ch          
Rb^Gvs      , Gg          , Rb^Gvs      , Rb^Gvs      , Rb^Gvs      , Rb^Gvs      , Gg          , Gg          , Rrc         , Gg          , Rrc         , Rrc         , Gg          , Gg          , Gg          , Gg          , Rb^Gvs      , Rb^Gvs      , Rb^Gvs      , Rb^Gvs      , Gg          , Gg          , Gg          , Ch          , Ch          , Ch          , Rrc         , Rrc         , Rrc         , Rr^Vhc      , Kh          , Rr^Vhc      , Rrc         , Rr^Vhc      , Rrc         , Rrc         , Ch          , Ch          , Kh          , Ch          , Ch          , 8 Kh        , Ch          , Ch          , Kh          , Ch          
Gg          , Rb^Gvs      , Rb^Gvs      , Rb^Gvs      , Rb^Gvs      , Rb^Gvs      , Rrc         , Rrc         , Gg          , Rrc         , Gs^Vh       , Gg          , Rb^Gvs      , Rb^Gvs      , Rb^Gvs      , Gg          , Gg          , Rb^Gvs      , Rb^Gvs      , Rb^Gvs      , Gg          , Gg          , Gg          , Ch          , Gg          , Rrc         , Rrc         , Rr^Vhc      , Rrc         , Ch          , Ch          , Ch          , Rrc         , Rrc         , Rrc         , Rrc         , Rrc         , Ch          , Ch          , Ch          , Ch          , Ch          , Kh          , Ch          , Ch          , Ch          
Gg          , Gg          , Gg          , Gs^Vh       , Rrc         , Rrc         , Gg          , Gg          , Gg          , Gg          , Rb^Gvs      , Rb^Gvs      , Rb^Gvs      , Rb^Gvs      , Rb^Gvs      , Gg          , Gg          , Gg          , Gg          , Gg          , Rb^Gvs      , Gg          , Gs^Vh       , Gg          , Rrc         , Rrc         , Ch          , Rrc         , Ch          , Rrc         , Rrc         , Rr^Vhc      , Rrc         , Rrc         , Rr^Vhc      , Rrc         , Rrc         , Ch          , Ch          , Ch          , Ch          , Ch          , Ch          , Ch          , Ch          , Ch          
Gg          , Gg          , Rrc         , Rrc         , Gg          , Gg          , Gg          , Gg          , Gg          , Gg          , Gg          , Rb^Gvs      , Gg          , Rb^Gvs      , Gg          , Gg          , Gg          , Gg          , Rb^Gvs      , Rb^Gvs      , Rb^Gvs      , Rb^Gvs      , Rrc         , Rrc         , Gg          , Ch          , Ch          , Ch          , Ch          , Rrc         , Rrc         , Rr^Vhc      , 6 Kh        , Ch          , Rrc         , Rrc         , Rrc         , Rrc         , Rrc         , Ch          , Rrc         , Ch          , Rrc         , Ch          , Rrc         , Rrc         
Rrc         , Rrc         , Gg          , Gg          , Gg          , Gg          , Rb^Gvs      , Rb^Gvs      , Rb^Gvs      , Gg          , Gg          , Gg          , Rb^Gvs      , Gg          , Gg          , Gg          , Gg          , Rb^Gvs      , Rb^Gvs      , Rb^Gvs      , Rb^Gvs      , Rb^Gvs      , Rrc         , Gg          , Gg          , Ch          , Ch          , 7 Kh        , Ch          , Ch          , Rrc         , Rrc         , Ch          , Ch          , Rr^Vhc      , Rrc         , Rrc         , Rr^Vhc      , Rrc         , Rrc         , Rrc         , Rrc         , Rrc         , Rrc         , Rrc         , Rrc         
Gg          , Rrc         , Rrc         , Gg          , Gg          , Rb^Gvs      , Rb^Gvs      , Rb^Gvs      , Rb^Gvs      , Gg          , Rb^Gvs      , Rb^Gvs      , Rb^Gvs      , Gg          , Rb^Gvs      , Rb^Gvs      , Rb^Gvs      , Gg          , Gg          , Rb^Gvs      , Rrc         , Rrc         , Gg          , Rb^Gvs      , Rb^Gvs      , Gg          , Gg          , Ch          , Rrc         , Rrc         , Rrc         , Rr^Vhc      , Rrc         , Rrc         , Rrc         , Rrc         , Rr^Vhc      , Rrc         , Rr^Vhc      , Rrc         , Rrc         , Rr^Vhc      , Rrc         , Rrc         , Rrc         , Rrc         
Gg          , Gg          , Gg          , Rrc         , Rrc         , Rb^Gvs      , Gs^Vh       , Rb^Gvs      , Gg          , Rb^Gvs      , Rb^Gvs      , Rb^Gvs      , Rb^Gvs      , Gg          , Rb^Gvs      , Rb^Gvs      , Rb^Gvs      , Gg          , Gg          , Gg          , Rrc         , Rb^Gvs      , Rb^Gvs      , Rb^Gvs      , Rb^Gvs      , Gg          , Gg          , Gg          , Gg          , Rrc         , Rrc         , Rrc         , Ch          , Rrc         , Rrc         , Rrc         , Rrc         , Rr^Vhc      , Rrc         , Ch          , Ch          , Rrc         , Rrc         , Rr^Vhc      , Rr^Vhc      , Rrc         
Gg          , Gg          , Gg          , Gg          , Gg          , Rrc         , Rrc         , Gg          , Gg          , Rb^Gvs      , Rb^Gvs      , Rb^Gvs      , Gg          , Gg          , Rb^Gvs      , Rb^Gvs      , Rb^Gvs      , Rb^Gvs      , Rrc         , Rrc         , Gs^Vh       , Rb^Gvs      , Rb^Gvs      , Rb^Gvs      , Gg          , Gg          , Rrc         , Gg          , Rrc         , Rrc         , Ch          , Ch          , Ch          , Ch          , Rrc         , Rrc         , Rrc         , Rrc         , Rr^Vhc      , Kh          , Ch          , Rr^Vhc      , Rrc         , Rrc         , Rrc         , Rrc         
Gg          , Gg          , Gg          , Gg          , Gg          , Gg          , Gg          , Rrc         , Rrc         , Rrc         , Rrc         , Gs^Vh       , Rrc         , Gg          , Gg          , Gg          , Gg          , Gs^Vh       , Rrc         , Gg          , Rrc         , Gg          , Gg          , Gg          , Rrc         , Rrc         , Gs^Vh       , Rrc         , Gg          , Ch          , Ch          , Kh          , Ch          , Ch          , Rrc         , Rr^Vhc      , Rrc         , Rrc         , Rrc         , Rrc         , Rrc         , Rrc         , Rrc         , Rrc         , Rr^Vhc      , Rrc         
Gg          , Rb^Gvs      , Rb^Gvs      , Rb^Gvs      , Rb^Gvs      , Gg          , Gg          , Gg          , Gg          , Gg          , Rb^Gvs      , Rrc         , Gg          , Rrc         , Rrc         , Gg          , Rrc         , Rrc         , Rb^Gvs      , Rrc         , Gg          , Rrc         , Rrc         , Rrc         , Rb^Gvs      , Rb^Gvs      , Rb^Gvs      , Rb^Gvs      , Gg          , Gg          , Gg          , Ch          , Rrc         , Rrc         , Rrc         , Rrc         , Ch          , Rrc         , Rr^Vhc      , Rrc         , Rrc         , Rr^Vhc      , Rrc         , Rrc         , Rrc         , Rrc         
Gg          , Rb^Gvs      , Rb^Gvs      , Rb^Gvs      , Gs^Vh       , Rb^Gvs      , Gg          , Gg          , Gg          , Rb^Gvs      , Rb^Gvs      , Rb^Gvs      , Rb^Gvs      , Gg          , Gg          , Rrc         , Rrc         , Rb^Gvs      , Rb^Gvs      , Rb^Gvs      , Gg          , Gg          , Gg          , Gg          , Rb^Gvs      , Rb^Gvs      , Rb^Gvs      , Rb^Gvs      , Gg          , Gg          , Gg          , Gg          , Rrc         , Rrc         , Ch          , Ch          , Ch          , Ch          , Rrc         , Rrc         , Rr^Vhc      , Rrc         , Rrc         , Rr^Vhc      , Rrc         , Rrc         
Gg          , Gg          , Gg          , Rb^Gvs      , Rb^Gvs      , Rb^Gvs      , Rb^Gvs      , Gg          , Gg          , Rb^Gvs      , Rb^Gvs      , Gs^Vh       , Rb^Gvs      , Rb^Gvs      , Rrc         , Rrc         , Gs^Vh       , Rb^Gvs      , Rb^Gvs      , Rb^Gvs      , Rb^Gvs      , Gg          , Rb^Gvs      , Gg          , Rb^Gvs      , Rb^Gvs      , Gg          , Gg          , Rrc         , Gg          , Rrc         , Rrc         , Gs^Vh       , Ch          , Ch          , Kh          , Ch          , Ch          , Rrc         , Rrc         , Rrc         , Rrc         , Rrc         , Rrc         , Rrc         , Rrc         
Gg          , Gg          , Gg          , Gg          , Gg          , Rb^Gvs      , Gg          , Gg          , Gg          , Gg          , Gg          , Rb^Gvs      , Rrc         , Rrc         , Gg          , Gg          , Gg          , Rb^Gvs      , Gg          , Rb^Gvs      , Rb^Gvs      , Rb^Gvs      , Rb^Gvs      , Gg          , Gg          , Gg          , Rrc         , Rrc         , Gg          , Rrc         , Rb^Gvs      , Rb^Gvs      , Rb^Gvs      , Gg          , Gg          , Ch          , Gg          , Rrc         , Rrc         , Rrc         , Ch          , Rrc         , Ch          , Rrc         , Rr^Vhc      , Rrc         
Gg          , Gg          , Rb^Gvs      , Gg          , Gg          , Gg          , Gg          , Gg          , Gg          , Gg          , Rrc         , Rrc         , Rb^Gvs      , Rrc         , Rrc         , Gg          , Gg          , Gg          , Gg          , Rb^Gvs      , Rb^Gvs      , Rb^Gvs      , Rb^Gvs      , Gs^Vh       , Rrc         , Rrc         , Gg          , Gg          , Rb^Gvs      , Rb^Gvs      , Rb^Gvs      , Rb^Gvs      , Rb^Gvs      , Rb^Gvs      , Gg          , Gg          , Rrc         , Rrc         , Gg          , Ch          , Ch          , Ch          , Ch          , Rrc         , Rrc         , Rrc         
Gg          , Rb^Gvs      , Rb^Gvs      , Rb^Gvs      , Gs^Vh       , Gg          , Gg          , Gg          , Gg          , Rrc         , Gs^Vh       , Rb^Gvs      , Rb^Gvs      , Gg          , Gg          , Rrc         , Gg          , Gg          , Gg          , Gg          , Gg          , Gg          , Rrc         , Rrc         , Rb^Gvs      , Gs^Vh       , Rb^Gvs      , Gg          , Rb^Gvs      , Rb^Gvs      , Gg          , Rb^Gvs      , Gg          , Gg          , Gg          , Rrc         , Gg          , Gg          , Gg          , Ch          , Ch          , Kh          , Ch          , Rrc         , Rrc         , Rrc         
Rb^Gvs      , Rb^Gvs      , Rb^Gvs      , Rb^Gvs      , Rb^Gvs      , Gg          , Gg          , Gg          , Rrc         , Rrc         , Rb^Gvs      , Rb^Gvs      , Rb^Gvs      , Gg          , Rb^Gvs      , Rrc         , Rrc         , Gg          , Gg          , Gg          , Rrc         , Rrc         , Gg          , Rb^Gvs      , Rb^Gvs      , Rb^Gvs      , Rb^Gvs      , Rb^Gvs      , Rb^Gvs      , Gg          , Rb^Gvs      , Gg          , Gs^Vh       , Gg          , Rrc         , Rrc         , Gg          , Gg          , Gg          , Gg          , Gg          , Ch          , Gg          , Gg          , Rrc         , Gg          
Rb^Gvs      , Rb^Gvs      , Rb^Gvs      , Rb^Gvs      , Gg          , Gg          , Rrc         , Rrc         , Gg          , Gg          , Rb^Gvs      , Rb^Gvs      , Gg          , Gs^Vh       , Rb^Gvs      , Gg          , Gg          , Rrc         , Rrc         , Rrc         , Gg          , Gg          , Gg          , Rb^Gvs      , Rb^Gvs      , Rb^Gvs      , Rb^Gvs      , Rb^Gvs      , Gg          , Rb^Gvs      , Rb^Gvs      , Rb^Gvs      , Rrc         , Rrc         , Rb^Gvs      , Gg          , Gg          , Gg          , Gg          , Gg          , Gs^Vh       , Gg          , Gg          , Gg          , Rrc         , Gg          
Gg          , Gg          , Gg          , Gg          , Rrc         , Rrc         , Gg          , Gg          , Rb^Gvs      , Gg          , Rb^Gvs      , Rb^Gvs      , Gg          , Rb^Gvs      , Rb^Gvs      , Rb^Gvs      , Gg          , Gg          , Gg          , Rrc         , Rrc         , Gg          , Rrc         , Gg          , Gg          , Gg          , Gg          , Gg          , Gg          , Rb^Gvs      , Rb^Gvs      , Rb^Gvs      , Rrc         , Gg          , Rb^Gvs      , Rb^Gvs      , Rb^Gvs      , Gg          , Gg          , Rb^Gvs      , Rb^Gvs      , Rb^Gvs      , Rb^Gvs      , Rrc         , Gg          , Gg          
Gg          , Gg          , Gg          , Rrc         , Gg          , Gg          , Gg          , Rb^Gvs      , Rb^Gvs      , Rb^Gvs      , Gg          , Gg          , Rb^Gvs      , Rb^Gvs      , Rb^Gvs      , Rb^Gvs      , Gg          , Gg          , Gg          , Rrc         , Gg          , Rrc         , Gg          , Rrc         , Rrc         , Gg          , Gg          , Gg          , Gg          , Rb^Gvs      , Rrc         , Rrc         , Gg          , Rb^Gvs      , Rb^Gvs      , Gs^Vh       , Gg          , Gg          , Gg          , Rb^Gvs      , Gg          , Rb^Gvs      , Rb^Gvs      , Rrc         , Gg          , Gg          
Gg          , Gg          , Gg          , Rrc         , Gg          , Gg          , Rb^Gvs      , Gs^Vh       , Rb^Gvs      , Gg          , Rb^Gvs      , Rb^Gvs      , Rb^Gvs      , Gg          , Gg          , Rb^Gvs      , Rb^Gvs      , Gg          , Gg          , Rrc         , Gg          , Gg          , Gs^Vh       , Gg          , Gg          , Rrc         , Rrc         , Gg          , Rrc         , Rrc         , Gg          , Gg          , Gg          , Rb^Gvs      , Rb^Gvs      , Rb^Gvs      , Gg          , Gg          , Gg          , Gg          , Rb^Gvs      , Gg          , Gg          , Rrc         , Gg          , Gg          
Gg          , Gg          , Rrc         , Rrc         , Gs^Vh       , Rb^Gvs      , Rb^Gvs      , Rb^Gvs      , Rb^Gvs      , Gg          , Rb^Gvs      , Rb^Gvs      , Rb^Gvs      , Rb^Gvs      , Rb^Gvs      , Rb^Gvs      , Rb^Gvs      , Rb^Gvs      , Gg          , Rrc         , Gg          , Rb^Gvs      , Rb^Gvs      , Gg          , Rb^Gvs      , Rb^Gvs      , Gg          , Rrc         , Rrc         , Gg          , Gg          , Gg          , Gg          , Gg          , Gg          , Gg          , Gg          , Gg          , Gg          , Rb^Gvs      , Rb^Gvs      , Gg          , Gg          , Rrc         , Gg          , Gg          
Gg          , Gg          , Rrc         , Gg          , Rb^Gvs      , Rb^Gvs      , Rb^Gvs      , Rb^Gvs      , Rb^Gvs      , Gg          , Gg          , Gs^Vh       , Rb^Gvs      , Rb^Gvs      , Rb^Gvs      , Rb^Gvs      , Rb^Gvs      , Gs^Vh       , Gg          , Rrc         , Gg          , Rb^Gvs      , Rb^Gvs      , Gg          , Rb^Gvs      , Rb^Gvs      , Rb^Gvs      , Gg          , Gg          , Rrc         , Gg          , Gg          , Rb^Gvs      , Rb^Gvs      , Gg          , Gg          , Gg          , Gg          , Gg          , Rb^Gvs      , Rb^Gvs      , Gs^Vh       , Gg          , Rrc         , Gg          , Gg          
Gg          , Rrc         , Gg          , Gg          , Rb^Gvs      , Rb^Gvs      , Rb^Gvs      , Rb^Gvs      , Rb^Gvs      , Gg          , Gg          , Rb^Gvs      , Rb^Gvs      , Gg          , Gg          , Rb^Gvs      , Gg          , Gg          , Gg          , Rrc         , Gg          , Rb^Gvs      , Gg          , Gg          , Rb^Gvs      , Gs^Vh       , Rb^Gvs      , Gg          , Gg          , Rrc         , Gg          , Rb^Gvs      , Rb^Gvs      , Rb^Gvs      , Gg          , Gg          , Gg          , Gg          , Gg          , Rb^Gvs      , Rb^Gvs      , Rb^Gvs      , Gg          , Rrc         , Gg          , Gg          
Rrc         , Rrc         , Gg          , Gg          , Gg          , Rb^Gvs      , Ce          , Ce          , Ce          , Gg          , Gg          , Gg          , Rb^Gvs      , Gg          , Gg          , Gg          , Gg          , Gg          , Gg          , Rrc         , Gg          , Rb^Gvs      , Rb^Gvs      , Rb^Gvs      , Gg          , Rb^Gvs      , Gg          , Gg          , Gg          , Rrc         , Gg          , Rb^Gvs      , Rb^Gvs      , Gg          , Rb^Gvs      , Gg          , Rb^Gvs      , Gg          , Gg          , Gg          , Gg          , Gg          , Gg          , Rrc         , Gg          , Gg          
Gg          , Gg          , Rb^Gvs      , Gg          , Ce          , Ce          , 2 Ke        , Ce          , Ce          , Gg          , Rb^Gvs      , Rb^Gvs      , Rb^Gvs      , Rb^Gvs      , Gs^Vh       , Gg          , Gg          , Gg          , Gg          , Rrc         , Gg          , Rb^Gvs      , Rb^Gvs      , Rb^Gvs      , Gg          , Gg          , Gg          , Rb          , Rb          , Rrc         , Gg          , Gg          , Gg          , Gg          , Rb^Gvs      , Rb^Gvs      , Gs^Vh       , Rb^Gvs      , Gg          , Gg          , Rb^Gvs      , Gg          , Gg          , Rrc         , Gg          , Gg          
Gg          , Gs^Vh       , Rb^Gvs      , Rb^Gvs      , Rb^Gvs      , Ce          , Ce          , Ce          , Gg          , Gg          , Gg          , Rb^Gvs      , Rb^Gvs      , Rb^Gvs      , Rb^Gvs      , Gg          , Gg          , Gg          , Rrc         , Rrc         , Rb^Gvs      , Rb^Gvs      , Rb^Gvs      , Rb^Gvs      , Gg          , Gg          , Rb^Gvs      , Gs^Vh       , Gg          , Rrc         , Gg          , Gg          , Gg          , Rb^Gvs      , Rb^Gvs      , Rb^Gvs      , Rb^Gvs      , Rb^Gvs      , Gg          , Rb^Gvs      , Rb^Gvs      , Rb^Gvs      , Gg          , Rrc         , Gg          , Gg          
Gg          , Gg          , Rb^Gvs      , Rb^Gvs      , Rb^Gvs      , Rb^Gvs      , Gg          , Gg          , Rb^Gvs      , Gg          , Ce          , Ce          , Ce          , Ce          , Gg          , Gg          , Rrc         , Rrc         , Gs^Vh       , Gg          , Ce          , Gs^Vh       , Gg          , Gg          , Gg          , Ce          , Ce          , Rb^Gvs      , Ce          , Rrc         , Gg          , Gg          , Gg          , Gg          , Gg          , Rb^Gvs      , Gg          , Rb^Gvs      , Gg          , Rb^Gvs      , Rb^Gvs      , Rb^Gvs      , Gg          , Rrc         , Gg          , Gg          
Gg          , Gg          , Gg          , Rb^Gvs      , Gg          , Rb^Gvs      , Rb^Gvs      , Gg          , Rb^Gvs      , Rb^Gvs      , Gg          , Ce          , 1 Ke        , Ce          , Gg          , Rrc         , Rb^Gvs      , Rb^Gvs      , Ce          , Ce          , 3 Ke        , Ce          , Ce          , Gg          , Ce          , Ce          , 4 Ke        , Ce          , Ce          , Rrc         , Gg          , Gg          , Ce          , Ce          , Ce          , Ce          , Ce          , Gg          , Gg          , Rb^Gvs      , Gs^Vh       , Rb^Gvs      , Gg          , Rrc         , Gg          , Gg          
Gg          , Gg          , Gg          , Gg          , Gg          , Gg          , Rb^Gvs      , Rb^Gvs      , Rb^Gvs      , Rb^Gvs      , Gs^Vh       , Ce          , Ce          , Ce          , Rrc         , Rrc         , Rb^Gvs      , Rb^Gvs      , Rb^Gvs      , Ce          , Ce          , Ce          , Gg          , Rb^Gvs      , Rb^Gvs      , Ce          , Ce          , Ce          , Gg          , Rrc         , Gg          , Gg          , Ce          , 9 Ke        , Ce          , Ce          , Ce          , Gg          , Gg          , Rb^Gvs      , Rb^Gvs      , Gg          , Gg          , Rrc         , Gg          , Gg          
Gg          , Gg          , Gg          , Gg          , Gg          , Gg          , Gg          , Rb^Gvs      , Rb^Gvs      , Rb^Gvs      , Gg          , Gg          , Gg          , Rrc         , Gg          , Gg          , Gg          , Rb^Gvs      , Rb^Gvs      , Ce          , Rb^Gvs      , Gg          , Rb^Gvs      , Rb^Gvs      , Rb^Gvs      , Ce          , Rb^Gvs      , Rb^Gvs      , Gs^Vh       , Rrc         , Rrc         , Gg          , Gg          , Ce          , Gg          , Ce          , Gg          , Gg          , Gg          , Gg          , Gg          , Gg          , Gg          , Rrc         , Gg          , Gg          
