border_size=1
usage=map

Qxua, Qxua, Qxua, Qxua, Qxua, Qxua, Qxua, Qxua, Qxua, Qxua, Qxua, Qxua, Qxua, Qxua, Qxua, Qxua, Qxua, Qxua, Qxua, Qxua, Qxua, Qxua, Qxua, Qxua, Qxua, Qxua, Qxua, Qxua, Qxua, Qxua, Qxua, Qxua, Qxua, Qxua, Qxua, Qxua, Qxua, Qxua, Qxua, Qxua, Qxua, Qxua, Qxua, Qxua, Qxua, Qxua, Qxua, Qxua, Qxua, Qxua, Qxua, Qxua, Qxua, Qxua, Qxua, Qxua, Qxua, Qxua, Qxua, Qxua, Qxua
Qxua, Qxua, Qxua, Qxua, Qxua, Qxua, Qxua, Qxua, Qxua, Qxua, Qxua, Qxua, Qxua, Qxua, Qxua, Qxua, Qxua, Qxua, Qxua, Qxua, Qxua, Qxua, Qxua, Qxua, Qxua, Qxua, Qxua, Qxua, Qxua, Qxua, Qxua, Qxua, Qxua, Qxua, Qxua, Qxua, Qxua, Qxua, Qxua, Qxua, Qxua, Qxua, Qxua, Qxua, Qxua, Qxua, Qxua, Qxua, Qxua, Qxua, Qxua, Qxua, Qxua, Qxua, Qxua, Qxua, Qxua, Qxua, Qxua, Qxua, Qxua
Qxua, Qxua, Qxua, Qxua, Qxua, Qxua, Qxua, Qxua, Qxua, Qxua, Qxua, Qxua, Qxua, Qxua, Qxua, Qxua, Qxua, Qxua, Qxua, Qxua, Qxua, Qxua, Qxua, Qxua, Qxua, Qxua, Qxua, Qxua, Qxua, Qxua, Qxua, Qxua, Qxua, Qxua, Qxua, Qxua, Qxua, Qxua, Qxua, Qxua, Qxua, Qxua, Qxua, Qxua, Qxua, Qxua, Qxua, Qxua, Qxua, Qxua, Qxua, Qxua, Qxua, Qxua, Qxua, Qxua, Cud, Cud, Cud, Qxua, Qxua
Qxua, Qxua, Qxua, Qxua, Qxua, Qxua, Qxua, Qxua, Qxua, Qxua, Qxua, Qxua, Qxua, Qxua, Qxua, Qxua, Qxua, Qxua, Qxua, Qxua, Qxua, Qxua, Qxua, Qxua, Qxua, Qxua, Qxua, Qxua, Qxua, Qxua, Qxua, Qxua, Qxua, Qxua, Qxua, Qxua, Qxua, Qxua, Qxua, Qxua, Qxua, Qxua, Qxua, Qxua, Qxua, Qxua, Qxua, Qxua, Qxua, Qxua, Qxua, Qxua, Qxua, Qxua, Qxua, Qxua, Cud, 2 Kud, Cud, Qxua, Qxua
Qxua, Qxua, Qxua, Qxua, Qxua, Qxua, Qxua, Qxua, Qxua, Qxua, Qxua, Qxua, Qxua, Qxua, Qxua, Qxua, Qxua, Qxua, Qxua, Qxua, Qxua, Qxua, Qxua, Qxua, Qxua, Qxua, Qxua, Qxua, Qxua, Qxua, Qxua, Qxua, Qxua, Qxua, Qxua, Qxua, Qxua, Qxua, Qxua, Qxua, Qxua, Qxua, Qxua, Qxua, Qxua, Qxua, Qxua, Qxua, Qxua, Qxua, Qxua, Qxua, Qxua, Qxua, Qxua, Qxua, Qxua, Cud, Qxua, Qxua, Qxua
Qxua, Qxua, Qxua, Qxua, Qxua, Qxua, Qxua, Qxua, Qxua, Qxua, Qxua, Qxua, Qxua, Qxua, Qxua, Qxua, Qxua, Qxua, Qxua, Qxua, Qxua, Qxua, Qxua, Qxua, Zwsl^Vzps, Zwsl, Zwsl, Zwsl, Zgwl, Qxua, Qxua, Qxua, Qxua, Qxua, Qxua, Qxua, Qxua, Qxua, Qxua, Qxua, Qxua, Qxua, Qxua, Qxua, Qxua, Qxua, Qxua, Qxua, Qxua, Qxua, Qxua, Qxua, Qxua, Qxua, Qxua, Qxua, Qxua, Qxua, Qxua, Qxua, Qxua
Qxua, Qxua, Qxua, Qxua, Qxua, Qxua, Qxua, Qxua, Qxua, Qxua, Qxua, Qxua, Qxua, Qxua, Qxua, Qxua, Qxua, Qxua, Qxua, Qxua, Qxua, Qxua, Qxua, Qxua, Zwsl, Zwsl, Uu, Zwsl, Uh, Zwsl, Zwsl, Qxua, Zwsl, Qxua, Qxua, Qxua, Qxua, Qxua, Qxua, Qxua, Qxua, Qxua, Qxua, Qxua, Qxua, Qxua, Qxua, Qxua, Qxua, Qxua, Qxua, Qxua, Qxua, Qxua, Qxua, Qxua, Qxua, Qxua, Qxua, Qxua, Qxua
Qxua, Qxua, Qxua, Qxua, Qxua, Qxua, Qxua, Qxua, Qxua, Qxua, Qxua, Qxua, Qxua, Qxua, Qxua, Qxua, Qxua, Qxua, Qxua, Qxua, Zwsl, Qxua, Zwsl^Zewt, Zwsl, Md, Zvw, Md, Uh, Md, Uh, Md^Zews, Zwsl, Uu, Zwsl, Zwsl, Zwsl^Zewt, Zwsl, Qxua, Zwsl, Qxua, Qxua, Qxua, Qxua, Qxua, Qxua, Qxua, Qxua, Qxua, Qxua, Qxua, Qxua, Qxua, Qxua, Qxua, Qxua, Qxua, Qxua, Qxua, Qxua, Qxua, Qxua
Qxua, Qxua, Qxua, Qxua, Qxua, Qxua, Qxua, Qxua, Qxua, Qxua, Qxua, Qxua, Qxua, Qxua, Qxua, Qxua, Zwsl, Zwsl, Zwsl, Zwsl, Md, Zwsl, Md, Md, Md^Xm, Md, Md, Md, Md, Md, Md^Xm, Md, Md, Md, Uh, Uu, Uu, Zwsl, Zwsl^Vzps, Zwsl, Zwsl^Zewc, Qxua, Qxua, Qxua, Qxua, Qxua, Qxua, Qxua, Qxua, Qxua, Qxua, Qxua, Qxua, Qxua, Qxua, Qxua, Qxua, Qxua, Qxua, Qxua, Qxua
Qxua, Qxua, Qxua, Qxua, Qxua, Qxua, Qxua, Qxua, Qxua, Qxua, Qxua, Qxua, Qxua, Qxua, Zwsl, Zwsl, Md, Md, Md^Xm, Md^Xm, Md^Xm, Md^Xm, Md^Xm, Md^Xm, Md^Xm, Md^Xm, Md^Xm, Md^Xm, Md^Xm, Md^Xm, Md^Xm, Md^Xm, Md, Md, Md, Uh, Uh, Uu, Zwsl, Zwsl, Zwsl, Zwsl, Qxua, Qxua, Qxua, Qxua, Qxua, Qxua, Qxua, Qxua, Qxua, Qxua, Qxua, Qxua, Qxua, Qxua, Qxua, Qxua, Qxua, Qxua, Qxua
Qxua, Qxua, Qxua, Qxua, Qxua, Qxua, Qxua, Qxu, Qxua^Bw\r, Qxua, Qxua, Qxua, Qxua, Qxua, Zwsl^Zewt, Uh, Md^Xm, Md^Xm, Xu, Xu, Xu, Xu, Xu, Xu, Xu, Md^Xm, Md^Xm, Md^Xm, Md^Xm, Md^Xm, Md^Xm, Md, Md, Md, Uh, Uh, Uh, Uu, Zwsl, Zwsl, Zgwl, Zwsl, Zwsl, Qxua, Qxua, Qxua, Qxua, Qxua, Qxua, Qxua, Qxua, Qxua, Qxua, Qxua, Qxua, Qxua, Qxua, Qxua, Qxua, Qxua, Qxua
Qxua, Qxua, Qxua, Qxua, Qxua, Qxua, Qxua, Qxua, Qxua, Qxua^Bw\r, Qxua^Bw\r, Qxua, Zwsl, Zwsl, Md, Md, Md^Xm, Md^Xm, Xu, Ur, Ur, Zgwl, Ur, Xu, Xu, Md^Xm, Md^Xm, Md^Xm, Md^Xm, Md^Xm, Md^Xm, Md, Md, Md, Uh, Uh, Uu, Uu^Zews, Zwsl, Zwsl^Ziff, Zwsl^Ziff, Zwsl, Zwsl, Zwsl^Zewt, Qxua, Qxua, Qxua, Qxua, Qxua, Qxua, Qxua, Qxua, Qxua, Qxua, Qxua, Qxua, Qxua, Qxua, Qxua, Qxua, Qxua
Qxua, Qxua, Qxua, Qxua, Qxua, Qxua, Qxua, Qxua, Qxua, Qxua, Qxua, Zwsl, Zwsl, Uh, Md, Md^Xm, Md^Xm, Md^Xm, Xu, Xu, Ur, Xu, Xu, Ur, Xu, Md^Xm, Md^Xm, Md^Xm, Md^Xm, Md^Xm, Md, Md, Md, Uh, Uh, Uh, Uu, Zwsl, Zwsl, Zwsl, Zwsl^Ziff, Zwsl, Zwsl, Zwsl, Qxua, Qxua, Qxua, Qxua, Qxua, Qxua, Qxua, Qxua, Qxua, Qxua, Qxua, Qxua, Qxua, Qxua, Qxua, Qxua, Qxua
Qxua, Qxua, Qxua, Qxua, Qxua, Qxua, Qxua, Qxua, Qxua, Qxua, Zwsl^Zews, Zwsl, Uh^Vzps, Md, Md^Xm, Md^Xm, Md^Xm, Md^Xm, Xu, Ur, Xu, Xu, Ur, Ur, Xu, Md^Xm, Md^Xm, Md^Xm, Md^Xm, Md, Md, Md, Md, Uh, Uu, Uu, Uu, Zwsl^Zewt, Zwsl, Zwsl^Ziff, Zwsl^Ziff, Zwsl^Ziff, Zwsl, Zwsl, Qxua, Qxua, Qxua, Qxua, Qxua, Qxua, Qxua, Qxua, Qxua, Qxua, Qxua, Qxua, Qxua, Qxua, Qxua, Qxua, Qxua
Qxua, Qxua, Qxua, Qxua, Qxua, Qxua, Qxua, Qxua, Qxua, Zwsl, Zwsl, Uu, Uh, Md, Md^Xm, Md^Xm, Md^Xm, Md^Xm, Xu, Ur, Ur, Xu, Ur, Xu, Xu, Md^Xm, Md^Xm, Md^Xm, Md, Md, Md, Md, Md, Uh, Uu, Uu, Uu, Zwsl, Zwsl^Zewe, Zwsl^Ziff, Zwsl^Ziff, Zwsl^Ziff, Zwsl, Zwsl, Qxua, Qxua, Qxua, Qxua, Qxua, Qxua, Qxua, Qxua, Qxua, Qxua, Qxua, Qxua, Qxua, Qxua, Qxua, Qxua, Qxua
Qxua, Qxua, Qxua, Qxua, Qxua, Qxua, Qxua, Qxua, Qxua, Zwsl, Zgwl, Uh, Md, Md, Md^Xm, Md^Xm, Md^Xm, Md^Xm, Xu, Xu, Xu, Xu, Zwsl, Xu, Xu, Md^Xm, Md^Xm, Md^Xm, Md, Md, Md, Md^Xm, Md, Uh, Uh, Uu, Zwsl, Zwsl, Zvw^Vzps, Zwsl^Ziff, Zvw, Zwsl^Ziff, Zwsl, Zwsl, Qxua, Qxua, Qxua, Qxua, Qxua, Qxua, Qxua, Qxua, Qxua, Qxua, Qxua, Qxua, Qxua, Qxua, Qxua, Qxua, Qxua
Qxua, Qxua, Qxua, Qxua, Qxua, Qxua, Qxua, Qxua, Zwsl, Zwsl, Uu, Uh, Md, Md, Md^Xm, Md^Xm, Md^Xm, Md^Xm, Md^Xm, Md^Xm, Md^Xm, Md^Xm, Zwsl, Md^Xm, Md^Xm, Md^Xm, Md, Md, Uh, Md, Md, Md^Xm, Md^Xm, Uh, Uh, Uu, Uu, Zvw, Zvw, Zwsl, Zvw, Zwsl, Zwsl, Zwsl^Zewe, Qxua, Qxua, Qxua, Qxua, Qxua, Qxua, Qxua, Qxua, Qxua, Qxua, Qxua, Qxua, Qxua, Qxua, Qxua, Qxua, Qxua
Qxua, Qxua, Qxua, Qxua, Qxua, Qxua, Qxua, Zwsl, Zwsl^Zewt, Uu, Uh, Uh, Md, Md, Md^Xm, Md^Xm, Md^Xm, Md^Xm, Md, Md, Md, Md, Zwsl, Md, Md, Md, Uh, Uh, Uh, Uh, Md, Md, Md^Xm, Md, Md, Uh, Uu, Zwsl, Zgwl, Zwsl, Zvw, Zwsl, Zwsl, Zwsl, Zwsl^Zewt, Qxua, Qxua, Qxua, Qxua, Qxua, Qxua, Qxua, Qxua, Qxua, Qxua, Qxua, Qxua, Qxua, Qxua, Qxua, Qxua
Qxua, Qxua, Qxua, Qxua, Qxua, Qxua, Qxua, Zwsl, Zwsl, Uu, Uh, Md, Md, Md^Xm, Md, Md, Md, Md, Md, Md, Uh, Uh, Zwsl, Uh, Zvw, Uh, Uu, Uh, Uu, Uh, Uh, Md, Md, Md^Xm, Md, Uh, Uh, Uu, Uu, Zwsl, Zvw, Zwsl, Uu, Zwsl, Zwsl, Qxua, Qxua, Qxua, Qxua, Qxua, Qxua, Qxua, Qxua, Qxua, Qxua, Qxua, Qxua, Qxua, Qxua, Qxua, Qxua
Qxua, Qxua, Qxua, Qxua, Qxua, Qxua, Qxua, Zwsl, Zwsl, Uu, Uh, Md, Md, Md, Md^Xm, Md, Md, Md, Uh, Uh, Uh, Uu, Zvw, Zwsl, Zwsl, Zvw, Zwsl, Zwsl, Zwsl^Zewt, Uu, Uh, Uh, Md, Md^Xm, Md^Xm, Uh, Uh, Uu, Uu, Zwsl^Zewe, Zwsl, Uu, Uh, Uu, Zwsl, Zwsl, Zwsl, Qxua, Qxua, Qxua, Qxua, Qxua, Qxua, Qxua, Qxua, Qxua, Qxua, Qxua, Qxua, Qxua, Qxua
Qxua, Qxua, Qxua, Qxua, Qxua, Qxua, Qxua, Zwsl^Zewc, Zwsl, Uu, Uu, Uh, Uh, Md, Md, Md, Md^Xm, Zwsl, Uh, Uh, Uu, Uu, Zvw, Zwsl, Zgwl, Zwsl, Zwsl, Zwsl^Zews, Zwsl, Zwsl, Uu, Uh, Md, Md, Md^Xm, Md, Uh, Uh, Uu^Zewt, Uu, Zwsl, Uh, Uh, Uu, Uu, Zwsl, Zvw, Zwsl, Zvw, Qxua, Qxua, Qxua, Qxua, Qxua, Qxua, Qxua, Qxua, Qxua, Qxua, Qxua, Qxua
Qxua, Qxua, Qxua, Qxua, Qxua, Qxua, Qxua, Zwsl, Zwsl, Zvw^Vzps, Uu, Uu, Uh, Uh, Md, Md, Md, Md^Xm, Md, Uh, Uh, Uu^Zewc, Uu, Zvw, Zwsl, Zwsl, Zwsl^Zewc, Zwsl, Zwsl, Zwsl, Uu, Uh, Uh, Md, Md^Xm, Md, Md, Uh, Uu, Uu, Zvw, Uh, Uh, Uh, Uu, Uu, Zwsl, Zvw^Vzps, Zwsl, Zwsl, Zwsl, Qxua, Zwsl, Qxua, Qxua, Qxua, Qxua, Qxua, Qxua, Qxua, Qxua
Qxua, Qxua, Qxua, Qxua, Qxua, Qxua, Zwsl, Zwsl, Zwsl, Zwsl, Uu^Zewt, Uu, Uh, Uh, Md, Md, Md, Md, Md, Md, Md, Uh, Uh, Uu, Uu^Vzps, Zwsl, Zwsl, Zwsl, Zgwl, Zwsl, Uu, Uh, Md, Md, Md, Md, Uh, Uh, Uu, Zvw, Zwsl, Zgwl, Uh, Md, Md, Uu, Uu, Zwsl, Zwsl, Zwsl^Zewt, Zwsl, Zwsl, Zwsl, Zwsl, Qxua, Qxua, Qxua, Qxua, Qxua, Qxua, Zwsl
Qxua, Qxua, Qxua, Qxua, Qxua, Zwsl, Zwsl, Zgwl, Zwsl, Zwsl, Zvw, Uu, Uu, Uh, Uh, Uh, Uh, Md, Md, Md, Md^Xm, Md, Uh, Uh, Uu, Uu, Zwsl, Zwsl, Zwsl, Zwsl, Uu, Uh, Md, Md, Md, Uh, Uh, Uu, Uu, Zwsl, Zwsl, Uu, Uu^Zewt, Md, Uh, Uh, Uu, Zvw, Zvw, Zwsl, Zwsl, Zwsl^Zews, Zwsl^Zewt, Zwsl, Qxua, Qxua, Zwsl, Zgwl, Zwsl, Qxua^Bw/r, Zwsl
Qxua, Qxua, Qxua, Qxua, Zwsl, Zwsl, Zwsl, Zwsl, Zwsl^Ziff, Zwsl, Zvw, Zvw, Zwsl, Uu^Zewt, Uu, Uh, Uh, Uh, Uh, Md, Md, Md, Md^Xm, Md, Uh, Uu, Zwsl, Zwsl, Zwsl, Zvw, Uh, Uh, Md, Md, Uh, Uh, Uu, Uu^Zewt, Zvw, Zvw, Zvw, Uu, Uu, Uh, Uh, Uu, Zwsl, Zwsl, Zvw, Zvw, Zwsl, Zwsl, Zwsl, Zwsl^Zewt, Zwsl, Qxua, Qxua^Bw/r, Zwsl, Qxua, Qxua, Qxua^Bw/r
Qxua, Qxua, Qxua, Qxua, Qxua, Zwsl, Zgwl, Zwsl^Ziff, Zwsl^Ziff, Zwsl^Zews, Zvw, Zvw, Zwsl, Zwsl, Zvw, Uu, Uu^Zewc, Uh, Uh, Md, Md, Md, Md, Md^Xm, Md, Uh, Uu, Zgwl, Zwsl, Zvw, Md, Md, Uh, Uh, Uh, Uh, Uu^Zews, Uu, Zwsl, Zvw, Uu, Uu, Md, Md, Uu, Uu^Zewt, Zwsl, Zwsl, Zwsl, Zvw, Zwsl, Zwsl, Zwsl^Zewt, Zwsl, Zwsl, Zwsl, Zwsl, Qxua, Qxua, Zwsl, Zwsl
Qxua, Qxua, Qxua, Qxua, Qxua, Zwsl, Zwsl, Zwsl, Zwsl^Ziff, Zwsl^Ziff, Zvw, Zwsl, Zgwl, Zwsl, Zwsl, Zvw, Zvw, Uu, Uu^Zewt, Uh, Uh, Md, Md, Md^Xm, Md, Uh, Uh, Zwsl, Zvw, Uu, Uu, Uh, Uu, Uu^Zewt, Uu, Uu, Zwsl, Zwsl, Zvw^Zewe, Zgwl, Uu, Uu, Md, Md, Uu, Uu, Zwsl, Zwsl, Zwsl^Vzps, Zvw, Zwsl, Zwsl, Uu, Zwsl, Zwsl, Zwsl, Zwsl, Qxua, Qxua^Bw/r, Zwsl, Zwsl
Qxua, Qxua, Qxua, Qxua, Qxua, Zwsl, Zwsl, Zwsl^Ziff, Zwsl^Ziff, Zwsl^Ziff, Zwsl, Zwsl, Zwsl, Zwsl, Zwsl, Zwsl, Zwsl, Uu, Uu, Uu, Uh, Md, Md, Md, Md, Uh, Uh, Zwsl, Zwsl, Zwsl, Zwsl^Zewc, Uu, Zwsl, Zwsl, Zwsl, Zwsl^Vzps, Zvw, Zwsl, Zwsl, Zvw, Uu^Zewt, Uh, Uh, Uh, Uu, Zwsl, Zvw, Zwsl, Zwsl, Zvw, Zwsl, Uu, Uu, Zwsl, Zvw, Zvw, Zwsl, Zwsl, Qxua, Qxua, Qxua
Qxua, Qxua, Qxua, Qxua, Zwsl, Zwsl, Zwsl^Zewt, Zwsl, Zwsl, Zwsl^Ziff, Zwsl, Uu, Uu, Zgwl, Zwsl, Zwsl, Zvw, Zwsl, Zvw, Uu, Uu, Uh, Uh, Md, Md, Md, Md, Uh, Uh, Zwsl, Uu, Zwsl, Zwsl, Zgwl, Zwsl, Zvw, Zwsl, Zwsl, Zwsl, Uu, Uh, Md, Uh, Uu, Zvw, Zwsl, Zvw, Zvw, Zwsl, Zwsl, Uu, Uu, Uu, Zwsl, Zwsl, Zvw, Zvw, Zwsl, Zwsl, Qxua, Qxua
Qxua, Qxua, Qxua, Zwsl, Zwsl, Zwsl, Zwsl, Zwsl, Zwsl^Vzps, Zwsl^Zewt, Zwsl, Uu, Uu, Uu, Uu, Zvw, Uu, Zvw, Zwsl, Uu, Uu, Uh, Uh, Uh, Uu, Md, Md, Md, Uh, Uh, Uh, Uh, Uh, Zwsl, Zwsl, Zvw, Zwsl, Zwsl, Uu, Uu^Zewt, Uh, Uh, Uu, Uu, Zwsl, Zvw, Zvw, Zvw, Zvw, Zwsl, Uu, Uh, Uu, Zwsl, Zwsl, 1 Zvw, Zvw, Zwsl, Zwsl, Qxua, Qxua
Qxua, Qxua, Qxua, Qxua, Zwsl, Zwsl, Zvw, Zvw, Zwsl, Zwsl, Zwsl, Zwsl, Uu, Uu, Uu^Zews, Uu, Uh, Uu, Zvw, Zvw, Zwsl, Uu, Zwsl, Uu^Zewt, Uu^Vzps, Uh, Uh, Md, Md, Md, Md, Md, Uh, Uu, Zwsl, Zwsl, Zgwl, Zwsl, Uu, Uu, Uu, Uu, Zwsl, Zwsl, Zwsl, Zwsl, Zwsl, Zvw, Uu, Uu, Uh, Uh, Uu, Uu, Zwsl, Zvw, Zwsl, Zwsl^Zewe, Zwsl, Qxua^Bw\r, Zwsl
Qxua, Qxua, Qxua, Qxua, Zwsl, Zwsl, Zvw, Zwsl, Zwsl, Zvw, Zvw, Zvw, Zwsl, Uu, Uu, Uh, Uh, Uu, Uu, Zwsl, Zwsl, Zwsl^Zewc, Zwsl, Zwsl, Zwsl, Uu, Uu, Uh, Uu, Uh, Uh, Uh, Uu, Uu^Zewt, Zwsl, Zwsl, Zwsl, Zwsl, Uu, Uu^Zewt, Zwsl, Zwsl, Zwsl^Ziff, Zwsl, Zwsl^Ziff, Zwsl^Ziff, Zwsl^Ziff, Zwsl, Uu, Uu^Zewc, Uh, Md, Uu, Zwsl, Zwsl, Zvw, Zwsl, Zwsl, Qxua, Qxua, Zwsl
Qxua, Qxua, Qxua, Qxua, Zwsl, Zwsl, Zvw, Zvw, Zvw, Zvw, Zwsl, Zwsl, Zwsl, Zwsl, Uu, Uh, Uh, Uh, Md, Uu, Uu, Zwsl, Zwsl, Zwsl, Zgwl, Zwsl, Zwsl, Uu, Uu, Uu, Uu, Uu, Zgwl, Zwsl, Zwsl, Zwsl, Zwsl, Zwsl, Zwsl, Zwsl, Zwsl, Zwsl, Zwsl^Ziff, Zwsl^Ziff, Zwsl^Ziff, Zwsl^Ziff, Uu, Uu, Uh, Uh, Uh, Uu, Zwsl^Zewt, Zwsl, Zgwl, Zwsl, Zwsl, Qxua, Qxua, Qxua, Qxua
Qxua, Qxua, Qxua, Qxua, Zwsl, Zwsl, Zwsl, Zwsl, Zwsl^Zewc, Zvw, Zvw, Zwsl^Zewt, Zwsl, Zwsl, Zwsl, Uu, Uu, Uh, Md, Md, Uh, Uu, Uu, Zwsl, Zvw, Zwsl, Zvw, Zwsl, Zwsl, Zwsl, Zwsl, Zwsl, Zwsl, Zwsl, Zwsl, Zwsl, Zwsl^Vzps, Zwsl, Zwsl^Ziff, Zwsl^Ziff, Zwsl^Ziff, Zwsl^Ziff, Zwsl^Ziff, Zwsl^Ziff, Uu, Uu, Uu, Uh, Uh, Uh, Uu, Uu, Zwsl, Zwsl, Zwsl, Zwsl, Qxua, Qxua^Bw\r, Zwsl, Zwsl, Qxua^Bw/r
Qxua, Qxua, Qxua, Qxua, Qxua, Zwsl, Zwsl, Zwsl, Zwsl, Zwsl, Zvw, Zwsl, Zwsl^Zewc, Zwsl, Zwsl, Zwsl, Zwsl, Uu, Uu, Md, Md, Uh, Uh, Uu, Uu, Zvw, Uu, Zvw, Zvw, Zwsl, Zwsl, Zwsl, Zwsl^Ziff, Zwsl^Ziff, Zwsl^Ziff, Zwsl, Zwsl, Zwsl, Zwsl, Zwsl^Ziff, Zwsl, Zwsl, Uu, Uu, Uu, Uu, Uh, Uh, Uu, Uu, Zvw, Zvw, Zvw, Zwsl, Qxua, Qxua, Qxua, Qxua, Zwsl, Zwsl, Qxua
Qxua, Qxua, Qxua, Qxua, Qxua, Zwsl, Zwsl, Zgwl, Zwsl, Zwsl, Uu, Uu, Zwsl, Zwsl, Zwsl, Zgwl, Zwsl, Uu, Uu, Uh, Uh, Md, Md, Uu, Uh, Uu, Uu, Uu, Uu, Zwsl, Zwsl^Zewe, Zwsl, Zwsl, Zwsl^Ziff, Zwsl, Zwsl^Ziff, Zwsl, Zwsl, Zwsl, Zwsl, Zwsl, Uu, Uu, Uu, Uh, Uh, Uu, Uu^Zewt, Zwsl, Zvw^Zews, Zwsl, Zwsl, Zwsl, Zwsl, Qxua, Qxua, Qxua, Qxua, Qxua, Zwsl, Qxua^Bw\r
Qxua, Qxua, Qxua, Qxua, Qxua, Qxua, Zwsl, Zwsl, Zwsl, Zwsl, Zwsl, Uu, Uu, Uu, Uu, Zwsl, Zvw, Zvw, Zwsl, Uu, Uu, Uh, Uh, Md, Uh, Uh, Md, Uu, Uu, Uu, Uu, Zwsl, Zwsl, Zwsl, Zwsl, Zwsl, Zwsl, Zwsl, Zwsl, Zwsl^Zewt, Uu, Uu, Uh, Uh, Md, Uh, Uu, Uu, Zwsl, Zwsl^Zewe, Zwsl, Zwsl, Zwsl, Zwsl, Qxua, Qxua, Qxua, Qxua, Qxua, Qxua, Qxua
Qxua, Qxua, Qxua, Qxua, Qxua, Qxua, Zwsl, Zwsl, Zwsl, Zwsl, Zwsl, Zwsl, Uu, Uh, Uh, Uu^Vzps, Uu, Zwsl, Zwsl^Zewt, Zwsl, Uu, Uu, Uu^Zewc, Uh, Uh, Uh, Uh, Uh, Uh, Uu, Uu, Uu, Uu, Zwsl^Zewe, Zwsl, Zwsl, Zwsl, Zvw, Zvw, Uu, Uu, Uh, Uu, Uh, Uu, Uu, Zwsl, Zwsl, Zwsl, Zwsl, Zwsl, Zgwl, Zwsl, Zwsl, Qxua, Qxua, Qxua, Qxua, Qxua, Qxua, Qxua
Qxua, Qxua, Qxua, Qxua, Qxua, Qxua, Qxua, Zvw, Zvw, Zgwl, Zwsl, Zwsl^Zewt, Zvw, Uu, Uu, Uh, Uh, Uu, Uu, Zwsl, Zwsl, Uu, Uu, Uu, Uu, Uu, Uu, Uh, Uh, Uh, Uu, Uu, Zwsl, Zwsl, Zwsl, Zwsl, Zwsl, Zwsl^Zewt, Zwsl, Uu, Zwsl, Uu, Zwsl, Uu, Zwsl^Ziff, Zwsl, Zwsl^Ziff, Zwsl^Ziff, Zwsl^Ziff, Zwsl^Vzps, Zwsl, Zwsl, Zwsl, Zwsl^Zewt, Qxua, Qxua, Qxua, Qxua, Qxua, Qxua, Qxua
Qxua, Qxua, Qxua, Qxua, Qxua, Qxua, Qxua, Zvw, Zwsl, Zvw, Zvw, Zwsl, Zvw, Uu, Uu, Uu^Zewt, Uu, Md, Uu, Uu, Zwsl, Zwsl, Zwsl, Zwsl, Zwsl, Uu, Zwsl, Uu, Uu, Uu, Uu, Uu, Uu, Zwsl, Zwsl, Zgwl, Zwsl, Zwsl, Zwsl, Zvw, Zwsl, Zwsl, Zwsl^Ziff, Zwsl^Ziff, Zwsl^Ziff, Zwsl^Ziff, Zwsl^Ziff, Zwsl^Ziff, Zwsl, Zwsl, Zwsl, Zwsl, Zwsl, Qxua, Qxua, Qxua, Qxua, Qxua, Qxua, Qxua, Qxua
Qxua, Qxua, Qxua, Qxua, Qxua, Qxua, Qxua, Qxua, Zwsl, Zvw, Zvw, Zwsl, Zwsl^Ziff, Zwsl, Zwsl, Uu, Uu, Md, Uh, Uu, Uu, Zwsl^Zews, Zwsl, Zwsl, Zwsl, Zwsl, Zwsl, Zwsl, Zwsl, Uu, Zwsl, Uu^Vzps, Uu, Uu, Uu, Zwsl, Zvw, Zwsl, Zvw, Zvw^Zewc, Zvw, Zwsl^Ziff, Zwsl^Ziff, Zwsl^Ziff, Zwsl, Zwsl^Ziff, Zwsl, Zwsl, Zwsl, Zwsl, Zwsl, Zwsl, Qxua, Qxua, Qxua, Qxua, Qxua, Qxua, Qxua, Qxua, Qxua
Qxua, Qxua, Qxua, Qxua, Qxua, Qxua, Qxua, Qxua, Qxua, Zwsl, Zwsl, Zwsl, Zvw, Zwsl^Ziff, Zwsl^Ziff, Zvw, Zwsl, Uu, Uu, Uh, Uu, Uu, Uh, Zwsl^Zewt, Zwsl, Zwsl, Zwsl^Ziff, Zwsl, Zwsl, Zwsl, Zwsl^Zewe, Zwsl, Zwsl, Zwsl, Zvw, Zwsl, Zvw, Zvw, Zwsl, Zwsl, Zwsl, Zwsl, Zwsl, Zwsl^Ziff, Zwsl, Zwsl, Zwsl, Zwsl^Zewt, Zwsl, Zwsl, Qxua, Qxua, Qxua, Qxua, Qxua, Qxua, Qxua, Qxua, Qxua, Qxua, Qxua
Qxua, Qxua, Qxua, Qxua, Qxua, Qxua, Qxua, Qxua, Qxua, Qxua, Zwsl, Zwsl^Zewt, Zwsl, Zwsl^Ziff, Zwsl^Ziff, Zvw, Zwsl, Zwsl^Zewc, Zvw, Uu, Uu, Uu, Uu^Zewt, Uu, Zwsl, Zwsl, Zwsl^Zewt, Zwsl^Ziff, Zwsl^Ziff, Zwsl, Zvw, Zwsl, Zwsl^Zewt, Zvw, Zwsl, Zvw, Zwsl, Zwsl, Zwsl, Zgwl, Zwsl, Zwsl, Zwsl, Zwsl, Qxua, Zwsl, Qxua, Qxua, Qxua, Qxua, Qxua, Qxua, Qxua, Qxua, Qxua, Qxua, Qxua, Qxua, Qxua, Qxua, Qxua
Qxua, Qxua, Qxua, Qxua, Qxua, Qxua, Qxua, Qxua, Qxua, Qxua, Qxua, Zwsl, Zwsl, Zwsl, Zwsl, Zwsl^Ziff, Zvw, Zwsl, Zwsl, Zvw, Zwsl, Zwsl, Zwsl, Uu, Uu, Zwsl, Zwsl, Zwsl, Zwsl^Ziff, Zwsl^Ziff, Zwsl^Ziff, Zwsl, Zwsl, Zwsl, Zwsl, Zwsl, Zwsl, Zwsl^Zews, Zwsl, Zwsl, Qxua, Qxua, Qxua, Qxua, Qxua, Qxua, Qxua, Qxua, Qxua, Qxua, Qxua, Qxua, Qxua, Qxua, Qxua, Qxua, Qxua, Qxua, Qxua, Qxua, Qxua
Qxua, Qxua, Qxua, Qxua, Qxua, Qxua, Qxua, Qxua, Qxua, Qxua, Qxua, Zwsl, Zwsl, Zwsl^Zewt, Zwsl, Zwsl, Zwsl, Zvw, Zvw, Zwsl^Vzps, Zvw, Zgwl, Zwsl, Zwsl, Zwsl, Uu, Zwsl, Zvw, Zvw, Zwsl^Ziff, Zwsl, Zwsl^Ziff, Zwsl, Zwsl, Zwsl^Zewt, Zwsl, Zwsl, Zwsl, Qxua, Qxua, Qxua, Qxua, Qxua, Qxua, Qxua, Qxua, Qxua, Qxua, Qxua, Qxua, Qxua, Qxua, Qxua, Qxua, Qxua, Qxua, Qxua, Qxua, Qxua, Qxua, Qxua
Qxua, Qxua, Qxua, Qxua, Qxua, Qxua, Qxua, Qxua, Qxua, Qxua, Qxua, Qxua, Qxua, Zwsl, Zwsl, Zwsl, Zwsl, Zwsl^Zewt, Zwsl, Zvw, Zwsl, Zvw, Zwsl, Zwsl^Zewe, Zwsl, Zwsl, Zgwl, Zwsl, Zwsl, Zwsl, Zvw, Zwsl, Zwsl^Zewt, Zwsl, Zwsl, Zwsl, Qxua, Qxua, Qxua, Qxua, Qxua, Qxua, Qxua, Qxua, Qxua, Qxua, Qxua, Qxua, Qxua, Qxua, Qxua, Qxua, Qxua, Qxua, Qxua, Qxua, Qxua, Qxua, Qxua, Qxua, Qxua
Qxua, Qxua, Qxua, Qxua, Qxua, Qxua, Qxua, Qxua, Qxua, Qxua, Qxua, Qxua, Qxua, Qxua, Qxua, Zwsl, Qxua, Zwsl, Zwsl, Zwsl, Zwsl, Zwsl, Zwsl, Zwsl, Qxua, Qxua, Zwsl, Zwsl, Zwsl, Zwsl, Zwsl, Zwsl, Zwsl, Zwsl, Zwsl, Zwsl, Qxua, Qxua, Qxua, Qxua, Qxua, Qxua, Qxua, Qxua, Qxua, Qxua, Qxua, Qxua, Qxua, Qxua, Qxua, Qxua, Qxua, Qxua, Qxua, Qxua, Qxua, Qxua, Qxua, Qxua, Qxua
Qxua, Qxua, Qxua, Qxua, Qxua, Qxua, Qxua, Qxua, Qxua, Qxua, Qxua, Qxua, Qxua, Qxua, Qxua, Qxua, Qxua, Qxua, Qxua, Zwsl, Zwsl, Zwsl, Qxua, Qxua, Qxua, Qxua, Qxua, Qxua, Qxua, Zwsl, Zwsl, Zwsl, Zwsl, Zwsl, Qxua, Qxua, Qxua, Qxua, Qxua, Qxua, Qxua, Qxua, Qxua, Qxua, Qxua, Qxua, Qxua, Qxua, Qxua, Qxua, Qxua, Qxua, Qxua, Qxua, Qxua, Qxua, Qxua, Qxua, Qxua, Qxua, Qxua
Qxua, Qxua, Qxua, Qxua, Qxua, Qxua, Qxua, Qxua, Qxua, Qxua, Qxua, Qxua, Qxua, Qxua, Qxua, Qxua, Qxua, Qxua, Qxua, Qxua, Qxua, Qxua, Qxua, Qxua, Qxua, Qxua, Qxua, Qxua, Qxua, Qxua, Qxua, Qxua, Qxua, Qxua, Qxua, Qxua, Qxua, Qxua, Qxua, Qxua, Qxua, Qxua, Qxua, Qxua, Qxua, Qxua, Qxua, Qxua, Qxua, Qxua, Qxua, Qxua, Qxua, Qxua, Qxua, Qxua, Qxua, Qxua, Qxua, Qxua, Qxua
Qxua, Qxua, Qxua, Qxua, Qxua, Qxua, Qxua, Qxua, Qxua, Qxua, Qxua, Qxua, Qxua, Qxua, Qxua, Qxua, Qxua, Qxua, Qxua, Qxua, Qxua, Qxua, Qxua, Qxua, Qxua, Qxua, Qxua, Qxua, Qxua, Qxua, Qxua, Qxua, Qxua, Qxua, Qxua, Qxua, Qxua, Qxua, Qxua, Qxua, Qxua, Qxua, Qxua, Qxua, Qxua, Qxua, Qxua, Qxua, Qxua, Qxua, Qxua, Qxua, Qxua, Qxua, Qxua, Qxua, Qxua, Qxua, Qxua, Qxua, Qxua
