border_size=1
usage=map

Xu          , Xu          , Xu          , Xu          , Xu          , Xu          , Xu          , Xu          , Xu          , Xu          , Xu          , Xu          , Xu          , Xu          , Xu          , Xu          , Xu          , Xu          , Xu          , Xu          , Xu          , Xu          , Xu          , Xu          , Xu          , Xu          , Xu          , Xu          , Xu          , Xu          , Xu          , Xu          , Xu          , Xu          , Xu          , Xu          , Xu          , Xu          , Xu          , Xu          , Xu          , Xu          , Md^Xm       , Md^Xm       , Md          , Md          
Xu          , Xu          , Xu          , Xu          , Xu          , Xu          , Xu          , Xu          , Xu          , Xu          , Xu          , Xu          , Xu          , Xu          , Uh          , Xu          , Xu          , Xu          , Uh^Uf       , Uu^Uf       , Uh^Em       , Xu          , Uh^Em       , Xu          , Uu^Uf       , Xu          , Uu^Uf       , Xu          , Ur^Em       , Xu          , Uu^Uf       , Xu          , Uh^Uf       , Xu          , Xu          , Xu          , Xu          , Xu          , Uh          , Xu          , Xu          , Xu          , Md^Xm       , Md^Xm       , Md          , Md          
Xu          , Xu          , Xu          , Xu          , Xu          , Xu          , Xu          , Xu          , Uu^Uf       , Xu          , Uh          , Uu^Vu       , Ur          , Ur          , Ur          , Ur          , Uh          , Uh^Em       , Xu          , Ur^Emf      , Ur^Es       , Uh^Em       , Uu          , Uh^Em       , Uu^Emf      , Uu^Uf       , Uu^Em       , Ur^Emf      , Xu          , Ur          , Ur^Es       , Ur^Emf      , Uu^Em       , Uu^Vu       , Uh^Emf      , Uu^Uf       , Ur^Em       , Ur          , Uh^Emf      , Uh^Emf      , Uu^Vu       , Uh          , Uu          , Md          , Hd          , Hd          
Xu          , Xu          , Xu          , Xu          , Uu^Uf       , Xu          , Xu          , Uh^Uf       , Ur^Emf      , Uh^Em       , Ur          , Ur^Es       , Ur          , Uu          , Uu^Es       , Ur^Es       , Ur^Em       , Uh^Es       , Ur          , Ur          , Xu          , Ur^Es       , Ur          , Ur^Em       , Ur          , Ur^Em       , Ur          , Ur^Em       , Ur          , Ur^Es       , Uu^Es       , Uh^Es       , Ur^Es       , Ur          , Ur          , Uh^Em       , Ur          , Ur          , Uu^Es       , Ur^Em       , Ur          , Ur^Emf      , Ur          , Hd          , Hd          , Hd          
Xu          , Xu          , Xu          , Xu          , Uu^Uf       , Xu          , Uu^Em       , Uh^Em       , Uu^Es       , Ur          , Ur          , Ur          , Ur          , Xu          , Xu          , Ur          , Uu^Vu       , Ur          , Xu          , Xu          , Xu          , Xu          , Xu          , Uu^Vu       , Xu          , Uh          , Uh          , Ur          , Xu          , Uu^Es       , Ur          , Uh          , Uh          , Uu          , Uu^Em       , Ur^Em       , Uu^Emf      , Ur^Em       , Ur^Em       , Ur^Es       , Ur          , Ur          , Ur          , Rd          , Rd          , Dd          
Xu          , Xu          , Xu          , Xu          , Uh^Emf      , Ur^Emf      , Ur^Em       , Xu          , Ur^Es       , Ur^Es       , Xu          , Xu          , Xu          , Xu          , Xu          , Xu          , Xu          , Xu          , Xu          , Xu          , Xu          , Xu          , Xu          , Xu          , Xu          , Xu          , Xu          , Xu          , Xu          , Uu          , Xu          , Ur          , Xu          , Uh          , Xu          , Uu^Emf      , Uu^Uf       , Uu^Uf       , Uh^Em       , Uh          , Uh          , Uh^Em       , Uu          , Hd          , Hd          , Rd          
Xu          , Xu          , Xu          , Xu          , Uh^Em       , Xu          , Uu^Em       , Ur^Es       , Ur          , Ur          , Uh          , Xu          , Xu          , Xu          , Xu          , Xu          , Xu          , Xu          , Xu          , Xu          , Uh          , Ur          , Ur          , Xu          , Uh          , Xu          , Xu          , Xu          , Xu          , Xu          , Xu          , Xu          , Xu          , Xu          , Xu          , Xu          , Xu          , Xu          , Xu          , Xu          , Xu          , Uh          , Md^Xm       , Hd          , Md          , Hd          
Xu          , Xu          , Xu          , Uu^Vu       , Ur          , Uu^Emf      , Uu^Uf       , Uu^Em       , Ur          , Xu          , Uu          , Uh          , Uh          , Xu          , Uu^Uf       , Uu^Uf       , Uu^Uf       , Xu          , Uh^Es       , Uu^Vu       , Ur^Es       , Xu          , Uu          , Ur          , Uu^Em       , Uu^Uf       , Uu^Emf      , Uh          , Uh          , Xu          , Xu          , Xu          , Xu          , Xu          , Xu          , Xu          , Uu^Uf       , Xu          , Xu          , Xu          , Xu          , Xu          , Xu          , Md^Xm       , Md^Xm       , Md          
Xu          , Xu          , Xu          , Xu          , Xu          , Ur^Emf      , Ur^Emf      , Ur^Em       , Uu^Em       , Uu          , Ur          , Ur          , Ur^Em       , Uu^Emf      , Ur^Em       , Ur^Emf      , Ur^Em       , Xu          , Ur^Em       , Ur^Em       , Uu^Emf      , Ur          , Ur^Es       , Ur          , Ur^Em       , Xu          , Uu^Em       , Ur          , Ur^Es       , Uh          , Uu          , Uu^Vu       , Uu^Em       , Xu          , Uh^Uf       , Ur^Emf      , Uu^Uf       , Xu          , Xu          , Xu          , Xu          , Xu          , Xu          , Md^Xm       , Md^Xm       , Md          
Xu          , Xu          , Xu          , Xu          , Xu          , Xu          , Uu^Uf       , Ur^Emf      , Ur          , Ur^Es       , Ur^Es       , Ur^Es       , Xu          , Ur^Em       , Ur^Es       , Ur^Em       , Uu^Em       , Ur^Em       , Uu^Emf      , Uu^Uf       , Uh^Uf       , Ur^Em       , Ur          , Ur          , Uu^Uf       , Ur^Emf      , Ur^Es       , Ur          , Uh^Emf      , Ur^Em       , Ur^Em       , Ur^Es       , Ur^Es       , Ur^Em       , Ur          , Ur^Es       , Ur          , Uu^Em       , Uh^Es       , Xu          , Uh          , Xu          , Xu          , Xu          , Xu          , Md^Xm       
Xu          , Xu          , Xu          , Xu          , Xu          , Xu          , Uh^Em       , Uh^Emf      , Xu          , Ur^Es       , Ur          , Uh          , Uu^Vu       , Uu          , Ur          , Ur^Em       , Uu^Uf       , Uh          , Uh          , Uh^Emf      , Xu          , Xu          , Xu          , Xu          , Xu          , Uh^Em       , Xu          , Xu          , Xu          , Uu^Uf       , Xu          , Uu^Em       , Ur^Emf      , Ur^Es       , Ur^Em       , Ur          , Xu          , Ur          , Ur^Es       , Uh^Es       , Ur^Es       , Uh^Uf       , Xu          , Xu          , Xu          , Xu          
Xu          , Xu          , Xu          , Xu          , Xu          , Xu          , Xu          , Xu          , Xu          , Xu          , Xu          , Xu          , Xu          , Xu          , Xu          , Ur^Emf      , Ur^Emf      , Xu          , Xu          , Xu          , Xu          , Xu          , Xu          , Xu          , Xu          , Xu          , Xu          , Xu          , Xu          , Xu          , Xu          , Uu^Uf       , Xu          , Ur          , Xu          , Uh          , Ur^Emf      , Uu^Em       , Uh^Emf      , Ur          , Ur^Es       , Ur^Es       , Uu^Vu       , Xu          , Xu          , Xu          
Xol         , Xu          , Xu          , Xu          , Xu          , Xu          , Xu          , Xu          , Xu          , Xu          , Xu          , Xu          , Xu          , Xu          , Xu          , Uu^Vu       , Xu          , Xu          , Xu          , Xu          , Xu          , Xu          , Xu          , Xu          , Xu          , Xu          , Xu          , Xu          , Xu          , Xu          , Xu          , Xu          , Xu          , Xu          , Xu          , Xu          , Xu          , Uu^Uf       , Xu          , Uu^Emf      , Ur^Es       , Uu          , Uh^Emf      , Xu          , Xu          , Xu          
Xol         , Xol         , Xol         , Xol         , Xol         , Xol         , Xol         , Xol         , Xol         , Xu          , Xol         , Xu          , Xol         , Xu          , Xol         , Xu          , Xol         , Xu          , Xol         , Xu          , Xol         , Xu          , Xol         , Xu          , Xu          , Xu          , Xu          , Xu          , Xu          , Xu          , Xu          , Xu          , Xu          , Xu          , Xu          , Xu          , Xu          , Xu          , Xu          , Uu^Uf       , Ur^Es       , Uu^Em       , Uh^Uf       , Xu          , Xu          , Xu          
Xol         , Xol         , Xol         , Xol         , Xol         , Xol         , Xol         , Xol         , Xol         , Xol         , Xol         , Xol         , Xol         , Xol         , Xol         , Xol         , Xol         , Xol         , Xol         , Xol         , Xol         , Xol         , Xol         , Xol         , Xol         , Xu          , Xu          , Xu          , Xu          , Xu          , Xu          , Xu          , Xu          , Xu          , Xu          , Xu          , Xu          , Xu          , Xu          , Xu          , Ur^Es       , Ur^Em       , Uu^Uf       , Xu          , Xu          , Xu          
Xol         , Xol         , Xol         , Xol         , Xol         , Xol         , Xol         , Xol         , Xol         , Xol         , Xol         , Xol         , Xol         , Xol         , Xol         , Xol         , Xol         , Xol         , Xol         , Xol         , Xol         , Xol         , Xol         , Xol         , Xol         , Xu          , Xu          , Xu          , Xu          , Xu          , Xu          , Xu          , Xu          , Xu          , Xu          , Xu          , Xu          , Xu          , Xu          , Xu          , Ur          , Uu^Es       , Ur^Emf      , Uh^Emf      , Xu          , Xu          
Xol         , Xol         , Xol         , Xol         , Xol         , Xol         , Xol         , Xol         , Xol         , Xol         , Xol         , Xol         , Urb         , Xol         , Urb         , Xol         , Urb         , Xol         , Xol         , Xol         , Xol         , Xol         , Urb         , Xol         , Urb         , Xol         , Uu^Uf       , Xu          , Xu          , Xu          , Xu          , Xu          , Xu          , Xu          , Xu          , Xu          , Xu          , Xu          , Uu^Uf       , Uh^Emf      , Ur^Es       , Ur          , Uu^Vud      , Xu          , Xu          , Xu          
Xol         , Xol         , Xol         , Xol         , Xol         , Xol         , Xol         , Xol         , Urb         , Urb         , Urb         , Urb         , Urb         , Urb         , Urb         , Urb         , Urb         , Cud         , Cud         , Kud         , Cud         , Cud         , Urb         , Urb         , Urb         , Xol         , Uu^Es       , Uu^Es       , Uu^Uf       , Xu          , Xu          , Xu          , Uu^Uf       , Xu          , Xu          , Xu          , Xu          , Xu          , Ur          , Ur          , Uu^Es       , Uu^Es       , Xu          , Xu          , Xu          , Xu          
Xol         , Xol         , Xol         , Xol         , Xol         , Xol         , Urb         , Urb         , Urb         , Urb         , Urb         , Urb         , Urb         , Urb         , Urb         , Urb         , Urb         , Urb         , Urb         , Cud         , Urb         , Urb         , Urb         , Urb         , Urb         , Xol         , Ur          , Ur          , Ur          , Uh^Emf      , Ur^Es       , Xu          , Uh^Emf      , Uu^Uf       , Uh^Emf      , Xu          , Uh^Es       , Uh^Emf      , Ur^Es       , Ur^Em       , Uh^Es       , Uu^Uf       , Xu          , Xu          , Xu          , Xu          
Xol         , Xol         , Xol         , Xol         , Xol         , Urb         , Urb         , Urb         , Urb         , Urb         , Urb         , Urb         , Urb         , Urb         , Urb         , Urb         , Urb         , Urb         , Urb         , Urb         , Urb         , Urb         , Urb         , Urb         , Urb         , Xol         , Uu^Es       , Uh^Es       , Uh^Es       , Ur          , Uu^Vud      , Ur          , Ur^Em       , Uh^Emf      , Ur          , Uh^Es       , Ur          , Ur          , Uu^Uf       , Uh^Es       , Xu          , Xu          , Xu          , Xu          , Xu          , Xu          
Xol         , Xol         , Xol         , Xol         , Xol         , Urb         , Urb         , Urb         , Urb         , Urb         , Urb         , Urb         , Urb         , Urb         , Urb         , Urb         , Urb         , Urb         , Urb         , Urb         , Urb         , Urb         , Urb         , Xol         , Xol         , Xol         , Xu          , Xu          , Xu          , Uu^Uf       , Xu          , Uu^Uf       , Uh^Es       , Ur          , Uu^Es       , Ur          , Uh^Es       , Uu^Vud      , Uh^Emf      , Xu          , Xu          , Xu          , Xu          , Xu          , Xu          , Xu          
Xol         , Xol         , Xol         , Xol         , Xol         , Urb         , Urb         , Urb         , Urb         , Urb         , Urb         , Urb         , Urb         , Urb         , Urb         , Urb         , Urb         , Urb         , Urb         , Urb         , Urb         , Urb         , Urb         , Urb         , Urb         , Xol         , Xu          , Xu          , Xu          , Xu          , Xu          , Xu          , Xu          , Xu          , Xu          , Xu          , Xu          , Xu          , Xu          , Xu          , Xu          , Xu          , Xu          , Xu          , Xu          , Xu          
Xol         , Xol         , Xol         , Xol         , Xol         , Urb         , Urb         , Urb         , Urb         , Urb         , Urb         , Urb         , Urb         , Urb         , Urb         , Urb         , Urb         , Urb         , Urb         , Urb         , Urb         , Urb         , Urb         , Urb         , Urb         , Xol         , Xol         , Xol         , Xol         , Xol         , Xol         , Xol         , Xol         , Xol         , Xol         , Xol         , Xol         , Xol         , Xol         , Xol         , Xol         , Xol         , Xol         , Xol         , Xol         , Xu          
Xol         , Xol         , Xol         , Xol         , Xol         , Urb         , Urb         , Urb         , Urb         , Urb         , Urb         , Urb         , Urb         , Urb         , Urb         , Urb         , Urb         , Urb         , Urb         , Urb         , Urb         , Urb         , Urb         , Urb         , Urb         , Xol         , Xol         , Xol         , Xol         , Xol         , Xol         , Xol         , Xol         , Xol         , Xol         , Xol         , Xol         , Xol         , Xol         , Xol         , Xol         , Xol         , Xol         , Xol         , Xol         , Xol         
Xol         , Xol         , Xol         , Xol         , Urb         , Urb         , Urb         , Urb         , Urb         , Urb         , Urb         , Urb         , Urb         , Urb         , Urb         , Urb         , Urb         , Urb         , Urb         , Urb         , Urb         , Urb         , Urb         , Urb         , Urb         , Urb         , Urb         , Xol         , Urb         , Xol         , Urb         , Xol         , Xol         , Xol         , Urb         , Xol         , Urb         , Xol         , Xol         , Xol         , Xol         , Xol         , Xol         , Xol         , Xol         , Xol         
Xol         , Xol         , Xol         , Urb         , Urb         , Urb         , Urb         , Urb         , Urb         , Urb         , Urb         , Urb         , Urb         , Urb         , Urb         , Urb         , Urb         , Urb         , Urb         , Urb         , Urb         , Urb         , Urb         , Urb         , Urb         , Urb         , Urb         , Urb         , Urb         , Urb         , Urb         , Urb         , Urb         , Urb         , Urb         , Urb         , Urb         , Xol         , Urb         , Urb         , Xol         , Xol         , Xol         , Xol         , Xol         , Xol         
Xol         , Xol         , Xol         , Urb         , Urb         , Urb         , Urb         , Urb         , Urb         , Urb         , Urb         , Urb         , Urb         , Urb         , Urb         , Urb         , Urb         , Urb         , Urb         , Urb         , Urb         , Urb         , Urb         , Urb         , Urb         , Urb         , Urb         , Urb         , Urb         , Urb         , Urb         , Urb         , Urb         , Urb         , Urb         , Urb         , Urb         , Urb         , Urb         , Urb         , Urb         , Xol         , Xol         , Xol         , Xol         , Xol         
Xol         , Xol         , Xol         , Xol         , Urb         , Urb         , Urb         , Urb         , Urb         , Urb         , Urb         , Urb         , Urb         , Urb         , Urb         , Urb         , Urb         , Urb         , Urb         , Urb         , Urb         , Urb         , Urb         , Urb         , Urb         , Urb         , Urb         , Urb         , Urb         , Urb         , Urb         , Urb         , Urb         , Urb         , Urb         , Urb         , Urb         , Urb         , Urb         , Urb         , Urb         , Urb         , Xol         , Xol         , Xol         , Xol         
Xol         , Xol         , Xol         , Urb         , Urb         , Urb         , Urb         , 1 Urb       , Urb         , Urb         , Urb         , Urb         , Urb         , Urb         , Urb         , Urb         , Urb         , Urb         , Urb         , Urb         , Urb         , Urb         , Urb         , Urb         , Urb         , Urb         , 2 Urb       , Urb         , Urb         , Urb         , Urb         , Urb         , Urb         , Urb         , Urb         , Urb         , Urb         , Urb         , Urb         , Urb         , Urb         , Urb         , Xol         , Xol         , Xol         , Xol         
Xol         , Xol         , Urb         , Urb         , Urb         , Urb         , Urb         , Urb         , Urb         , Urb         , Urb         , Urb         , Urb         , Urb         , Urb         , Urb         , Urb         , Urb         , Urb         , Urb         , Urb         , Urb         , Urb         , Urb         , Urb         , Urb         , Urb         , Urb         , Urb         , Urb         , Urb         , Urb         , Urb         , Urb         , Qxu         , Urb         , Urb         , Urb         , Urb         , Urb         , Urb         , Xol         , Xol         , Xol         , Xol         , Xol         
Xol         , Urb         , Xol         , Xol         , Xol         , Urb         , Urb         , Urb         , Urb         , Urb         , Urb         , Urb         , Urb         , Urb         , Urb         , Urb         , Urb         , Urb         , Urb         , Urb         , Urb         , Urb         , Urb         , Urb         , Urb         , Urb         , Urb         , Urb         , Urb         , Urb         , Urb         , Urb         , Urb         , Qxu         , Qxu         , Qxu         , Urb         , Urb         , Urb         , Urb         , Xol         , Xol         , Xol         , Xol         , Xol         , Xol         
Xol         , Xol         , Xol         , Xol         , Xol         , Xol         , Xol         , Urb         , Urb         , Urb         , Urb         , Urb         , Urb         , Urb         , Urb         , Urb         , Urb         , Urb         , Urb         , Urb         , Urb         , Urb         , Urb         , Urb         , Urb         , Urb         , Urb         , Urb         , Urb         , Urb         , Urb         , Urb         , Urb         , Qxu         , Qxu         , Qxu         , Urb         , Urb         , Xol         , Xol         , Xol         , Xol         , Xol         , Xol         , Xol         , Xol         
Xol         , Xol         , Xol         , Xol         , Xol         , Xol         , Xol         , Xol         , Xol         , Urb         , Urb         , Urb         , Urb         , Urb         , Urb         , Urb         , Urb         , Urb         , Xol         , Urb         , Urb         , Urb         , Urb         , Urb         , Urb         , Urb         , Urb         , Urb         , Urb         , Urb         , Urb         , Urb         , Urb         , Urb         , Urb         , Urb         , Urb         , Urb         , Xol         , Xol         , Xol         , Xol         , Xol         , Xol         , Xol         , Xol         
Xol         , Xol         , Xol         , Xol         , Xol         , Xol         , Xol         , Xol         , Xol         , Urb         , Urb         , Urb         , Urb         , Urb         , Xol         , Urb         , Xol         , Xol         , Xol         , Xol         , Xol         , Urb         , Xol         , Urb         , Urb         , Urb         , Urb         , Urb         , Xol         , Urb         , Xol         , Xol         , Xol         , Urb         , Xol         , Urb         , Xol         , Xol         , Xol         , Xol         , Xol         , Xol         , Xol         , Xol         , Xol         , Xol         
Xol         , Xol         , Xol         , Xol         , Xol         , Xol         , Xol         , Xol         , Xol         , Xol         , Xol         , Xol         , Xol         , Xol         , Xol         , Xol         , Xol         , Xol         , Xol         , Xol         , Xol         , Xol         , Xol         , Xol         , Xol         , Xol         , Xol         , Xol         , Xol         , Xol         , Xol         , Xol         , Xol         , Xol         , Xol         , Xol         , Xol         , Xol         , Xol         , Xol         , Xol         , Xol         , Xol         , Xol         , Xol         , Xol         
