border_size=1
usage=map

Urb         , Urb         , Urb         , Urb         , Urb         , Urb         , Xos         , Xos         , Xos         , Xos         , Xos         , Xos         , Aa          , Aa          , Aa          , Aa          , Zaw         , Aa          , Aa          , Aa          , Zaw         , Zaw         , Zaw         , Aa          , Aa          , Aa          , Zaw         , Zaw         , Zaw         , Zaw         , Aa          , Aa          , Aa          , Aa          , Ha          , Aa          , Zaw         , Zaw         , Zaw         , Zaw         , Zaw         , Zaw         , Zaw         , Aa          , Zaw         , Aa          
Urb         , Urb         , Urb         , Urb         , Urb         , Urb         , Xos         , Xos         , Xos         , Xos         , Aa          , Aa          , Aa          , Aa          , Aa          , Aa          , Zaw         , Zaw         , Zaw         , Aa          , Zaw         , Zaw         , Zaw         , Aa          , Aa          , Zaw         , Zaw         , Zaw         , Zaw         , Zaw         , Aa          , Aa          , Ha          , Ha          , Ms          , Ha          , Ha          , Aa          , Aa          , Zaw         , Aa          , Aa          , Zaw         , Zaw         , Aa          , Zaw         
Xos         , Urb         , Urb         , Urb         , Urb         , Urb         , Urb         , Xos         , Aa          , Aa          , Aa          , Aa          , Aa          , Aa          , Zaw         , Zaw         , Zaw         , Aa          , Zaw         , Zaw         , Zaw         , Zaw         , Aa          , Aa          , Zaw         , Zaw         , Zaw         , Zaw         , Zaw         , Aa          , Aa          , Ha          , Ha          , Ms          , Ms          , Ha          , Ha          , Ha          , Aa          , Aa          , Zaw         , Zaw         , Aa          , Aa          , Ha          , Aa          
Xos         , Xos         , Xos         , Xos         , Xos         , Urb         , Zaw         , Aa          , Aa          , Aa          , Aa          , Aa          , Aa          , Zaw         , Aa^Vla      , Zaw         , Zaw         , Zaw         , Zaw         , Zaw         , Aa          , Aa          , Zaw         , Zaw         , Zaw         , Zaw         , Zaw         , Zaw         , Zaw         , Aa          , Aa          , Ha          , Ha          , Ha          , Ha          , Ha          , Aa          , Aa          , Zaw         , Aa^Vla      , Zaw         , Zaw         , Aa          , Ha          , Ms          , Ha          
Xos         , Xos         , Xos         , Xos         , Aa          , Aa          , Aa          , Zaw         , Zaw         , Aa          , Aa          , Aa          , Aa          , Aa          , Zaw         , Zaw         , Zaw         , Zaw         , Zaw         , Zaw         , Aa          , Zaw         , Zaw         , Zaw         , Aa          , Zaw         , Zaw         , Zaw         , Zaw         , Aa          , Aa          , Aa          , Aa          , Aa          , Aa          , Ha          , Aa          , Aa          , Aa          , Aa          , Zaw         , Zaw         , Aa          , Ha          , Ha          , Ha          
Xos         , Xos         , Aa          , Aa          , Aa          , Aa          , Aa          , Aa          , Aa          , Zaw         , Cha         , Cha         , Cha         , Zaw         , Zaw         , Zaw         , Zaw         , Zaw         , Aa          , Aa          , Ha          , Aa          , Aa          , Aa^Vla      , Zaw         , Aa          , Zaw         , Aa          , Zaw         , Zaw         , Aa          , Zaw         , Zaw         , Aa          , Aa          , Aa          , Aa          , Aa          , Cha         , Aa          , Aa          , Zaw         , Aa          , Aa          , Aa          , Aa          
Aa          , Aa          , Aa          , Aa          , Aa          , Aa          , Aa          , Aa          , Aa          , Aa          , Cha         , 1 Kha       , Cha         , Zaw         , Zaw         , Zaw         , Zaw         , Zaw         , Aa          , Ha          , Ms          , Ha          , Aa          , Aa          , Aa          , Zaw         , Zaw         , Zaw         , Zaw         , Zaw         , Zaw         , Zaw         , Zaw         , Aa          , Aa          , Zaw         , Zaw         , Cha         , 5 Kha       , Cha         , Zaw         , Zaw         , Zaw         , Zaw         , Zaw         , Zaw         
Aa          , Aa          , Aa          , Aa          , Aa          , Aa          , Aa          , Aa          , Aa          , Aa          , Aa          , Cha         , Zaw         , Zaw         , Zaw         , Zaw         , Zaw         , Zaw         , Aa          , Ha          , Ha          , Ha          , Aa          , Aa          , Zaw         , Zaw         , Zaw         , Aa          , Zaw         , Aa          , Zaw         , Aa          , Aa          , Aa          , Aa          , Zaw         , Zaw         , Cha         , Cha         , Cha         , Zaw         , Zaw         , Zaw         , Zaw         , Zaw         , Zaw         
Aa          , Aa          , Aa          , Aa          , Aa          , Aa          , Aa          , Aa          , Aa          , Aa          , Zaw         , Aa          , Zaw         , Zaw         , Zaw         , Zaw         , Zaw         , Zaw         , Zaw         , Aa          , Zaw         , Aa          , Zaw         , Zaw         , Zaw         , Zaw         , Zaw         , Zaw         , Zaw         , Zaw         , Zaw         , Zaw         , Aa^Vla      , Zaw         , Zaw         , Zaw         , Aa          , Zaw         , Aa          , Aa          , Aa          , Zaw         , Zaw         , Zaw         , Zaw         , Zaw         
Aa          , Aa          , Aa          , Aa          , Aa          , Aa          , Zaw         , Zaw         , Aa^Vla      , Zaw         , Aa          , Zaw         , Zaw         , Zaw         , Zaw         , Zaw         , Zaw         , Zaw         , Zaw         , Zaw         , Zaw         , Zaw         , Zaw         , Zaw         , Aa          , Zaw         , Aa          , Zaw         , Zaw         , Zaw         , Zaw         , Zaw         , Zaw         , Aa          , Aa          , Aa          , Ha          , Aa          , Ha          , Aa          , Ha          , Aa          , Aa          , Aa^Vla      , Zaw         , Zaw         
Aa          , Aa          , Aa          , Aa          , Aa          , Zaw         , Zaw         , Zaw         , Zaw         , Zaw         , Aa          , Aa          , Zaw         , Zaw         , Zaw         , Zaw         , Zaw         , Zaw         , Aa          , Zaw         , Zaw         , Zaw         , Zaw         , Zaw         , Aa          , Aa          , Aa          , Zaw         , Zaw         , Zaw         , Zaw         , Zaw         , Zaw         , Zaw         , Aa          , Aa          , Ha          , Ms          , Ms          , Ha          , Ha          , Aa          , Zaw         , Zaw         , Zaw         , Zaw         
Zaw         , Aa          , Aa          , Aa          , Zaw         , Zaw         , Aa          , Aa          , Zaw         , Zaw         , Zaw         , Zaw         , Zaw         , Zaw         , Zaw         , Zaw         , Zaw         , Aa          , Aa          , Aa          , Aa          , Zaw         , Aa          , Aa          , Aa          , Aa          , Aa          , Aa^Vla      , Zaw         , Zaw         , Zaw         , Zaw         , Aa          , Aa          , Aa          , Aa          , Ha          , Ms          , Ha          , Ha          , Aa          , Aa          , Aa          , Zaw         , Zaw         , Zaw         
Zaw         , Zaw         , Zaw         , Aa          , Zaw         , Aa          , Zaw         , Aa          , Zaw         , Zaw         , Zaw         , Zaw         , Zaw         , Zaw         , Zaw         , Zaw         , Zaw         , Aa          , Aa^Vla      , Aa          , Aa          , Aa          , Ha          , Ha          , Ha          , Aa          , Aa          , Aa          , Zaw         , Zaw         , Zaw         , Zaw         , Zaw         , Aa          , Aa          , Aa          , Aa          , Ha          , Aa          , Ha          , Aa          , Aa          , Aa          , Zaw         , Zaw         , Aa          
Aa          , Zaw         , Zaw         , Zaw         , Aa          , Zaw         , Aa          , Zaw         , Aa          , Zaw         , Zaw         , Zaw         , Zaw         , Zaw         , Aa          , Aa          , Aa          , Zaw         , Aa          , Zaw         , Aa          , Aa          , Ha          , Ms          , Ha          , Ha          , Aa          , Zaw         , Zaw         , Zaw         , Zaw         , Zaw         , Aa          , Zaw         , Zaw         , Aa^Vla      , Zaw         , Aa          , Aa          , Aa          , Aa          , Aa          , Aa          , Aa          , Zaw         , Aa          
Zaw         , Aa          , Zaw         , Aa          , Zaw         , Aa          , Zaw         , Zaw         , Zaw         , Zaw         , Zaw         , Zaw         , Zaw         , Zaw         , Zaw         , Aa          , Aa          , Aa          , Aa          , Zaw         , Aa          , Aa          , Ha          , Ms          , Ha          , Ha          , Aa          , Zaw         , Zaw         , Zaw         , Zaw         , Zaw         , Zaw         , Zaw         , Zaw         , Aa          , Zaw         , Zaw         , Zaw         , Zaw         , Cha         , Zaw         , Zaw         , Zaw         , Zaw         , Aa          
Zaw         , Aa          , Zaw         , Zaw         , Zaw         , Zaw         , Zaw         , Aa          , Aa^Vla      , Zaw         , Aa          , Zaw         , Zaw         , Zaw         , Zaw         , Zaw         , Zaw         , Aa          , Zaw         , Zaw         , Zaw         , Aa          , Aa          , Ha          , Aa          , Aa          , Aa          , Aa          , Zaw         , Zaw         , Zaw         , Zaw         , Zaw         , Zaw         , Zaw         , Zaw         , Zaw         , Aa          , Zaw         , Cha         , 4 Kha       , Cha         , Zaw         , Zaw         , Zaw         , Zaw         
Zaw         , Zaw         , Zaw         , Zaw         , Zaw         , Zaw         , Zaw         , Zaw         , Zaw         , Aa          , Zaw         , Zaw         , Aa          , Zaw         , Zaw         , Zaw         , Zaw         , Zaw         , Zaw         , Aa          , Aa          , Aa          , Aa          , Aa          , Aa          , Aa          , Zaw         , Aa          , Aa          , Aa          , Zaw         , Aa          , Zaw         , Zaw         , Aa          , Zaw         , Aa          , Zaw         , Aa          , Cha         , Cha         , Cha         , Aa          , Zaw         , Zaw         , Aa          
Zaw         , Zaw         , Zaw         , Zaw         , Zaw         , Zaw         , Zaw         , Zaw         , Aa          , Aa          , Aa          , Zaw         , Zaw         , Zaw         , Zaw         , Aa          , Aa          , Aa          , Zaw         , Zaw         , Zaw         , Zaw         , Aa          , Aa^Vla      , Aa          , Zaw         , Zaw         , Zaw         , Zaw         , Aa          , Zaw         , Zaw         , Aa          , Aa          , Aa^Vla      , Aa          , Aa          , Aa          , Zaw         , Zaw         , Aa          , Zaw         , Zaw         , Zaw         , Aa          , Zaw         
Zaw         , Zaw         , Zaw         , Zaw         , Zaw         , Zaw         , Aa          , Aa          , Ha          , Aa          , Ha          , Aa          , Aa          , Zaw         , Aa          , Aa          , Aa          , Aa          , Aa          , Zaw         , Zaw         , Zaw         , Aa          , Zaw         , Zaw         , Zaw         , Zaw         , Zaw         , Zaw         , Zaw         , Zaw         , Aa          , Aa          , Aa          , Aa          , Aa          , Ha          , Aa          , Aa          , Zaw         , Zaw         , Zaw         , Zaw         , Zaw         , Zaw         , Aa          
Aa          , Zaw         , Zaw         , Zaw         , Zaw         , Aa          , Aa          , Ha          , Ms          , Ha          , Ms          , Ha          , Aa          , Aa          , Aa^Vla      , Zaw         , Zaw         , Zaw         , Zaw         , Aa          , Aa          , Zaw         , Aa          , Zaw         , Aa          , Zaw         , Zaw         , Zaw         , Zaw         , Zaw         , Aa          , Aa          , Aa          , Aa          , Ha          , Ha          , Ha          , Ha          , Aa          , Aa          , Zaw         , Zaw         , Aa          , Aa          , Zaw         , Zaw         
Aa          , Aa          , Zaw         , Zaw         , Zaw         , Aa^Vla      , Aa          , Ha          , Ha          , Ms          , Ms          , Ha          , Ha          , Aa          , Aa          , Zaw         , Zaw         , Zaw         , Zaw         , Aa          , Aa          , Zaw         , Zaw         , Aa          , Zaw         , Zaw         , Zaw         , Zaw         , Zaw         , Aa          , Aa          , Aa          , Ha          , Ha          , Ha          , Ha          , Ms          , Ha          , Ha          , Aa          , Aa          , Aa          , Aa          , Zaw         , Zaw         , Zaw         
Aa          , Zaw         , Zaw         , Zaw         , Zaw         , Zaw         , Aa          , Aa          , Aa          , Ha          , Ha          , Ha          , Ha          , Ha          , Aa          , Aa          , Zaw         , Zaw         , Aa          , Zaw         , Zaw         , Aa          , Aa          , Zaw         , Zaw         , Zaw         , Zaw         , Aa          , Zaw         , Aa          , Aa^Vla      , Aa          , Ha          , Ha          , Ha          , Ms          , Ms          , Ms          , Ha          , Ha          , Aa          , Aa          , Aa          , Aa          , Aa          , Zaw         
Zaw         , Zaw         , Zaw         , Zaw         , Zaw         , Zaw         , Zaw         , Aa          , Zaw         , Aa          , Aa          , Aa          , Aa          , Aa          , Aa          , Aa          , Zaw         , Aa          , Zaw         , Zaw         , Aa          , Zaw         , Zaw         , Zaw         , Zaw         , Aa          , Aa          , Zaw         , Zaw         , Zaw         , Aa          , Aa          , Aa          , Aa          , Aa          , Ha          , Ha          , Ha          , Ha          , Ha          , Aa          , Aa          , Zaw         , Zaw         , Zaw         , Zaw         
Zaw         , Zaw         , Zaw         , Zaw         , Aa          , Zaw         , Zaw         , Zaw         , Zaw         , Aa          , Aa          , Aa          , Zaw         , Zaw         , Zaw         , Zaw         , Aa          , Aa          , Zaw         , Zaw         , Zaw         , Zaw         , Zaw         , Zaw         , Zaw         , Zaw         , Zaw         , Zaw         , Aa          , Zaw         , Zaw         , Aa          , Zaw         , Aa          , Zaw         , Aa          , Aa          , Aa          , Aa          , Aa          , Aa          , Aa^Vla      , Aa          , Zaw         , Zaw         , Zaw         
Aa          , Zaw         , Aa          , Zaw         , Aa          , Zaw         , Zaw         , Zaw         , Zaw         , Zaw         , Aa          , Zaw         , Zaw         , Zaw         , Zaw         , Zaw         , Zaw         , Zaw         , Zaw         , Aa          , Aa          , Zaw         , Aa          , Aa^Vla      , Zaw         , Zaw         , Zaw         , Zaw         , Zaw         , Zaw         , Zaw         , Zaw         , Aa          , Zaw         , Aa          , Aa          , Aa          , Aa          , Aa          , Aa          , Zaw         , Aa          , Zaw         , Aa          , Aa          , Aa          
Aa          , Aa          , Aa          , Aa          , Zaw         , Zaw         , Zaw         , Zaw         , Zaw         , Zaw         , Zaw         , Zaw         , Zaw         , Aa          , Zaw         , Aa          , Aa          , Zaw         , Aa          , Aa          , Ha          , Aa          , Aa          , Aa          , Zaw         , Zaw         , Zaw         , Zaw         , Zaw         , Zaw         , Zaw         , Aa          , Zaw         , Aa          , Zaw         , Zaw         , Aa          , Zaw         , Aa          , Zaw         , Aa          , Aa          , Aa          , Aa          , Aa          , Aa          
Aa          , Aa          , Aa          , Zaw         , Aa          , Zaw         , Zaw         , Zaw         , Zaw         , Zaw         , Zaw         , Zaw         , Zaw         , Zaw         , Aa          , Aa          , Aa          , Aa          , Ha          , Ha          , Ms          , Ha          , Ha          , Aa          , Zaw         , Zaw         , Zaw         , Zaw         , Zaw         , Zaw         , Zaw         , Zaw         , Zaw         , Aa          , Zaw         , Zaw         , Cha         , Aa          , Aa          , Aa          , Aa          , Aa          , Ha          , Aa          , Ha          , Ha          
Aa          , Aa          , Zaw         , Aa          , Zaw         , Zaw         , Aa^Vla      , Aa          , Zaw         , Zaw         , Zaw         , Zaw         , Zaw         , Zaw         , Aa          , Aa          , Aa          , Ha          , Ha          , Ms          , Ms          , Ha          , Ha          , Aa          , Zaw         , Zaw         , Zaw         , Zaw         , Zaw         , Zaw         , Zaw         , Zaw         , Zaw         , Zaw         , Zaw         , Cha         , 3 Kha       , Cha         , Aa          , Aa          , Zaw         , Aa          , Ha          , Ha          , Ms          , Ms          
Zaw         , Zaw         , Aa          , Zaw         , Zaw         , Zaw         , Zaw         , Zaw         , Zaw         , Zaw         , Zaw         , Zaw         , Zaw         , Zaw         , Zaw         , Aa^Vla      , Aa          , Aa          , Ha          , Ha          , Ha          , Ha          , Aa          , Aa          , Zaw         , Zaw         , Zaw         , Zaw         , Zaw         , Zaw         , Zaw         , Zaw         , Zaw         , Zaw         , Aa          , Cha         , Cha         , Cha         , Zaw         , Zaw         , Aa          , Aa          , Aa          , Ha          , Ha          , Ha          
Zaw         , Zaw         , Zaw         , Zaw         , Aa          , Zaw         , Zaw         , Zaw         , Zaw         , Zaw         , Zaw         , Zaw         , Zaw         , Zaw         , Zaw         , Aa          , Zaw         , Aa          , Ha          , Ha          , Aa          , Ha          , Zaw         , Aa          , Zaw         , Aa          , Zaw         , Aa          , Aa          , Aa          , Aa          , Zaw         , Aa          , Aa          , Zaw         , Aa^Vla      , Zaw         , Zaw         , Zaw         , Zaw         , Zaw         , Aa          , Aa          , Aa          , Aa          , Ha          
Aa          , Aa          , Aa          , Aa          , Aa          , Aa          , Aa          , Zaw         , Zaw         , Zaw         , Zaw         , Zaw         , Zaw         , Aa          , Zaw         , Zaw         , Zaw         , Zaw         , Aa          , Aa          , Zaw         , Aa          , Aa          , Aa          , Aa          , Zaw         , Zaw         , Zaw         , Zaw         , Aa          , Aa          , Aa          , Aa          , Aa          , Aa          , Aa          , Aa          , Zaw         , Zaw         , Zaw         , Zaw         , Aa          , Aa^Vla      , Aa          , Aa          , Aa          
Aa          , Aa          , Ha          , Aa          , Aa          , Aa          , Aa          , Aa          , Aa          , Aa          , Zaw         , Zaw         , Zaw         , Zaw         , Cha         , Cha         , Cha         , Zaw         , Zaw         , Zaw         , Zaw         , Zaw         , Aa^Vla      , Zaw         , Zaw         , Aa          , Zaw         , Aa          , Zaw         , Aa^Vla      , Aa          , Aa          , Aa          , Aa          , Ha          , Aa          , Aa          , Aa          , Zaw         , Aa          , Zaw         , Zaw         , Zaw         , Zaw         , Aa          , Aa          
Ha          , Ha          , Ha          , Ha          , Aa          , Aa          , Zaw         , Zaw         , Zaw         , Aa          , Zaw         , Zaw         , Aa          , Zaw         , Cha         , 2 Kha       , Cha         , Zaw         , Zaw         , Zaw         , Zaw         , Zaw         , Aa          , Aa          , Zaw         , Zaw         , Zaw         , Aa          , Zaw         , Zaw         , Aa          , Aa          , Aa          , Ha          , Ms          , Ha          , Ha          , Aa          , Aa          , Zaw         , Zaw         , Zaw         , Zaw         , Zaw         , Zaw         , Aa          
Ms          , Ms          , Ms          , Ha          , Aa          , Aa          , Zaw         , Zaw         , Zaw         , Aa^Vla      , Zaw         , Zaw         , Zaw         , Aa          , Zaw         , Cha         , Zaw         , Zaw         , Zaw         , Zaw         , Zaw         , Aa          , Aa          , Zaw         , Zaw         , Aa          , Zaw         , Zaw         , Zaw         , Aa          , Aa          , Aa          , Ha          , Ha          , Ha          , Ms          , Ha          , Aa          , Aa          , Zaw         , Aa          , Zaw         , Zaw         , Zaw         , Zaw         , Zaw         
Ms          , Ms          , Ha          , Ha          , Aa          , Aa          , Aa          , Aa          , Aa          , Aa          , Zaw         , Zaw         , Zaw         , Zaw         , Zaw         , Aa          , Zaw         , Zaw         , Aa          , Aa          , Aa          , Aa          , Aa          , Zaw         , Aa          , Zaw         , Zaw         , Zaw         , Zaw         , Zaw         , Zaw         , Aa          , Aa          , Aa          , Aa          , Ha          , Aa          , Aa          , Aa          , Aa          , Zaw         , Zaw         , Zaw         , Zaw         , Aa          , Zaw         
