border_size=1
usage=map

Ql          , Ql          , Ql          , Ql          , Ql          , Ql          , Ql          , Ql          , Ql          , Ql          , Ql          , Ql          , Ql          , Ql          , Ql          , Ql          , Ql          , Ql          , Ql          , Ql          , Ql          , Ql          , Ql          , Ql          
Ql          , Ql          , Ur          , Ql          , Ql          , Ql          , Ql          , Ql          , Ql          , Ql          , Ql          , Ql          , Qlf         , Ql          , Ql          , Ql          , Ql          , Ql          , Ql          , Ql          , Ql          , Ql          , Ql          , Ql          
Ql          , Ql          , Ur          , Ur          , Ur          , Ql          , Ql          , Ql          , Ql          , Ql          , Ql          , Qlf         , Qlf         , Qlf         , Qlf         , Qlf         , Qlf         , Ql          , Ql          , Ql          , Ur          , Ql          , Ql          , Ql          
Ql          , Ql          , Uh          , Ur          , Ur          , Uh          , Ql          , Ql          , Ql          , Ql          , Ql          , Qlf         , Qlf         , Qlf         , Ur          , Qlf         , Ur          , Ur          , Ur          , Qlf         , Ur          , Ql          , Ql          , Ql          
Qlf         , Qlf         , Qlf         , Ur          , Ur          , Ur          , Qlf         , Qlf         , Qlf         , Ql          , Ql          , Qlf         , Qlf         , Ur          , Ur          , Qlf         , Qlf         , Ur          , Qlf         , Ur          , Ur          , Ql          , Ql          , Ql          
Qlf         , Qlf         , Qlf         , Uh          , Uh          , Ur          , Uh          , Qlf         , Qlf         , Qlf         , Qlf         , Qlf         , Qlf         , Ur          , Ur          , Qlf         , Uh          , Ur          , Ur          , Ur          , Ur          , Ql          , Ql          , Ql          
Ql          , Qlf         , Qlf         , Uh          , Ur          , Ur          , Ur          , Ur          , Ur          , Ur          , Ur          , Uh          , Uh          , Ur          , Ur          , Ur          , Ur          , Uh          , Ur          , Ur          , Ur          , Ur          , Ql          , Ql          
Ql          , Ql          , Qlf         , Qlf         , Ur          , Ur          , Ur          , Ur          , Ur          , Ur          , Qlf         , Ur          , Ur          , Ur          , Qlf         , Qlf         , Ur          , Ur          , Qlf         , Ur          , Ql          , Ql          , Ql          , Ql          
Ql          , Ql          , Qlf         , Qlf         , Ur          , Ur          , Ql          , Ql          , Ur          , Qlf         , Uh          , Qlf         , Ur          , Ur          , Ur          , Qlf         , Ur          , Qlf         , Qlf         , Qlf         , Ql          , Ql          , Ql          , Ql          
Ql          , Ql          , Qlf         , Qlf         , Uh          , Ur          , Ur          , Ql          , Ur          , Uh          , Ur          , Ur          , Ur          , Ur          , Ur          , Ur          , Uh          , Qlf         , Ql          , Ql          , Ql          , Ql          , Ql          , Ql          
Qlf         , Qlf         , Qlf         , Qlf         , Ur          , Ur          , Qlf         , Ur          , Ur          , Ur          , Ur          , Ur          , Qlf         , Qlf         , Qlf         , Ur          , Uh          , Qlf         , Ql          , Ql          , Qlf         , Ql          , Ql          , Ql          
Qlf         , Qlf         , Qlf         , Qlf         , Qlf         , Ur          , Ur          , Qlf         , Ur          , Ur          , Qlf         , Ur          , Qlf         , Qlf         , Qlf         , Ur          , Ur          , Ur          , Ur          , Qlf         , Qlf         , Qlf         , Qlf         , Ql          
Qlf         , Qlf         , Qlf         , Qlf         , Uh          , Ur          , Ur          , Ur          , Ur          , Ur          , Ur          , Ur          , Qlf         , Ur          , Ur          , Ur          , Uh          , Ur          , Ur          , Ur          , Ur          , Qlf         , Qlf         , Ql          
Ql          , Qlf         , Qlf         , Qlf         , Uh          , Uh          , Ur          , Qlf         , Qlf         , Ur          , Ur          , Ur          , Ur          , Ur          , Ur          , Ur          , Uh          , Ur          , Ur          , Ur          , Ur          , Ur          , Qlf         , Ql          
Ql          , Ql          , Ql          , Ql          , Ql          , Uh          , Uh          , Ur          , Ur          , Ur          , Ur          , Ur          , Ur          , Ur          , Ur          , Ur          , Qlf         , Qlf         , Qlf         , Ur          , Ur          , Ur          , Ql          , Ql          
Ql          , Ql          , Ql          , Ql          , Ql          , Ql          , Uh          , Ur          , Ur          , Ur          , Ur          , Ur          , Ur          , Ur          , Ur          , Qlf         , Qlf         , Qlf         , Qlf         , Qlf         , Ql          , Ur          , Ql          , Ql          
Ql          , Ql          , Ql          , Ql          , Ql          , Qlf         , Ur          , Ur          , Ur          , Ur          , Cud         , Cud         , Cud         , Ur          , Ur          , Ur          , Qlf         , Qlf         , Qlf         , Ql          , Ql          , Ql          , Ql          , Ql          
Ql          , Ql          , Ql          , Ql          , Ql          , Qlf         , Ur          , Ur          , Ur          , Cud         , Cud         , 1 Kud       , Cud         , Cud         , Ur          , Ur          , Qlf         , Qlf         , Ql          , Ql          , Ql          , Ql          , Ql          , Ql          
Ql          , Ql          , Ql          , Ql          , Qlf         , Qlf         , Qlf         , Ur          , Ur          , Ur          , Ur          , Cud         , Qlf         , Ur          , Qlf         , Qlf         , Qlf         , Qlf         , Ql          , Ql          , Ql          , Ql          , Ql          , Ql          
Ql          , Ql          , Ql          , Ql          , Ql          , Qlf         , Qlf         , Qlf         , Qlf         , Qlf         , Qlf         , Qlf         , Qlf         , Qlf         , Qlf         , Qlf         , Ql          , Ql          , Ql          , Ql          , Ql          , Ql          , Ql          , Ql          
