border_size=1
usage=map

Ww, Gs^Fds, Gg, Gs^Fds, Gg, Gs^Fds, Gg, Gg, Gg, Gg^Efm, Gg, Gg, Gg, Gs^Fds, Rd, Gs^Fds, Gs^Fds, Rd, Chr, Chr, Chr, Chr, Chr, Chr
Gs^Fds, Ww, Ww, Gg^Vh, Gg, Gg, Gg^Efm, Gg, Gs^Fds, Gg, Gg, Gg, Gg, Gg, Gg^Vh, Rd, Gs^Fds, Hh^Fms, Chr, Chr, Chr, 2 Khr, Chr, Chr
Gs^Fds, Gs^Fds, Gg, Ww, Gg, Gg, Gs^Fds, Gs^Fds, Gs^Fds, Gg, Gg^Efm, Gg, Gg, Gg, Gg, Rd, Gs^Fds, Hh^Fds, Hh^Fms, Chr, Chr, Chr, Chr, Chr
Gg, Gg, Gg, Ww, Ww, Gs^Fds, Gg, Gs^Fds, Gg, Gg, Gg^Efm, Gg^Efm, Gs^Fds, Gs^Fds, Gg, Rd, Gs^Fds, Hh^Fds, Chr, Chr, Chr, Chr, Chr, Chr
Gg, Gg, Gg, Gg, Gg, Ww, Ww, Gg, Gg, Gg, Gg, Gg^Efm, Gg, Gs^Fds, Gs^Fds, Rd, Rd, Chr, Hh^Fds, Hh^Fms, Chr, Chr, Chr, Chr
Gg^Vh, Gg, Gg, Gg, Gs^Fds, Gg, Ww, Gg, Gg, Gg, Gg, Gg, Gg, Gs^Fds, Gs^Fds, Rd, Rd, Gs^Fds, Gs^Fds, Hh^Fds, Hh^Fms, Chr, Chr, Chr
Gg, Gg, Gs^Fds, Gs^Fds, Gs^Fds, Gs^Fds, Ww, Gg, Gs^Fds, Gg, Gg, Gg^Efm, Gg, Gg, Rd, Rd, Gg, Rd, Gs^Fds, Gs^Fds, Gs^Fds, Hh^Fms, Hh^Fms, Chr
Gg, Gs^Fds, Gs^Fds, Gs^Fds, Gs^Fds, Gs^Fds, Gg, Ww, Gs^Fds, Gs^Fds, Gs^Fds, Gs^Fds, Gs^Fds, Gg, Rd, Gg, Gg, Rd, Rd, Gg^Vh, Gs^Fds, Hh^Fds, Hh^Fds, Hh^Fms
Gg, Gg, Gg, Gs^Fds, Gg, Gg, Gg, Ww, Gg, Gs^Fds, Gs^Fds, Gs^Fds, Rd, Rd, Gg^Efm, Gg^Efm, Gg, Gg, Gg, Rd, Gs^Fds, Hh^Fds, Hh^Fds, Hh^Fds
Gg, Gg, Gg, Gg, Gg, Gg, Gg, Ww, Ww, Gg, Rd, Rd, Gg, Gg, Gg, Gg^Efm, Gg, Gs^Fds, Gs^Fds, Rd, Rd, Gs^Fds, Hh^Fds, Hh^Fds
Gg, Gg, Gg, Gg, Gg^Efm, Gg, Gg, Gg, Gs^Fds, Ww, Ww^Bw|, Gg, Gs^Fds, Gg, Gg, Gg, Gg, Gs^Fds, Gg, Gg, Rd, Gs^Fds, Gs^Fds, Hh^Fds
Gg, Gg, Gg, Gg^Efm, Gg, Gg, Gs^Fds, Gs^Fds, Gs^Fds, Gs^Fds, Rd, Ww, Gs^Fds, Gs^Fds, Gg, Gg^Vh, Gg, Gs^Fds, Gg, Gg, Gs^Fds, Rd, Rd, Gg
Gg^Efm, Gg, Gg, Gg, Gg^Vh, Gg, Gg, Gs^Fds, Gs^Fds, Rd, Gg, Ww, Ww, Gs^Fds, Gg, Gg, Gs^Fds, Gg, Gg, Gg, Gg, Gs^Fds, Gs^Fms, Rd
Gg^Efm, Gg, Gs^Fds, Gs^Fds, Gg, Gg, Gg, Gg, Gg, Rd, Gg, Gg, Gg, Ww, Ww, Gg, Gs^Fds, Gs^Fds, Gg, Gg^Efm, Gg^Efm, Gg, Ss^Vhs, Gg
Gg, Gs^Fds, Gg, Gg, Gg, Gg, Gs^Fds, Gg, Rd, Rd, Gs^Fds, Gg, Gs^Fds, Gg, Gg, Ww, Gs^Fds, Gs^Fds, Gg, Gg^Efm, Gg^Efm, Gg, Ww, Gg
Gg, Gg, Gg, Gg, Gg, Gs^Fds, Gs^Fds, Gs^Fds, Rd, Gg, Gs^Fds, Gs^Fds, Gs^Fds, Gs^Fds, Ww, Ww, Gs^Fms, Gs^Fms, Ss, Gg, Ww, Ss, Ss, Gg
Gg, Gg, Gg, Gg, Gg^Efm, Gs^Fds, Gs^Fds, Rd, Gg, Gg, Gs^Fds, Gs^Fds, Gs^Fds, Gs^Fds, Ww, Gg, Ss, Gs^Fms, Gs^Fms, Ww, Gg, Gs^Fms, Gs^Fms, Gs^Fms
Gs^Fds, Gg, Gg, Gg, Gg^Efm, Gg^Efm, Rd, Rd, Gg, Gg, Gg, Gg, Ww, Gs^Fms, Ss, Gs^Fms, Gs^Fms, Gg, Gg, Ss, Ww, Gg, Gs^Fms, Gg
Gs^Fds, Gs^Fds, Gg, Gg, Gg, Gg^Efm, Rd, Gg, Gg, Gg^Vh, Gs^Fds, Gg^Efm, Gg^Efm, Ww, Ww, Gs^Fms, Ss, Gg, Ss^Vhs, Gg, Ww, Ss, Ss, Gg
Gs^Fds, Gs^Fds, Gg, Gg, Gg, Gg^Efm, Rd, Gg, Gg, Gg, Gs^Fds, Gs^Fds, Gg, Gg, Ww, Ss, Ww, Ss, Ww, Ww, Gs^Fms, Gg, Ss, Gg
Rd, Gs^Fds, Gg, Gg, Ch, Ch, Ch, Gg, Gg, Gg, Gg, Gg, Ss, Ww, Gs^Fms, Gg, Gs^Fms, Gs^Fms, Gg, Ww, Gs^Fms, Gs^Fms, Ss, Gg
Gg, Rd, Ch, Ch, 1 Kh, Ch, Gg, Rr, Gg, Gg, Gg, Gg, Ss, Gg, Gg, Gg, Ss, Gs^Fms, Gg, Ss, Gg, Gs^Fms, Gg, Gg
Gg, Gg, Gg, Ch, Gg, Ch, Gg, Rr, Ss, Gg, Gg, Ss^Vhs, Ss, Ss, Gs^Fms, Gg, Gg, Gs^Fms, Gs^Fms, Ww, Gg, Gg, Gg, Gg
Gg, Gg, Gg, Gg, Gg, Gg, Ss, Rr^Bw|, Ss, Ss, Ss, Gg, Ww, Gs^Fms, Gg, Gg, Gg, Gs^Fms, Gs^Fms, Ss, Ss, Gg, Gg, Gg
