border_size=1
usage=map

Uu          , Uu          , Uu          , Uu          , Uu          , Xu          , Xu          , Xu          , Xu          , Xu          , Xu          , Xu          , Xu          , Xu          , Xu          , Xu          , Qlf         , Qlf         , Qlf         , Qlf         , Qlf         , Qlf         , Qlf         , Qlf         , Qlf         , Qlf         , Qlf         , Qlf         , Qlf         , Qlf         , Qlf         , Qlf         , Qlf         , Qlf         , Qlf         , Qlf         , Qlf         , Qlf         , Qlf         , Qlf         , Qlf         , Qlf         , Qlf         , Qlf         , Qlf         , Qlf         , Qlf         , Qlf         , Qlf         , Qlf         
Xu          , Uu          , Cud         , Cud         , Cud         , Xu          , Uu          , Xu          , Uu          , Xu          , Xu          , Xu          , Xu          , Xu          , Qlf         , Qlf         , Qlf         , Qlf         , Qlf         , Qlf         , Qlf         , Qlf         , Qlf         , Qlf         , Uh          , Uh          , Uh          , Qlf         , Zvw         , Qlf         , Qlf         , Qlf         , Qlf         , Qlf         , Uu          , Qlf         , Qlf         , Qlf         , Qlf         , Qlf         , Qlf         , Qlf         , Qlf         , Qlf         , Qlf         , Qlf         , Qlf         , Qlf         , Qlf         , Qlf         
Xu          , Uu          , Cud         , 1 Kud       , Cud         , Cud         , Ur          , Ur          , Uu          , Xu          , Xu          , Xu          , Xu          , Qlf         , Qlf         , Qlf         , Qlf         , Qlf         , Qlf         , Qlf         , Uh          , Zvw         , Zvw         , Qlf         , Zvw         , Xu          , Xu          , Uh          , Zvw^Vzps     , Qlf         , Qlf         , Qlf         , Qlf         , Uu          , Uh          , Xu          , Zvw         , Qlf         , Qlf         , Qlf         , Uu          , Xu          , Qlf         , Qlf         , Qlf         , Qlf         , Qlf         , Qlf         , Qlf         , Qlf         
Xu          , Xu          , Uu          , Cud         , Uu          , Cud         , Ur          , Ur          , Ur          , Uu^Vzps      , Uu          , Xu          , Qlf         , Qlf         , Qlf         , Qlf         , Qlf         , Qlf         , Xu          , Xu          , Uh          , Zvw^Vzps     , Zvw         , Qlf^Bs/     , Qlf         , Zvw         , Zvw         , Uu          , Qlf^Bs\     , Qlf         , Zvw         , Qlf         , Qlf^Bs/     , Zvw         , Zvw^Vzps     , Zvw         , Qlf         , Qlf^Bs\     , Zvw         , Zvw         , Uh          , Xu          , Xu          , Qlf         , Qlf         , Qlf         , Qlf         , Qlf         , Qlf         , Qlf         
Xu          , Xu          , Xu          , Xu          , Xu          , Uu          , Ur          , Ur          , Ur          , Ur          , Uu          , Uu          , Uu          , Qlf         , Qlf         , Qlf         , Qlf         , Qlf         , Qlf         , Zvw         , Zvw         , Zvw         , Qlf^Bs\     , Qlf         , Zvw         , Qlf         , Qlf^Bs/     , Zvw         , Qlf         , Uu          , Zvw^Vzps     , Zvw         , Qlf         , Zvw         , Qlf^Bs\     , Qlf         , Qlf         , Qlf         , Qlf         , Zvw         , Zvw         , Zvw^Vzps     , Qlf         , Qlf         , Qlf         , Qlf         , Qlf         , Qlf         , Qlf         , Qlf         
Xu          , Xu          , Xu          , Xu          , Xu          , Uu          , Uu          , Ur          , Ur          , Ur          , Uu          , Uu          , Uu          , Qlf         , Qlf         , Qlf         , Qlf         , Qlf         , Qlf         , Qlf         , Qlf         , Qlf         , Qlf         , Zvw         , Uh          , Zvw^Vzps     , Qlf         , Qlf         , Zvw         , Zvw         , Xu          , Xu          , Qlf         , Qlf         , Uu          , Zvw         , Qlf         , Qlf         , Zvw         , Qlf^Bs/     , Qlf         , Qlf         , Qlf         , Qlf         , Qlf         , Qlf         , Qlf         , Qlf         , Qlf         , Qlf         
Xu          , Xu          , Xu          , Xu          , Uu          , Uu          , Uu          , Uu          , Uu          , Uu          , Zvw         , Ur          , Zvw^Vzps     , Uu          , Xu          , Qlf         , Qlf         , Qlf         , Qlf         , Qlf         , Qlf         , Qlf         , Qlf^Bs/     , Zvw         , Xu          , Zvw         , Qlf^Bs/     , Zvw         , Zvw         , Uu          , Zvw         , Qlf         , Zvw         , Xu          , Zvw^Vzps     , Zvw         , Qlf^Bs\     , Qlf         , Zvw         , Uu          , Zvw^Vzps     , Uu          , Qlf         , Qlf         , Qlf         , Qlf         , Qlf         , Qlf         , Qlf         , Qlf         
Xu          , Xu          , Xu          , Xu          , Qlf         , Uu          , Qlf         , Xu          , Xu          , Zvw         , Zvw         , Zvw         , Zvw         , Xu          , Qlf         , Qlf         , Qlf         , Qlf         , Zvw         , Zvw         , Zvw         , Zvw         , Zvw         , Qlf         , Xu          , Zvw         , Qlf         , Qlf         , Qlf         , Zvw         , Zvw         , Qlf^Bs/     , Uu          , Uu          , Zvw         , Qlf         , Qlf         , Zvw         , Zvw         , Xu          , Zvw         , Qlf         , Qlf         , Qlf         , Uu^Vzps      , Qlf         , Qlf         , Qlf         , Qlf         , Qlf         
Xu          , Xu          , Qlf         , Qlf         , Qlf         , Qlf^Bs|     , Qlf         , Qlf         , Qlf^Bs/     , Zvw         , Qlf         , Zvw         , Zvw         , Uu          , Qlf         , Qlf         , Zvw         , Qlf^Bs/     , Qlf         , Zvw         , Uu          , Zvw         , Zvw^Vzps     , Qlf         , Qlf         , Xu          , Qlf         , Qlf         , Zvw         , Qlf^Bs/     , Qlf         , Qlf         , Uh          , Uh          , Zvw         , Qlf         , Qlf         , Zvw         , Qlf^Bs\     , Qlf         , Qlf         , Qlf^Bs\     , Zvw         , Zvw         , Zvw         , Qlf         , Qlf         , Qlf         , Qlf         , Qlf         
Xu          , Qlf         , Qlf         , Qlf         , Uh          , Uh          , Zvw         , Zvw         , Zvw         , Qlf         , Zvw         , Qlf         , Qlf         , Qlf^Bs\     , Zvw         , Zvw         , Uu          , Zvw         , Xu          , Xu          , Qlf         , Zvw         , Qlf^Bs\     , Qlf         , Zvw         , Qlf         , Zvw         , Uu          , Zvw^Vzps     , Zvw         , Qlf         , Qlf         , Qlf         , Xu          , Zvw         , Zvw         , Qlf^Bs\     , Qlf         , Zvw         , Uu          , Qlf         , Qlf         , Zvw         , Xu          , Xu          , Xu          , Qlf         , Qlf         , Qlf         , Qlf         
Qlf         , Qlf         , Qlf         , Qlf         , Zvw         , Uh          , Zvw         , Zvw^Vzps     , Qlf         , Qlf^Bs\     , Zvw         , Zvw         , Zvw         , Qlf         , Qlf^Bs/     , Zvw         , Zvw         , Zvw^Vzps     , Xu          , Xu          , Qlf         , Qlf         , Zvw         , Zvw         , Zvw         , Qlf^Bs/     , Qlf         , Xu          , Uu          , Zvw         , Qlf         , Qlf         , Zvw         , Qlf^Bs/     , Qlf         , Qlf         , Zvw         , Zvw         , Zvw         , Uu^Vzps      , Qlf         , Zvw         , Cud         , Cud         , 5 Kud       , Xu          , Qlf         , Qlf         , Qlf         , Qlf         
Qlf         , Qlf         , Qlf         , Qlf         , Zvw         , Zvw         , Qlf         , Qlf         , Xu          , Xu          , Uu          , Zvw         , Zvw^Vzps     , Zvw         , Qlf         , Qlf         , Zvw         , Zvw         , Xu          , Xu          , Qlf         , Qlf         , Zvw         , Uu          , Uh          , Zvw         , Qlf         , Xu          , Zvw         , Zvw         , Qlf^Bs\     , Zvw         , Zvw         , Uu          , Qlf         , Qlf         , Xu          , Zvw         , Zvw         , Zvw         , Qlf^Bs/     , Zvw         , Zvw         , Cud         , Cud         , Xu          , Qlf         , Qlf         , Qlf         , Qlf         
Qlf         , Qlf         , Qlf         , Qlf         , Qlf         , Qlf^Bs\     , Zvw         , Uh          , Xu          , Xu          , Xu          , Zvw         , Zvw         , Zvw         , Zvw         , Qlf^Bs/     , Qlf         , Qlf^Bs\     , Cud         , 2 Kud       , Cud         , Qlf^Bs/     , Qlf         , Zvw^Vzps     , Qlf         , Qlf         , Qlf         , Uh          , Zvw         , Zvw         , Qlf         , Zvw         , Zvw         , Xu          , Qlf         , Qlf         , Qlf         , Xu          , Qlf         , Zvw         , Zvw         , Qlf         , Qlf         , Zvw         , Qlf         , Qlf         , Qlf         , Qlf         , Qlf         , Qlf         
Qlf         , Qlf         , Qlf         , Qlf         , Qlf         , Zvw         , Zvw         , Uu          , Qlf         , Xu          , Qlf         , Qlf         , Qlf         , Qlf         , Qlf         , Qlf         , Qlf         , Zvw^Vzps     , Zvw         , Cud         , Zvw         , Qlf         , Qlf         , Qlf         , Qlf         , Qlf         , Qlf         , Qlf         , Zvw         , Qlf         , Qlf         , Uh^Vzps      , Uu          , Uu          , Qlf^Bs\     , Qlf         , Qlf         , Qlf         , Qlf^Bs/     , Zvw         , Qlf^Bs\     , Qlf         , Zvw         , Qlf^Bs|     , Qlf         , Qlf         , Qlf         , Qlf         , Qlf         , Qlf         
Qlf         , Xu          , Zvw^Vzps     , Qlf         , Zvw         , Zvw         , Zvw         , Zvw         , Uu          , Qlf         , Zvw         , Qlf         , Xu          , Qlf         , Qlf         , Qlf         , Qlf         , Qlf         , Qlf^Bs/     , Zvw         , Qlf         , Zvw         , Qlf^Bs\     , Qlf         , Zvw         , Zvw         , Zvw         , Qlf^Bs/     , Qlf         , Qlf         , Qlf^Bs/     , Zvw         , Qlf         , Qlf         , Zvw         , Zvw         , Zvw^Vzps     , Zvw         , Xu          , Qlf         , Qlf         , Zvw         , Uu          , Zvw         , Qlf         , Qlf         , Qlf         , Qlf         , Qlf         , Qlf         
Qlf         , Xu          , Zvw         , Qlf^Bs/     , Qlf         , Zvw         , Zvw         , Zvw         , Zvw         , Qlf         , Zvw         , Xu          , Xu          , Xu          , Qlf         , Zvw         , Zvw         , Zvw         , Uh          , Qlf         , Xu          , Qlf         , Uh          , Zvw         , Zvw^Vzps     , Zvw         , Qlf         , Qlf^Bs\     , Zvw         , Zvw         , Qlf         , Qlf         , Qlf         , Qlf         , Zvw         , Zvw         , Zvw         , Uu          , Xu          , Qlf         , Qlf         , Zvw^Vzps     , Zvw         , Uu          , Qlf         , Qlf         , Qlf         , Qlf         , Qlf         , Qlf         
Qlf         , Qlf         , Qlf         , Qlf         , Qlf         , Zvw         , Qlf         , Zvw^Vzps     , Qlf         , Qlf^Bs\     , Zvw         , Uu^Vzps      , Zvw         , Zvw         , Qlf^Bs/     , Zvw         , Zvw         , Zvw         , Uh^Vzps      , Xu          , Xu          , Qlf         , Uh          , Zvw         , Uu          , Xu          , Qlf         , Qlf         , Xu          , Zvw         , Uu          , Qlf         , Qlf         , Qlf         , Qlf^Bs|     , Qlf         , Qlf         , Zvw         , Qlf^Bs\     , Qlf         , Zvw         , Zvw         , Zvw         , Zvw         , Qlf^Bs\     , Zvw         , Xu          , Qlf         , Qlf         , Qlf         
Qlf         , Qlf         , Qlf         , Qlf         , Zvw         , Qlf^Bs|     , Qlf         , Qlf         , Qlf         , Qlf         , Zvw         , Zvw         , Uh          , Zvw         , Qlf         , Qlf         , Zvw         , Zvw         , Zvw         , Xu          , Qlf         , Qlf         , Qlf^Bs/     , Zvw         , Zvw         , Xu          , Qlf         , Qlf         , Xu          , Uu          , Zvw^Vzps     , Zvw         , Qlf^Bs\     , Qlf         , Zvw         , Qlf         , Qlf         , Qlf         , Qlf         , Zvw         , Zvw         , Uu          , Uu          , Qlf         , Zvw         , Zvw         , Uu^Vzps      , Xu          , Qlf         , Qlf         
Qlf         , Qlf         , Qlf         , Zvw         , Zvw         , Zvw         , Zvw         , Qlf         , Zvw         , Zvw         , Zvw         , Uh          , Qlf         , Qlf         , Xu          , Qlf         , Qlf         , Zvw         , Qlf         , Qlf^Bs\     , Zvw         , Zvw         , Zvw         , Qlf         , Qlf         , Zvw         , Qlf^Bs\     , Qlf         , Zvw         , Zvw         , Uu          , Qlf         , Qlf         , Zvw         , Zvw         , Zvw         , Qlf         , Qlf         , Qlf         , Zvw         , Zvw         , Zvw         , Qlf         , Qlf         , Zvw         , Zvw         , Zvw         , Zvw         , Qlf         , Qlf         
Qlf         , Qlf         , Qlf         , Uu          , Xu          , Uh          , Zvw         , Qlf^Bs/     , Qlf         , Zvw         , Zvw         , Qlf         , Uh          , Xu          , Xu          , Qlf         , Qlf         , Qlf         , Qlf         , Zvw         , Zvw         , Uu^Vzps      , Qlf         , Qlf^Bs\     , Zvw         , Qlf         , Qlf^Bs/     , Zvw         , Qlf         , Zvw         , Qlf^Bs\     , Qlf         , Zvw         , Zvw         , Uu          , Xu          , Qlf         , Qlf         , Zvw         , Qlf^Bs/     , Qlf         , Qlf         , Qlf         , Qlf         , Qlf^Bs/     , Zvw         , Qlf         , Qlf         , Qlf         , Qlf         
Qlf         , Qlf         , Qlf         , Xu          , Xu          , Uh^Vzps      , Uu          , Zvw         , Qlf         , Qlf         , Qlf         , Qlf^Bs\     , Zvw         , Uh          , Zvw         , Qlf^Bs\     , Zvw         , Zvw         , Qlf^Bs/     , Zvw         , Zvw         , Qlf         , Qlf         , Qlf         , Xu          , Zvw         , Zvw         , Qlf         , Qlf         , Qlf         , Qlf         , Zvw         , Qlf         , Zvw^Vzps     , Zvw         , Zvw         , Qlf^Bs\     , Qlf         , Zvw         , Uu          , Zvw         , Qlf         , Zvw         , Zvw         , Zvw         , Qlf         , Qlf         , Qlf         , Qlf         , Qlf         
Qlf         , Qlf         , Qlf         , Qlf         , Qlf         , Qlf         , Qlf         , Zvw         , Zvw         , Qlf         , Qlf         , Qlf         , Zvw         , Uu^Vzps      , Qlf         , Qlf         , Zvw         , Uu          , Zvw         , Qlf         , Qlf         , Qlf^Bs\     , Zvw         , Xu          , Xu          , Zvw^Vzps     , Zvw         , Zvw         , Qlf^Bs\     , Qlf         , Zvw         , Qlf         , Qlf^Bs/     , Zvw         , Qlf         , Qlf         , Qlf         , Zvw         , Uu          , Zvw^Vzps     , Qlf         , Qlf^Bs\     , Zvw         , Zvw^Vzps     , Zvw         , Qlf         , Qlf         , Qlf         , Qlf         , Qlf         
Qlf         , Qlf         , Qlf         , Qlf         , Qlf         , Qlf         , Qlf         , Qlf         , Qlf^Bs|     , Qlf         , Qlf         , Qlf         , Qlf^Bs|     , Qlf         , Qlf         , Xu          , Zvw         , Zvw^Vzps     , Zvw         , Qlf         , Qlf         , Qlf         , Uu          , Zvw         , Zvw         , Uu          , Qlf         , Qlf         , Qlf         , Zvw         , Zvw         , Zvw         , Qlf         , Qlf         , Qlf         , Zvw         , Zvw         , Qlf^Bs/     , Zvw         , Zvw         , Qlf         , Qlf         , Zvw         , Uu          , Zvw         , Xu          , Qlf         , Qlf         , Qlf         , Qlf         
Qlf         , Qlf         , Qlf         , Qlf         , Qlf         , Qlf         , Qlf         , Qlf         , Zvw         , Zvw         , Zvw         , Qlf         , Zvw         , Qlf         , Qlf         , Xu          , Zvw         , Zvw         , Qlf         , Qlf^Bs\     , Zvw         , Qlf         , Qlf^Bs/     , Zvw         , Qlf         , Qlf^Bs\     , Zvw         , Zvw         , Zvw         , Qlf^Bs/     , Qlf         , Qlf^Bs\     , Zvw         , Qlf         , Zvw         , Zvw         , Xu          , Qlf         , Qlf         , Qlf^Bs\     , Zvw         , Qlf         , Qlf^Bs/     , Zvw         , Qlf         , Qlf         , Qlf         , Qlf         , Qlf         , Qlf         
Qlf         , Qlf         , Qlf         , Qlf         , Qlf         , Qlf         , Qlf         , Zvw         , Xu          , Uu          , Uh^Vzps      , Zvw         , Zvw         , Qlf         , Zvw         , Qlf^Bs/     , Qlf         , Qlf         , Qlf         , Qlf         , Uu          , Zvw^Vzps     , Zvw         , Qlf         , Qlf         , Xu          , Uu          , Uu^Vzps      , Zvw         , Zvw         , Qlf^Bs\     , Zvw         , Uu          , Uu          , Zvw         , Zvw         , Zvw         , Qlf         , Qlf         , Qlf         , Zvw         , Zvw         , Qlf         , Qlf         , Qlf         , Qlf         , Qlf         , Qlf         , Qlf         , Qlf         
Qlf         , Qlf         , Xu          , Xu          , Zvw         , Qlf         , Qlf^Bs/     , Zvw         , Xu          , Xu          , Qlf         , Uh          , Zvw         , Zvw         , Zvw         , Qlf         , Qlf         , Qlf         , Qlf         , Xu          , Zvw         , Zvw         , Qlf^Bs\     , Qlf         , Xu          , Qlf         , Qlf^Bs/     , Zvw         , Qlf         , Qlf         , Qlf         , Zvw         , Xu          , Zvw^Vzps     , Zvw         , Qlf         , Qlf         , Qlf^Bs\     , Zvw         , Zvw         , Uu^Vzps      , Xu          , Xu          , Qlf         , Qlf         , Qlf         , Qlf         , Qlf         , Qlf         , Qlf         
Qlf         , Qlf         , Xu          , Xu          , Uu^Vzps      , Zvw         , Qlf         , Qlf         , Qlf         , Qlf         , Zvw         , Qlf^Bs/     , Qlf         , Qlf         , Qlf         , Qlf^Bs\     , Zvw         , Xu          , Xu          , Qlf         , Qlf         , Qlf         , Qlf         , Zvw         , Zvw         , Zvw         , Zvw         , Qlf         , Qlf         , Qlf         , Qlf^Bs/     , Zvw         , Qlf         , Zvw         , Qlf^Bs\     , Qlf         , Qlf         , Qlf         , Zvw         , Uu          , Zvw         , Xu          , Xu          , Qlf         , Qlf         , Qlf         , Qlf         , Qlf         , Qlf         , Qlf         
Qlf         , Qlf         , Qlf         , Zvw         , Zvw         , Zvw         , Qlf         , Qlf         , Zvw^Vzps     , Uu          , Zvw         , Zvw         , Xu          , Qlf         , Qlf         , Uu          , Zvw         , Uh          , Zvw         , Zvw         , Qlf^Bs\     , Qlf         , Qlf         , Zvw^Vzps     , Uu          , Uu          , Zvw         , Qlf         , Qlf         , Zvw         , Zvw         , Qlf         , Qlf         , Qlf         , Qlf         , Zvw         , Zvw         , Qlf         , Qlf^Bs/     , Zvw         , Zvw         , Uu          , Qlf         , Qlf         , Qlf         , Qlf         , Qlf         , Qlf         , Qlf         , Qlf         
Qlf         , Qlf         , Qlf         , Uh          , Zvw         , Zvw         , Qlf         , Qlf         , Zvw         , Zvw         , Zvw         , Xu          , Qlf         , Qlf         , Qlf         , Uu          , Zvw         , Zvw^Vzps     , Zvw         , Qlf         , Qlf         , Zvw         , Uu          , Zvw         , Zvw         , Qlf         , Qlf         , Qlf^Bs\     , Zvw         , Zvw^Vzps     , Zvw         , Zvw         , Qlf^Bs\     , Qlf         , Zvw         , Uh          , Zvw         , Zvw         , Qlf         , Qlf         , Qlf         , Qlf^Bs\     , Zvw         , Qlf         , Qlf         , Qlf         , Qlf         , Qlf         , Qlf         , Qlf         
Qlf         , Qlf         , Qlf         , Qlf         , Qlf^Bs|     , Qlf         , Zvw         , Qlf^Bs/     , Qlf         , Qlf         , Qlf         , Qlf^Bs\     , Zvw         , Qlf         , Zvw         , Qlf^Bs/     , Qlf         , Qlf         , Qlf         , Qlf         , Xu          , Zvw         , Zvw         , Zvw         , Zvw         , Qlf         , Qlf         , Qlf         , Qlf^Bs/     , Zvw         , Uh          , Qlf         , Qlf         , Uu          , Xu          , Uu^Vzps      , Zvw         , Zvw         , Qlf^Bs\     , Qlf         , Zvw         , Zvw         , Zvw^Vzps     , Uh          , Qlf         , Qlf         , Qlf         , Qlf         , Qlf         , Qlf         
Qlf         , Qlf         , Xu          , Qlf         , Zvw         , Qlf         , Uh^Vzps      , Qlf         , Qlf         , Qlf         , Qlf         , Qlf         , Zvw         , Uu          , Zvw         , Qlf         , Qlf         , Qlf         , Qlf         , Qlf         , Xu          , Zvw         , Qlf         , Zvw         , Qlf         , Qlf^Bs\     , Zvw         , Zvw         , Uh          , Qlf         , Qlf         , Qlf         , Qlf         , Xu          , Qlf         , Uh          , Zvw         , Zvw         , Qlf         , Zvw         , Uu          , Uu          , Qlf         , Zvw         , Qlf         , Qlf         , Qlf         , Qlf         , Qlf         , Qlf         
Qlf         , Qlf         , Xu          , Cud         , Cud         , Zvw         , Uu          , Xu          , Qlf         , Qlf         , Qlf         , Qlf         , Zvw^Vzps     , Zvw         , Xu          , Zvw         , Uh          , Qlf         , Qlf         , Qlf         , Qlf         , Qlf^Bs|     , Qlf         , Qlf         , Qlf         , Qlf         , Zvw         , Zvw         , Uu          , Qlf         , Qlf         , Qlf         , Qlf         , Qlf         , Zvw         , Qlf^Bs/     , Qlf         , Qlf         , Qlf^Bs/     , Zvw         , Qlf         , Zvw         , Qlf^Bs\     , Qlf         , Xu          , Qlf         , Qlf         , Qlf         , Qlf         , Qlf         
Qlf         , Qlf         , Qlf         , Xu          , 3 Kud       , Cud         , Qlf         , Xu          , Qlf         , Qlf         , Zvw         , Qlf^Bs/     , Qlf         , Xu          , Xu          , Zvw         , Qlf^Bs\     , Qlf         , Zvw^Vzps     , Qlf         , Zvw         , Zvw         , Uu          , Qlf         , Qlf^Bs/     , Zvw         , Qlf         , Xu          , Qlf         , Qlf^Bs\     , Zvw         , Qlf         , Qlf         , Uu^Vzps      , Zvw         , Cud         , 4 Kud       , Cud         , Qlf         , Qlf         , Qlf         , Qlf         , Zvw         , Zvw         , Xu          , Xu          , Qlf         , Qlf         , Qlf         , Qlf         
Qlf         , Qlf         , Qlf         , Qlf         , Qlf         , Cud         , Qlf^Bs\     , Qlf         , Qlf         , Zvw         , Zvw         , Uu          , Xu          , Qlf         , Qlf         , Qlf         , Qlf         , Zvw         , Zvw         , Qlf         , Zvw         , Xu          , Uu          , Zvw         , Qlf         , Qlf         , Qlf         , Qlf         , Qlf         , Uu          , Uu^Vzps      , Zvw         , Qlf^Bs/     , Zvw         , Xu          , Cud         , Cud         , Cud         , Zvw         , Qlf         , Qlf         , Qlf         , Zvw         , Uu^Vzps      , Uh          , Xu          , Qlf         , Qlf         , Qlf         , Qlf         
Qlf         , Qlf         , Qlf         , Qlf         , Qlf         , Qlf         , Zvw         , Zvw         , Zvw         , Qlf^Bs/     , Zvw         , Zvw         , Uh          , Xu          , Zvw         , Qlf         , Zvw         , Zvw         , Zvw         , Qlf^Bs/     , Qlf         , Xu          , Qlf         , Qlf^Bs\     , Zvw         , Xu          , Qlf         , Qlf         , Zvw         , Zvw         , Uh          , Zvw         , Qlf         , Qlf         , Qlf         , Xu          , Zvw         , Zvw         , Qlf^Bs\     , Qlf         , Zvw         , Qlf         , Qlf^Bs/     , Zvw         , Qlf         , Qlf         , Xu          , Qlf         , Xu          , Xu          
Qlf         , Qlf         , Qlf         , Qlf         , Qlf         , Xu          , Uh          , Zvw         , Zvw         , Qlf         , Qlf         , Qlf         , Qlf         , Zvw^Vzps     , Zvw         , Qlf^Bs/     , Qlf         , Qlf         , Qlf         , Qlf^Bs\     , Zvw         , Qlf         , Uu^Vzps      , Zvw         , Uu          , Xu          , Zvw         , Qlf^Bs/     , Zvw         , Zvw         , Qlf^Bs\     , Qlf         , Uh          , Uh          , Uh          , Qlf         , Qlf         , Qlf         , Qlf         , Zvw         , Zvw         , Zvw         , Qlf         , Qlf         , Xu          , Xu          , Xu          , Xu          , Xu          , Xu          
Qlf         , Qlf         , Qlf         , Qlf         , Qlf         , Xu          , Qlf         , Zvw^Vzps     , Qlf         , Qlf^Bs\     , Zvw         , Qlf         , Uh          , Qlf         , Qlf         , Qlf^Bs\     , Zvw         , Qlf         , Zvw         , Qlf         , Qlf^Bs/     , Zvw         , Zvw         , Zvw         , Qlf         , Zvw         , Qlf         , Qlf         , Zvw         , Zvw         , Qlf         , Zvw         , Zvw         , Zvw         , Zvw         , Zvw         , Zvw         , Qlf         , Qlf         , Zvw         , Zvw^Vzps     , Zvw         , Zvw         , Qlf         , Xu          , Xu          , Uu^Vu       , Uh          , Xu          , Xu          
Qlf         , Qlf         , Qlf         , Qlf         , Qlf         , Qlf         , Qlf         , Qlf         , Qlf         , Zvw         , Uu          , Zvw         , Zvw         , Zvw         , Qlf^Bs/     , Zvw         , Zvw         , Uu^Vzps      , Xu          , Zvw         , Qlf         , Uh          , Qlf         , Qlf^Bs\     , Zvw         , Qlf         , Zvw         , Qlf^Bs/     , Qlf         , Qlf         , Qlf         , Zvw         , Xu          , Uu^Vzps      , Zvw         , Zvw         , Qlf         , Qlf^Bs\     , Zvw         , Zvw         , Zvw         , Zvw         , Zvw         , Zvw         , Uu          , Ur          , Ur          , Uu          , Uu^Vu       , Xu          
Qlf         , Qlf         , Qlf         , Qlf         , Qlf         , Qlf         , Qlf         , Qlf         , Qlf         , Xu          , Xu          , Uu          , Zvw         , Zvw^Vzps     , Qlf         , Zvw         , Zvw         , Xu          , Qlf         , Qlf         , Qlf         , Qlf         , Qlf         , Qlf         , Zvw         , Zvw^Vzps     , Xu          , Zvw         , Qlf         , Qlf         , Qlf         , Qlf         , Xu          , Xu          , Xu          , Qlf         , Qlf         , Qlf         , Zvw         , Zvw         , Zvw         , Zvw         , Xu          , Zvw         , Uu          , Ur          , Ur          , Ur          , Uu          , Uh          
Qlf         , Qlf         , Qlf         , Qlf         , Qlf         , Qlf         , Qlf         , Qlf         , Qlf         , Qlf         , Qlf         , Qlf         , Qlf         , Qlf         , Qlf         , Qlf         , Qlf         , Qlf         , Qlf         , Qlf         , Qlf         , Qlf         , Qlf         , Qlf         , Qlf         , Qlf         , Qlf         , Qlf         , Qlf         , Qlf         , Qlf         , Qlf         , Qlf         , Qlf         , Qlf         , Qlf         , Qlf         , Qlf         , Qlf         , Zvw         , Xu          , Xu          , Xu          , Uh          , Uu^Vu       , Ur          , Ur          , Ur          , Ur          , Uu^Vu       
Qlf         , Qlf         , Qlf         , Qlf         , Qlf         , Qlf         , Qlf         , Qlf         , Qlf         , Qlf         , Qlf         , Qlf         , Qlf         , Qlf         , Qlf         , Qlf         , Qlf         , Qlf         , Qlf         , Qlf         , Qlf         , Qlf         , Qlf         , Qlf         , Qlf         , Qlf         , Qlf         , Qlf         , Qlf         , Qlf         , Qlf         , Qlf         , Qlf         , Qlf         , Qlf         , Qlf         , Qlf         , Qlf         , Qlf         , Xu          , Xu          , Xu          , Xu          , Xu          , Xu          , Uh          , Uh          , Uh          , Uh          , Ur          
