border_size=1
usage=map

Ms^Xm       , Ms^Xm       , Ms^Xm       , Ms^Xm       , Ms^Xm       , Ms^Xm       , Ms^Xm       , Ms^Xm       , Ms^Xm       , Ms^Xm       , Ms^Xm       , Ms^Xm       , Ms^Xm       , Ms^Xm       , Ms^Xm       , Ms^Xm       , Ms^Xm       , Ms^Xm       , Ms          , Ms          , Ms          , Ms          , Ms          , Ms          , Ms          , Ms          , Ms          , Ms          , Ms          , Ms          , Ms          , Ms          , Ms          , Ms          , Ms          , Ms          , Ms          , Ms          , Ms          , Ms          , Ms          , Ms          , Ms          , Ms          , Ms          , Ms          
Ms^Xm       , Ms^Xm       , Ms^Xm       , Ms^Xm       , Ms          , Ms^Xm       , Ms          , Ms^Xm       , Ms          , Ms^Xm       , Ms          , Ms          , Ms          , Ms          , Ms          , Ms          , Ms          , Ms          , Ms          , Ms          , Ha^Fpa      , Ms          , Ha^Fpa      , Ms          , Ms          , Cha         , Cha         , 3 Kha       , Ms          , Ms          , Ms          , Ms          , Ms          , Ms          , Ms          , Ms          , Ms          , Ms          , Ha          , Ms          , Ms          , Ms          , Ms          , Ms          , Ms          , Ms          
Ms^Xm       , Ms^Xm       , Ms          , Ms          , Cha         , Ms          , Ms          , Ms          , Ms          , Ms          , Ms          , Ms          , Ha          , Ms          , Ms          , Ms          , Ms          , Ms          , Ha^Fpa      , Ha^Fpa      , Ha^Fpa      , Ha^Fpa      , Ms          , Ms          , Ms          , Ms          , Ms          , Ms          , Ms          , Ms          , Ms          , Ms          , Ha^Fpa      , Ms          , Ha          , Ha          , Ha^Voa      , Ha^Fpa      , Ha^Fpa      , Ha          , Ha^Fpa      , Ms          , Ms          , Ms          , Ms          , Ms          
Ms          , Ms          , Aa          , 1 Khr       , Ch          , Ms          , Ms          , Ha          , Ha          , Ha          , Ha          , Ms          , Ha          , Ha          , Ha^Voa      , Ha^Fpa      , Ms          , Ms          , Ms          , Ms          , Ms          , Ms          , Ms          , Ha^Fpa      , Ms          , Ms          , Ms          , Ms          , Ms          , Ms          , Ha^Fpa      , Ha^Fpa      , Ha^Fpa      , Ha^Fpa      , Ha^Fpa      , Ha^Fpa      , Aa          , Ha^Fpa      , Ha^Fpa      , Ha^Fpa      , Ha^Fpa      , Ha^Fpa      , Ha          , Ms          , Ms          , Ms          
Aa          , Aa          , Aa          , Ch          , Aa          , Cha         , Ai          , Ms          , Ms          , Ms          , Ms          , Ms          , Ms          , Ms          , Ha          , Ha^Fpa      , Ms          , Ms          , Ha^Fpa      , Ms          , Ms          , Ms          , Ha^Fpa      , Ms          , Ha^Fpa      , Ms          , Ms          , Ms          , Ms          , Ha^Fpa      , Ha^Fpa      , Ha^Fpa      , Ha^Fpa      , Ha^Fpa      , Aa^Fpa      , Aa          , Aa^Fpa      , Aa          , Aa          , Ai          , Aa^Fpa      , Ha^Fpa      , Ha^Fpa      , Ms          , Ms          , Ms          
Ms          , Aa          , Aa          , Aa          , Aa          , Ai          , Ms          , Aa^Vha      , Ms          , Ha          , Ms          , Ms          , Ms          , Ms          , Ha          , Ha^Fpa      , Ms          , Ha^Fpa      , Ha^Fpa      , Ha^Fpa      , Ms          , Ms          , Ha^Fpa      , Ms          , Ha^Fpa      , Ha^Fpa      , Ms          , Ms          , Ha^Fpa      , Ha^Fpa      , Ha^Fpa      , Ha^Fpa      , Aa          , Aa          , Aa^Fpa      , Aa^Fpa      , Aa^Fpa      , Aa^Fpa      , Ai          , Ai          , Aa^Fpa      , Ha          , Ha^Fpa      , Ms          , Ms          , Ms          
Ms^Xm       , Ms          , Ms          , Aa          , Aa          , Ai          , Ai          , Ms          , Ms          , Ms          , Ms          , Ms          , Ha^Fpa      , Ms          , Ms          , Ha          , Ms          , Ms          , Ms          , Ms          , Ms          , Ms          , Ha^Fpa      , Ha^Fpa      , Ha^Fpa      , Ha^Fpa      , Ms          , Ha          , Ha^Fpa      , Aa          , Aa          , Aa          , Aa^Fpa      , Aa^Fpa      , Aa^Fpa      , Aa^Fpa      , Aa^Fpa      , Aa^Fpa      , Ai          , Aa^Fpa      , Aa^Fpa      , Ha^Fpa      , Ha^Fpa      , Ms          , Ms          , Ms          
Ms^Xm       , Ms^Xm       , Ms          , Ha^Fpa      , Aa          , Aa          , Ai          , Ha^Fpa      , Ha^Fpa      , Ha^Fpa      , Ms          , Ha^Fpa      , Ha^Fpa      , Ha^Fpa      , Ha^Fpa      , Ha^Fpa      , Ha^Fpa      , Ms          , Ms          , Ms          , Ha^Fpa      , Ha^Fpa      , Ha^Fpa      , Ha^Fpa      , Ha^Fpa      , Ms          , Ha^Fpa      , Ha^Fpa      , Ha^Fpa      , Aa          , Aa^Es       , Aa          , Aa^Fpa      , Aa          , Aa^Fpa      , Aa^Fpa      , Wwg         , Ai          , Aa^Fpa      , Aa^Fpa      , Ha^Fpa      , Ha^Fpa      , Ms          , Ms          , Ms          , Ms          
Ms^Xm       , Ms^Xm       , Ms^Xm       , Ms          , Ha^Fpa      , Aa          , Aa          , Ai          , Ai          , Ha^Fpa      , Ha^Fpa      , Ms          , Ms          , Ha^Fpa      , Ha^Fpa      , Ha^Fpa      , Ha^Fpa      , Ha^Voa      , Ha          , Ms          , Ha^Fpa      , Ha^Fpa      , Aa          , Aa          , Ha^Fpa      , Ha^Fpa      , Aa          , Ha^Fpa      , Aa          , Aa          , Aa          , Aa          , Aa^Fpa      , Aa^Fpa      , Aa^Fpa      , Aa^Vha      , Ai          , Ai          , Aa^Fpa      , Aa^Fpa      , Ha^Vca      , Ha          , Ms          , Ha          , Ms          , Ms          
Ms^Xm       , Ms^Xm       , Ms^Xm       , Ms          , Ha^Fpa      , Aa^Vca      , Ha^Fpa      , Ha^Fpa      , Ha^Fpa      , Ai          , Wwg         , Ha^Fpa      , Aa          , Ms          , Aa          , Ha^Fpa      , Ha^Fpa      , Ha          , Ha          , Ha^Fpa      , Ha^Fpa      , Aa          , Aa          , Aa          , Aa          , Aa          , Aa^Fpa      , Aa^Fpa      , Aa^Fpa      , Aa^Fpa      , Aa^Fpa      , Aa^Fpa      , Aa^Fpa      , Aa          , Ai          , Ai          , Aa^Fpa      , Aa^Fpa      , Ha          , Ha          , Ha^Fpa      , Ms          , Ha          , Ms          , Ms          , Ms          
Ms^Xm       , Ms^Xm       , Ms          , Ms          , Ha^Fpa      , Ms          , Ms          , Ha^Fpa      , Ms          , Ha^Fpa      , Ha^Fpa      , Ai          , Ai          , Aa          , Aa          , Aa          , Aa^Fpa      , Aa^Voa      , Aa          , Ha          , Aa          , Ha^Fpa      , Aa          , Aa^Es       , Aa          , Aa          , Aa^Fpa      , Aa          , Aa^Fpa      , Aa^Fpa      , Aa^Fpa      , Aa          , Aa^Fpa      , Ai          , Aa^Fpa      , Aa^Fpa      , Aa^Fpa      , Aa^Fpa      , Ha^Fpa      , Ha^Fpa      , Ha^Fpa      , Ha^Fpa      , Ms          , Ms          , Ms          , Ms          
Ms^Xm       , Ms^Xm       , Ms          , Ms          , Ha^Fpa      , Ha^Fpa      , Ha^Fpa      , Ms          , Ms          , Ms          , Ha^Fpa      , Ha          , Ai          , Aa          , Aa^Fpa      , Aa^Fpa      , Aa^Fpa      , Aa          , Aa^Fpa      , Aa^Fpa      , Aa^Fpa      , Aa          , Aa          , Aa          , Aa^Fpa      , Aa^Fpa      , Aa^Fpa      , Aa^Fpa      , Aa          , Aa^Fpa      , Aa          , Aa^Fpa      , Ai          , Ai^Es       , Aa^Fpa      , Aa^Fpa      , Aa^Fpa      , Aa^Fpa      , Ha^Fpa      , Ha^Fpa      , Ha          , Ha          , Ms          , Ha          , Ms          , Ms          
Ms^Xm       , Ms^Xm       , Ms          , Ms          , Ha^Fpa      , Ha^Fpa      , Ms          , Ms          , Ms          , Ha^Fpa      , Ha^Fpa      , Ha^Fpa      , Aa^Vla      , Ai          , Aa          , Aa^Fpa      , Aa^Fpa      , Aa^Fpa      , Aa          , Aa^Fpa      , Aa          , Aa^Fpa      , Aa^Fpa      , Aa^Fpa      , Aa^Fpa      , Aa          , Aa          , Aa          , Aa          , Aa          , Aa          , Aa          , Ai          , Aa^Fpa      , Aa^Fpa      , Aa^Fpa      , Aa^Fpa      , Aa^Fpa      , Ha^Fpa      , Ha^Fpa      , Ms          , Ms          , Ha^Fpa      , Ha          , Ms          , Ms          
Ms^Xm       , Ms^Xm       , Ms          , Ha^Fpa      , Ha^Fpa      , Ha^Fpa      , Ms          , Ha^Fpa      , Ms          , Ha^Fpa      , Ha^Fpa      , Ha^Fpa      , Ha^Fpa      , Ai          , Ai          , Aa          , Aa          , Aa^Fpa      , Aa          , Aa          , Aa^Voa      , Aa          , Aa          , Aa          , Aa          , Aa^Fpa      , Aa          , Aa^Es       , Aa          , Aa^Vha      , Ai          , Ai          , Aa^Fpa      , Aa^Fpa      , Aa^Fpa      , Aa^Fpa      , Aa^Fpa      , Aa^Fpa      , Ha          , Ha^Fpa      , Ha^Fpa      , Ha^Fpa      , Ms          , Ha          , Ms          , Ms          
Ms^Xm       , Ms          , Ms          , Ms          , Ha^Fpa      , Ha^Fpa      , Ms          , Ms          , Ms          , Ha^Fpa      , Ha          , Ha^Fpa      , Ha^Fpa      , Ha^Fpa      , Ha^Fpa      , Ai          , Ai          , Aa^Fpa      , Aa^Fpa      , Aa          , Aa          , Aa          , Aa^Fpa      , Aa^Fpa      , Aa^Fpa      , Aa^Fpa      , Aa^Fpa      , Aa          , Ai^Es       , Ai          , Ai^Es       , Aa          , Aa^Fpa      , Aa          , Aa^Fpa      , Aa^Fpa      , Aa^Fpa      , Aa^Fpa      , Ha^Fpa      , Ha^Fpa      , Ha^Fpa      , Ha^Fpa      , Ms          , Ms          , Ms          , Ms          
Ms^Xm       , Ms^Xm       , Ms          , Ms          , Ms          , Ha^Fpa      , Ha^Fpa      , Ha^Fpa      , Ms          , Ha          , Ms          , Ms          , Ms          , Ha^Fpa      , Ha^Fpa      , Ha^Fpa      , Aa          , Ai          , Aa^Fpa      , Aa          , Aa          , Aa          , Aa^Fpa      , Aa          , Aa          , Aa^Fpa      , Aa^Fpa      , Aa          , Ai^Es       , Wwg         , Ai^Es       , Ai          , Ai          , Aa          , Aa^Fpa      , Aa^Fpa      , Ha          , Ha^Voa      , Ha^Fpa      , Ha          , Ms          , Ms          , Ms          , Ms          , Ms          , Ms          
Ms^Xm       , Ms^Xm       , Ms          , Ms          , Ms          , Ms          , Ms          , Ms          , Ms          , Ms          , Ha^Fpa      , Ms          , Ha          , Ms          , Ms          , Aa^Voa      , Aa          , Ai          , Ai^Es       , Aa^Fpa      , Aa^Fpa      , Aa^Fpa      , Aa^Fpa      , Aa^Fpa      , Aa^Fpa      , Aa^Fpa      , Aa          , Aa          , Ai          , Ai^Es       , Aa          , Aa^Fpa      , Ai          , Aa^Fpa      , Aa          , Aa          , Ha^Fpa      , Ha^Fpa      , Ms          , Ms          , Ms          , Ha          , Ms          , Ms          , Ms          , Ms          
Ms^Xm       , Ms^Xm       , Ms          , Ms          , Ha^Fpa      , Ms          , Ha^Voa      , Ms          , Ms          , Ha          , Ha^Fpa      , Ha          , Ha^Fpa      , Ms          , Ms          , Ms          , Aa          , Aa          , Aa^Fpa      , Ai          , Ai          , Aa^Fpa      , Aa          , Aa          , Aa          , Aa          , Ai          , Ai          , Aa          , Aa^Fpa      , Aa^Fpa      , Ai          , Ai          , Aa^Fpa      , Aa^Fpa      , Aa^Es       , Ai          , Ha^Fpa      , Ms          , Ms          , Ha^Fpa      , Ha^Fpa      , Ms          , Ms          , Ms          , Ms          
Ms^Xm       , Ms^Xm       , Ms          , Ms          , Ha^Fpa      , Ha^Fpa      , Ha^Fpa      , Ha^Fpa      , Ms          , Ms          , Ha          , Ha^Fpa      , Ha^Fpa      , Ms          , Ms          , Ms          , Aa          , Aa          , Aa          , Aa          , Aa          , Ai          , Ai          , Aa          , Aa          , Ai          , Ai          , Ai          , Aa          , Aa^Fpa      , Aa^Fpa      , Aa^Vha      , Aa          , Ai          , Ai          , Aa          , Ai          , Ai          , Ai^Es       , Ha^Fpa      , Ai          , Ai          , Ai          , Ms          , Ms          , Ms          
Ms^Xm       , Ms^Xm       , Ms          , Ms          , Ha          , Ha^Fpa      , Ha^Fpa      , Ha^Fpa      , Ms          , Ms          , Ms          , Ha          , Ha^Fpa      , Ha^Fpa      , Ha          , Ms          , Ms          , Aa^Es       , Aa          , Aa          , Aa^Fpa      , Aa^Fpa      , Aa          , Ai          , Aa^Voa      , Ai          , Aa          , Aa^Fpa      , Aa^Fpa      , Aa^Fpa      , Aa^Fpa      , Aa          , Aa^Fpa      , Aa^Fpa      , Aa^Fpa      , Ai          , Ha          , Ha^Fpa      , Ha^Fpa      , Ai          , Ms          , Ms          , Ai          , Ms          , Ms          , Ms          
Ms^Xm       , Ms^Xm       , Ms          , Ms          , Ha          , Ha^Fpa      , Ha^Fpa      , Ha          , Ms          , Ha          , Ms          , Ha          , Ha^Fpa      , Ha^Fpa      , Ha^Fpa      , Ha^Fpa      , Ms          , Ms          , Aa^Fpa      , Aa          , Aa^Fpa      , Aa          , Aa          , Ai          , Ai          , Ai          , Aa^Fpa      , Aa^Fpa      , Aa^Fpa      , Aa^Fpa      , Aa          , Aa^Fpa      , Aa^Fpa      , Aa^Fpa      , Aa^Fpa      , Aa          , Ha^Fpa      , Ha^Fpa      , Ms          , Ms          , Ai          , Ai          , Ms          , Ms          , Ms          , Ms          
Ms^Xm       , Ms          , Ms          , Ms          , Ha          , Ha          , Ha          , Ha^Fpa      , Ms          , Ms          , Ms          , Ms          , Ha          , Ha^Fpa      , Ha^Fpa      , Ha^Fpa      , Ha^Fpa      , Ms          , Aa^Fpa      , Aa^Fpa      , Aa^Fpa      , Aa^Fpa      , Aa          , Aa          , Ai          , Aa          , Aa^Fpa      , Aa          , Aa          , Aa          , Aa          , Aa^Fpa      , Aa^Fpa      , Aa^Fpa      , Aa^Fpa      , Aa          , Ha^Fpa      , Ha          , Ms          , Ai          , Ha^Fpa      , Ha^Voa      , Ms          , Ms          , Ms          , Ms          
Ms^Xm       , Ms          , Ha          , Ms          , Ms          , Ms          , Ms          , Ms          , Ms          , Ms          , Ha          , Ms          , Ms          , Ha^Fpa      , Ha^Fpa      , Ha^Fpa      , Ha^Fpa      , Ha^Fpa      , Aa          , Aa^Fpa      , Aa^Fpa      , Aa^Fpa      , Aa          , Ai          , Ai          , Aa^Fpa      , Aa          , Aa^Fpa      , Aa^Fpa      , Aa^Vla      , Aa^Fpa      , Aa^Fpa      , Aa^Fpa      , Aa^Fpa      , Ha^Fpa      , Ha^Fpa      , Ha          , Ms          , Ms          , Ai          , Ai          , Ha^Fpa      , Ms          , Ms          , Ms          , Ms          
Ms^Xm       , Ms          , Ha          , Ha^Fpa      , Ha^Fpa      , Ha^Fpa      , Ms          , Ms          , Ms          , Ms          , Ha          , Ha          , Ha          , Ha^Fpa      , Ha^Fpa      , Ha^Fpa      , Ha^Fpa      , Ha^Fpa      , Aa          , Aa          , Aa^Fpa      , Aa          , Ai          , Ai          , Aa^Fpa      , Aa^Fpa      , Aa^Fpa      , Aa^Fpa      , Aa^Fpa      , Aa^Fpa      , Aa          , Aa^Fpa      , Aa          , Ha^Voa      , Ha^Fpa      , Ha^Fpa      , Ms          , Ms          , Ha          , Ms          , Ms          , Ai          , Ms          , Ms          , Ms          , Ms          
Ms^Xm       , Ms          , Ms          , Ha^Fpa      , Ha^Voa      , Ms          , Ha          , Ha^Fpa      , Ha^Fpa      , Ms          , Ms          , Ha          , Ms          , Ha^Fpa      , Ha^Fpa      , Ha^Fpa      , Ha          , Aa          , Aa^Fpa      , Aa^Fpa      , Aa          , Aa          , Ai          , Wwg         , Aa          , Aa^Fpa      , Aa^Fpa      , Aa^Fpa      , Aa          , Aa^Fpa      , Aa^Fpa      , Aa^Fpa      , Ha^Fpa      , Ha^Fpa      , Ha          , Ms          , Ha          , Ms          , Ha^Fpa      , Ha^Fpa      , Ha^Fpa      , Ai          , Ai          , Ms          , Ai          , Ai          
Ms^Xm       , Ms^Xm       , Ms          , Ha          , Ms          , Ha^Fpa      , Ha          , Ms          , Ms          , Ha          , Ms          , Ms          , Ha          , Ha          , Ha^Fpa      , Ha          , Ha          , Aa^Fpa      , Aa          , Aa          , Aa          , Aa          , Ai          , Ai          , Aa^Fpa      , Aa^Fpa      , Aa          , Aa^Fpa      , Aa^Fpa      , Aa^Fpa      , Aa          , Aa          , Ha^Fpa      , Ha          , Ms          , Ms          , Ha          , Ha^Fpa      , Ha^Fpa      , Ha^Fpa      , Ha^Fpa      , Ms          , Ms          , Ai          , Ms          , Ms          
Ms^Xm       , Ms^Xm       , Ms          , Ms          , Ms          , Ms          , Ha^Fpa      , Ms          , Ms          , Ms          , Ms          , Ha          , Ha^Fpa      , Ha^Fpa      , Ha          , Ha          , Aa          , Aa^Fpa      , Aa^Fpa      , Aa^Es       , Aa          , Aa          , Ai          , Aa^Voa      , Aa          , Aa^Fpa      , Aa          , Aa^Fpa      , Aa^Fpa      , Aa          , Ha^Fpa      , Ha^Fpa      , Ha          , Ha          , Ha          , Ms          , Ms          , Ha^Fpa      , Ha^Fpa      , Ms          , Ha          , Ha^Fpa      , Ha          , Ms          , Ms          , Ms          
Ms^Xm       , Ms^Xm       , Ms^Xm       , Ms          , Ha          , Ms          , Ms          , Ms          , Ms          , Ha^Voa      , Ms          , Ha          , Ha          , Ha^Fpa      , Ha          , Aa^Voa      , Aa          , Aa          , Aa          , Aa^Fpa      , Aa          , Aa          , Ai          , Ai          , Aa          , Aa          , Aa^Fpa      , Aa^Fpa      , Aa^Fpa      , Aa          , Ha^Fpa      , Ha^Fpa      , Ms          , Ms          , Ms          , Ms          , Ms          , Ha          , Ms          , Ms          , Ha^Voa      , Ha^Fpa      , Ha          , Ms          , Ms^Xm       , Ms          
Ms^Xm       , Ms^Xm       , Ms          , Ms          , Ms          , Ha^Fpa      , Ha^Fpa      , Ms          , Ms          , Ha^Fpa      , Ha^Fpa      , Ms          , Ha          , Ha^Fpa      , Aa          , Aa          , Aa          , Aa          , Aa^Fpa      , Aa^Fpa      , Aa          , Aa          , Ai          , Ai^Es       , Aa          , Aa^Fpa      , Aa^Fpa      , Aa          , Aa^Fpa      , Aa          , Ha^Fpa      , Ha^Fpa      , Ms          , Ha          , Ha^Fpa      , Ha^Fpa      , Ha^Fpa      , Ms          , Ms          , Ms          , Ms          , Ha^Fpa      , Ha^Fpa      , Ms          , Ms^Xm       , Ms^Xm       
Ms^Xm       , Ms^Xm       , Ms          , Ms          , Ms          , Ms          , Ms          , Ms          , Ha^Voa      , Ha^Fpa      , Ha^Fpa      , Ms          , Ha          , Ha^Fpa      , Aa          , Aa          , Aa^Fpa      , Aa^Fpa      , Aa          , Aa          , Aa          , Ai          , Aa          , Aa^Fpa      , Aa          , Aa          , Aa^Fpa      , Aa          , Aa^Voa      , Aa          , Ha          , Ha^Fpa      , Ms          , Ms          , Ms          , Ha^Fpa      , Ha          , Ha^Fpa      , Ms          , Ms          , Ha          , Ha^Fpa      , Ha          , Ms          , Ms^Xm       , Ms^Xm       
Ms^Xm       , Ms          , Ms          , Ms          , Ms          , Ha          , Ms          , Ms          , Ms          , Ha^Fpa      , Ha^Fpa      , Ms          , Ha^Fpa      , Ha^Fpa      , Aa          , Aa^Fpa      , Aa^Fpa      , Aa^Fpa      , Aa          , Aa          , Ai          , Ai          , Aa          , Aa^Fpa      , Aa^Fpa      , Aa          , Aa^Fpa      , Aa          , Aa          , Aa          , Ha^Fpa      , Ha^Fpa      , Ms          , Ms          , Ha          , Ms          , Ms          , Ms          , Ms          , Ha          , Ha          , Ha^Fpa      , Ms^Xm       , Ms^Xm       , Ms^Xm       , Ms^Xm       
Ms^Xm       , Ms^Xm       , Ms          , Ms          , Ms          , Ms          , Ms          , Ms          , Ms          , Ha^Fpa      , Ha^Fpa      , Ha          , Ha^Fpa      , Aa          , Aa          , Aa^Fpa      , Aa^Fpa      , Aa          , Aa          , Aa          , Ai          , Aa          , Aa          , Aa^Fpa      , Aa^Fpa      , Aa^Fpa      , Aa^Fpa      , Aa          , Ha          , Ha^Fpa      , Ha          , Ms          , Ha          , Ms          , Ha^Fpa      , Ha^Voa      , Ms          , Ms          , Ms^Xm       , Ms^Xm       , Ms^Xm       , Ms^Xm       , Ms^Xm       , Ms^Xm       , Ms^Xm       , Ms^Xm       
Ms^Xm       , Ms^Xm       , Ms          , Ms          , Ms          , Ms          , Ms          , Ms          , Ms^Xm       , Ha          , Ms^Xm       , Ha          , Ms^Xm       , Aa^Voa      , Aa          , Aa^Fpa      , Aa^Fpa      , Aa^Fpa      , Aa          , Ai          , Ai          , Ai          , Cha         , Cha         , Cha         , Aa^Fpa      , Aa          , Aa          , Ms          , Ha          , Ms          , Ms          , Ha          , Ha^Fpa      , Ha^Fpa      , Ha^Fpa      , Ms          , Ha          , Ms^Xm       , Ms^Xm       , Ms^Xm       , Ms^Xm       , Ms^Xm       , Ms^Xm       , Ms^Xm       , Ms^Xm       
Ms^Xm       , Ms^Xm       , Ms^Xm       , Ms^Xm       , Ms^Xm       , Ms^Xm       , Ms^Xm       , Ms^Xm       , Ms^Xm       , Ms^Xm       , Ms^Xm       , Ms^Xm       , Ms^Xm       , Ms^Xm       , Ms^Xm       , Aa          , Aa          , Aa^Fpa      , Aa^Fpa      , Ai          , Ai          , Ai          , Cha         , 2 Kha       , Cha         , Cha         , Cha         , Ha          , Ms^Xm       , Ms          , Ms          , Ms          , Ms          , Ha          , Ms          , Ha          , Ms          , Ms^Xm       , Ms^Xm       , Ms^Xm       , Ms^Xm       , Ms^Xm       , Ms^Xm       , Ms^Xm       , Ms^Xm       , Ms^Xm       
Ms^Xm       , Ms^Xm       , Ms^Xm       , Ms^Xm       , Ms^Xm       , Ms^Xm       , Ms^Xm       , Ms^Xm       , Ms          , Ms^Xm       , Ha          , Ms^Xm       , Ms^Xm       , Ms^Xm       , Ms^Xm       , Ms^Xm       , Ms^Xm       , Aa          , Aa          , Aa          , Ai          , Ai          , Cha         , Cha         , Cha         , Cha         , Ms^Xm       , Ms^Xm       , Ms^Xm       , Ms^Xm       , Ms^Xm       , Ms^Xm       , Ms^Xm       , Ms^Xm       , Ms^Xm       , Ms^Xm       , Ms^Xm       , Ms^Xm       , Ms^Xm       , Ms^Xm       , Ms^Xm       , Ms^Xm       , Ms^Xm       , Ms^Xm       , Ms^Xm       , Ms^Xm       
