border_size=1
usage=map

Xos         , Xos         , Xos         , Xos         , Xos         , Xos         , Xos         , Xos         , Xos         , Xos         , Xos         , Xos         , Xos         , Xos         , Xos         , Xos         , Xos         , Xos         , Xos         , Xos         , Xos         , Xos         , Xos         , Xos         , Xos         , Xos         , Xos         , Xos         , Xos         , Xos         , Xos         , Xos         , Xos         , Xos         , Urb         , Urb         , Urb         , Urb         , Urb         , Urb         
Xos         , Xos         , Xos         , Xos         , Xos         , Xos         , Xos         , Xos         , Xos         , Xos         , Xos         , Xos         , Xos         , Xos         , Xos         , Xos         , Urb         , Urb         , Urb         , Xos         , Xos         , Xos         , Xos         , Xos         , Xos         , Xos         , Urb         , Xos         , Xos         , Xos         , Xos         , Xos         , Xos         , Urb         , Urb         , Urb         , Urb         , Urb         , Urb         , Urb         
Urb         , Xos         , Xos         , Xos         , Xos         , Xos         , Xos         , Xos         , Xos         , Xos         , Urb         , Xos         , Urb         , Urb         , Urb         , Urb         , Urb         , Urb         , Urb         , Urb         , Urb         , Urb         , Urb         , Xos         , Urb         , Urb         , Urb         , Urb         , Urb         , Xos         , Xos         , Xos         , Urb         , Urb         , Urb         , Urb         , 1 Urb       , Urb         , Urb         , Urb         
Urb         , Urb         , Urb         , Urb         , Urb         , Urb         , Urb         , Xos         , Urb         , Urb         , Urb         , Urb         , Urb         , Urb         , Urb         , Urb         , Urb         , Urb         , Urb         , Urb         , Urb         , Urb         , Urb         , Urb         , Xos         , Urb         , Urb         , Urb         , Urb         , Xos         , Xos         , Xos         , Xos         , Urb         , Urb         , Urb         , Urb         , Urb         , Urb         , Urb         
Urb         , Urb         , Urb         , Urb         , Urb         , Urb         , Urb         , Urb         , Urb         , Urb         , Urb         , Urb         , Urb         , Urb         , Urb         , Xos         , Xos         , Xos         , Urb         , Urb         , Urb         , Urb         , Urb         , Urb         , Xos         , Xos         , Xos         , Urb         , Urb         , Urb         , Urb         , Xos         , Xos         , Urb         , Urb         , Urb         , Urb         , Urb         , Xos         , Xos         
Urb         , Urb         , Urb         , Urb         , Urb         , Urb         , Urb         , Urb         , Urb         , Urb         , Urb         , Urb         , Urb         , Urb         , Xos         , Xos         , Xos         , Xos         , Urb         , Urb         , Urb         , Urb         , Xos         , Xos         , Xos         , Xos         , Xos         , Xos         , Urb         , Urb         , Urb         , Urb         , Urb         , Urb         , Urb         , Urb         , Xos         , Xos         , Xos         , Xos         
Urb         , Urb         , Urb         , Urb         , Urb         , Urb         , Xos         , Urb         , Xos         , Urb         , Urb         , Urb         , Urb         , Xos         , Urb         , Xos         , Urb         , Urb         , Urb         , Urb         , Urb         , Urb         , Urb         , Urb         , Urb         , Urb         , Urb         , Urb         , Urb         , Urb         , Urb         , Urb         , Urb         , Urb         , Urb         , Urb         , Urb         , Xos         , Xos         , Xos         
Xos         , Urb         , Urb         , Urb         , Urb         , Urb         , Xos         , Xos         , Xos         , Xos         , Urb         , Urb         , Urb         , Urb         , Urb         , Urb         , Urb         , Urb         , Urb         , Urb         , Urb         , Urb         , Urb         , Urb         , Urb         , Urb         , Xos         , Urb         , Urb         , Urb         , Xos         , Urb         , Urb         , Urb         , Urb         , Urb         , Xos         , Xos         , Xos         , Xos         
Xos         , Xos         , Xos         , Xos         , Xos         , Xos         , Xos         , Xos         , Xos         , Xos         , Urb         , Urb         , Urb         , Urb         , Urb         , Urb         , Urb         , Urb         , Urb         , Urb         , Urb         , Urb         , Urb         , Urb         , Urb         , Urb         , Urb         , Xos         , Xos         , Xos         , Xos         , Xos         , Urb         , Urb         , Urb         , Urb         , Xos         , Xos         , Xos         , Xos         
Xos         , Xos         , Xos         , Xos         , Xos         , Xos         , Xos         , Xos         , Urb         , Urb         , Urb         , Urb         , Urb         , Urb         , Urb         , Urb         , Urb         , Urb         , Xos         , Urb         , Urb         , Urb         , Urb         , Urb         , Urb         , Urb         , Urb         , Xos         , Xos         , Xos         , Xos         , Xos         , Urb         , Urb         , Urb         , Xos         , Xos         , Xos         , Xos         , Xos         
Xos         , Xos         , Xos         , Xos         , Xos         , Xos         , Urb         , Urb         , Urb         , Urb         , Urb         , Urb         , Urb         , Urb         , Urb         , Urb         , Xos         , Xos         , Xos         , Urb         , Ur          , Urb         , Xos         , Urb         , Xos         , Urb         , Urb         , Urb         , Urb         , Urb         , Urb         , Xos         , Urb         , Urb         , Urb         , Urb         , Xos         , Xos         , Xos         , Xos         
Xos         , Xos         , Xos         , Xos         , Xos         , Urb         , Urb         , Urb         , Urb         , Urb         , Xos         , Urb         , Urb         , Urb         , Xos         , Urb         , Urb         , Xos         , Uu          , Uu          , Ur          , Uu          , Uu          , Xos         , Xos         , Urb         , Urb         , Urb         , Urb         , Urb         , Urb         , Urb         , Urb         , Urb         , Urb         , Urb         , Xos         , Xos         , Xos         , Xos         
Xos         , Xos         , Xos         , Xos         , Urb         , Urb         , Urb         , Urb         , Xos         , Xos         , Xos         , Xos         , Xos         , Urb         , Xos         , Xos         , Ur          , Uu          , Xu          , Xu          , Ur          , Xu          , Xu          , Uu          , Ur          , Urb         , Urb         , Urb         , Xos         , Urb         , Urb         , Urb         , Urb         , Urb         , Urb         , Urb         , Urb         , Xos         , Xos         , Xos         
Xos         , Xos         , Xos         , Urb         , Urb         , Urb         , Urb         , Urb         , Xos         , Xos         , Xos         , Xos         , Urb         , Urb         , Urb         , Xos         , Uu          , Ur          , Ur          , Xu          , Cud         , Xu          , Ur          , Ur          , Uu          , Urb         , Urb         , Urb         , Xos         , Xos         , Urb         , Xos         , Xos         , Urb         , Urb         , Urb         , Urb         , Urb         , Xos         , Xos         
Xos         , Xos         , Urb         , Urb         , Urb         , Urb         , Urb         , Xos         , Xos         , Xos         , Xos         , Xos         , Urb         , Urb         , Urb         , Urb         , Uu          , Xu          , Xu          , Cud         , 2 Kud       , Cud         , Xu          , Xu          , Uu          , Urb         , Xos         , Xos         , Urb         , Urb         , Urb         , Urb         , Xos         , Urb         , Urb         , Urb         , Urb         , Xos         , Xos         , Xos         
Xos         , Xos         , Urb         , Urb         , Urb         , Urb         , Urb         , Urb         , Urb         , Urb         , Urb         , Urb         , Urb         , Urb         , Xos         , Urb         , Uu          , Xu          , Ur          , Cud         , Cud         , Cud         , Ur          , Xu          , Uu          , Xos         , Xos         , Urb         , Urb         , Urb         , Xos         , Xos         , Xos         , Urb         , Xos         , Urb         , Urb         , Urb         , Xos         , Xos         
Xos         , Xos         , Urb         , Urb         , Urb         , Urb         , Xos         , Urb         , Xos         , Urb         , Urb         , Urb         , Urb         , Urb         , Xos         , Xos         , Ur          , Ur          , Xu          , Cud         , Cud         , Cud         , Xu          , Ur          , Ur          , Xos         , Urb         , Urb         , Urb         , Urb         , Xos         , Xos         , Xos         , Xos         , Xos         , Xos         , Urb         , Urb         , Xos         , Xos         
Xos         , Xos         , Xos         , Urb         , Urb         , Urb         , Urb         , Xos         , Xos         , Xos         , Urb         , Urb         , Urb         , Urb         , Urb         , Xos         , Uu          , Xu          , Ur          , Cud         , Cud         , Cud         , Ur          , Xu          , Uu          , Urb         , Urb         , Urb         , Urb         , Xos         , Urb         , Xos         , Urb         , Xos         , Urb         , Urb         , Urb         , Xos         , Xos         , Xos         
Xos         , Xos         , Xos         , Urb         , Urb         , Urb         , Urb         , Xos         , Xos         , Xos         , Urb         , Urb         , Urb         , Urb         , Urb         , Xos         , Ur          , Ur          , Xu          , Xu          , Ur          , Xu          , Xu          , Ur          , Ur          , Urb         , Urb         , Urb         , Urb         , Urb         , Urb         , Urb         , Urb         , Urb         , Urb         , Urb         , Urb         , Xos         , Xos         , Xos         
Xos         , Xos         , Xos         , Xos         , Urb         , Urb         , Urb         , Urb         , Urb         , Xos         , Urb         , Urb         , Urb         , Urb         , Urb         , Urb         , Urb         , Uu          , Uu          , Xu          , Ur          , Xu          , Uu          , Uu          , Xos         , Xos         , Urb         , Urb         , Urb         , Urb         , Urb         , Urb         , Xos         , Urb         , Urb         , Urb         , Urb         , Xos         , Xos         , Xos         
Xos         , Xos         , Xos         , Xos         , Urb         , Urb         , Urb         , Urb         , Urb         , Urb         , Urb         , Urb         , Urb         , Urb         , Urb         , Urb         , Urb         , Xos         , Xos         , Uu          , Ur          , Uu          , Urb         , Xos         , Xos         , Xos         , Xos         , Urb         , Urb         , Urb         , Urb         , Xos         , Urb         , Urb         , Urb         , Urb         , Urb         , Xos         , Xos         , Xos         
Xos         , Xos         , Xos         , Xos         , Urb         , Urb         , Urb         , Urb         , Urb         , Urb         , Urb         , Urb         , Xos         , Urb         , Urb         , Urb         , Urb         , Xos         , Xos         , Xos         , Urb         , Urb         , Urb         , Urb         , Urb         , Urb         , Urb         , Urb         , Urb         , Urb         , Xos         , Xos         , Xos         , Urb         , Urb         , Urb         , Xos         , Xos         , Xos         , Xos         
Xos         , Xos         , Xos         , Xos         , Urb         , Urb         , Urb         , Urb         , Xos         , Xos         , Xos         , Xos         , Xos         , Urb         , Urb         , Urb         , Urb         , Urb         , Urb         , Xos         , Urb         , Urb         , Urb         , Xos         , Xos         , Urb         , Xos         , Urb         , Urb         , Urb         , Xos         , Xos         , Xos         , Urb         , Urb         , Urb         , Urb         , Xos         , Xos         , Xos         
Xos         , Xos         , Xos         , Urb         , Urb         , Urb         , Urb         , Urb         , Xos         , Xos         , Xos         , Xos         , Xos         , Xos         , Urb         , Urb         , Urb         , Urb         , Urb         , Urb         , Urb         , Urb         , Urb         , Urb         , Urb         , Xos         , Xos         , Xos         , Urb         , Urb         , Urb         , Xos         , Urb         , Urb         , Urb         , Urb         , Xos         , Xos         , Xos         , Xos         
Xos         , Xos         , Xos         , Urb         , Urb         , Urb         , Urb         , Urb         , Urb         , Xos         , Urb         , Urb         , Urb         , Urb         , Urb         , Urb         , Xos         , Xos         , Urb         , Urb         , Urb         , Urb         , Urb         , Urb         , Urb         , Xos         , Urb         , Xos         , Urb         , Urb         , Urb         , Urb         , Urb         , Urb         , Urb         , Xos         , Xos         , Xos         , Xos         , Xos         
Xos         , Xos         , Xos         , Urb         , Urb         , Urb         , Urb         , Urb         , Urb         , Urb         , Urb         , Urb         , Urb         , Urb         , Xos         , Xos         , Xos         , Xos         , Urb         , Urb         , Urb         , Urb         , Urb         , Xos         , Xos         , Urb         , Urb         , Urb         , Urb         , Urb         , Urb         , Urb         , Urb         , Urb         , Urb         , Urb         , Xos         , Xos         , Xos         , Xos         
Xos         , Xos         , Xos         , Xos         , Xos         , Urb         , Urb         , Urb         , Urb         , Urb         , Xos         , Urb         , Xos         , Xos         , Xos         , Xos         , Xos         , Urb         , Urb         , Urb         , Urb         , Urb         , Urb         , Xos         , Xos         , Urb         , Urb         , Urb         , Xos         , Xos         , Xos         , Urb         , Urb         , Urb         , Urb         , Urb         , Xos         , Xos         , Xos         , Xos         
Xos         , Xos         , Xos         , Xos         , Xos         , Xos         , Xos         , Urb         , Xos         , Xos         , Xos         , Xos         , Xos         , Xos         , Xos         , Xos         , Urb         , Urb         , Urb         , Urb         , Urb         , Urb         , Urb         , Xos         , Xos         , Xos         , Xos         , Xos         , Xos         , Xos         , Xos         , Xos         , Xos         , Urb         , Xos         , Xos         , Xos         , Xos         , Xos         , Xos         
Xos         , Xos         , Xos         , Xos         , Xos         , Xos         , Xos         , Xos         , Xos         , Xos         , Xos         , Xos         , Xos         , Xos         , Xos         , Xos         , Xos         , Urb         , Urb         , Urb         , Urb         , Urb         , Urb         , Urb         , Urb         , Xos         , Xos         , Xos         , Xos         , Xos         , Xos         , Xos         , Xos         , Xos         , Xos         , Xos         , Xos         , Xos         , Xos         , Xos         
