border_size=1
usage=map

Dd, Dd, Dd, Dd, Dd, Dd, Dd, Dd, Dd, Dd, Dd, Dd, Dd, Dd, Dd, Dd, Dd, Dd, Dd, Dd, Dd, Dd, Dd, Dd, Dd, Dd, Dd, Dd, Dd, Dd, Rd, Dd, Dd, Dd, Dd, Dd, Dd, Dd, Dd, Dd, Dd, Dd, Dd, Dd, Dd, Dd, Dd, Dd, Dd, Dd, Dd, Dd, Dd, Dd, Dd, Dd, Dd, Dd, Dd, Dd, Dd, Dd, Dd, Dd, Dd, Dd, Dd, Dd, Dd, Dd, Dd, Dd, Dd, Dd, Dd, Dd
Dd, Dd, Dd, Dd^Esd, Dd, Dd, Dd^Esd, Dd, Dd, Dd, Dd, Dd, Dd^Es, Dd, Dd, Dd, Dd, Dd, Dd, Dd, Dd, Dd, Dd^Es, Dd, Dd, Dd, Dd, Dd, Dd, Dd, Dd, Rd, Cdr, Cdr, Dd, Dd, Dd, Dd, Dd, Dd^Esd, Dd, Dd, Dd, Dd, Dd, Dd, Dd, Dd, Dd, Dd, Dd, Dd, Dd, Dd, Dd, Dd, Dd, Dd, Dd, Dd, Dd, Dd, Dd^Esd, Dd, Dd, Dd, Dd, Dd, Dd, Dd, Dd, Dd, Dd, Dd, Dd, Dd
Dd, Dd, Dd, Dd, Dd, Dd, Dd, Dd, Dd^Esd, Dd, Dd^Esd, Dd, Dd, Dd, Dd, Dd, Dd, Dd, Dd, Dd, Dd, Dd^Esd, Dd, Dd, Dd, Dd, Dd, Dd, Dd, Dd, Dd, Rd, 2 Kdr, Cdr, Cdr, Dd, Dd, Dd, Dd, Dd, Dd, Dd, Dd, Dd^Edp, Dd, Dd, Ds, Ds, Ds, Ds^Esd, Ds, Ds, Dd, Dd, Dd^Es, Dd, Dd, Dd^Edp, Dd, Dd, Dd, Dd, Dd, Dd, Dd, Dd, Dd, Dd, Dd, Dd, Dd, Dd^Esd, Dd^Esd, Dd, Dd, Dd
Dd, Dd, Dd^Edp, Dd, Dd, Dd, Dd, Dd, Dd, Dd^Esd, Dd, Dd, Dd, Dd^Edp, Dd, Dd, Dd, Dd, Dd, Dd, Dd^Esd, Dd^Esd, Dd, Dd, Dd, Dd, Dd, Dd^Esd, Dd^Esd, Dd, Dd, Rd, Rd, Cdr, Dd, Dd, Dd^Esd, Dd, Dd, Dd, Dd, Dd, Dd, Dd, Ds, Dd, Ds^Vdt, Ds, Ds, Ds^Es, Ds, Ds, Dd, Dd, Dd, Dd^Esd, Dd, Dd, Dd, Dd, Dd, Dd, Dd, Dd, Dd, Dd, Dd^Esd, Dd, Dd, Dd, Dd, Dd, Dd, Dd, Dd, Dd
Dd, Dd, Dd, Dd, Dd, Dd, Dd, Dd, Dd^Esd, Dd, Dd, Dd, Dd, Dd, Dd^Dc, Dd, Dd, Dd, Dd, Dd, Dd, Dd, Dd, Dd, Dd, Dd^Edp, Dd, Dd, Dd, Dd, Dd, Dd, Rd, Cdr, Dd, Dd, Dd, Dd, Dd, Dd, Dd^Esd, Dd, Dd, Ds, Ds, Ds, Ds^Esd, Ds, Ds, Ds, Ds, Ds, Dd, Dd, Dd, Dd, Dd, Dd^Es, Dd, Dd, Dd^Esd, Dd^Esd, Dd, Dd, Dd, Dd, Dd, Dd, Dd, Dd^Es, Dd, Dd, Dd^Edp, Dd, Dd, Dd
Dd, Dd, Dd, Dd, Dd, Dd, Dd, Dd, Dd^Esd, Dd, Dd, Dd, Dd, Dd, Dd, Dd, Dd, Dd^Esd, Dd, Dd, Dd, Dd, Dd, Dd, Dd, Dd, Dd, Dd, Dd, Dd, Dd, Dd, Rd, Dd, Dd, Dd, Dd, Dd^Es, Dd, Dd, Dd^Esd, Dd, Dd, Ds, Ds, Ds, Ds, Ds, Ds^Es, Ds, Ds, Dd, Dd, Dd, Dd, Dd, Dd, Dd, Dd, Dd, Dd, Dd^Esd, Dd, Dd, Dd, Dd, Dd, Dd, Dd, Dd, Dd, Dd, Dd^Esd, Dd, Dd, Dd
Dd, Dd, Dd^Es, Dd, Dd, Dd, Dd, Dd, Dd, Dd, Dd, Dd, Dd, Dd, Dd, Dd, Dd, Dd, Dd, Dd, Dd, Dd, Dd, Dd, Dd^Esd, Dd^Vdt, Dd^Es, Dd, Dd, Dd, Dd, Dd, Rd, Dd, Dd, Dd, Dd, Dd, Dd, Dd, Dd^Esd, Dd, Dd, Ds, Ds, Ds, Ds, Ds, Ds, Ds, Ds, Dd, Dd, Dd, Dd, Dd, Dd^Edp, Dd, Dd, Dd, Dd, Dd, Dd, Dd, Dd, Dd, Dd, Dd, Dd, Dd^Vdt, Dd, Dd, Dd^Esd, Dd, Dd, Dd
Dd, Dd, Dd, Dd^Esd, Dd, Dd, Dd, Dd, Dd, Dd^Es, Dd, Dd, Dd^Edp, Dd, Dd, Dd^Esd, Dd, Dd, Dd, Dd, Dd^Edp, Dd, Dd, Dd, Dd, Dd, Dd, Dd, Dd, Dd, Dd, Dd, Rd, Dd, Dd, Dd, Dd^Esd, Dd^Esd, Dd, Dd, Dd, Dd^Esd, Dd, Ds, Ds, Ds, Ds, Ds, Ds, Ds, Dd^Esd, Dd, Dd, Dd, Dd, Dd, Dd, Dd^Esd, Dd, Dd^Esd, Dd, Dd, Dd, Dd, Dd, Dd^Edp, Dd, Dd, Dd, Dd, Dd, Dd, Dd, Dd, Dd, Dd
Dd, Dd, Dd, Dd, Dd, Dd, Dd^Esd, Dd, Dd, Dd, Ds, Dd, Ds, Dd, Dd, Dd^Esd, Dd, Dd, Dd, Dd, Dd, Dd, Dd, Dd, Dd, Dd, Dd, Dd, Dd, Dd^Esd, Dd, Dd, Dd, Rd, Rd, Dd, Dd, Dd^Esd, Dd, Dd, Dd, Dd, Dd, Ds^Edp, Ds, Dd, Dd, Ds, Ds, Ds, Dd, Dd, Dd^Es, Dd, Dd, Dd, Dd, Dd, Dd, Dd, Dd, Dd, Dd^Es, Dd, Dd, Dd, Dd, Dd, Dd, Dd, Dd^Esd, Dd, Dd, Dd, Dd, Dd
Dd, Dd, Dd, Dd, Dd, Dd^Esd, Dd, Dd, Dd, Dd, Ds, Ds, Ds, Ds^Es, Ds, Dd, Dd^Es, Dd, Dd, Dd, Dd, Dd, Dd, Dd, Dd, Dd, Dd, Dd, Dd, Dd, Dd, Dd, Dd, Dd, Rd, Dd, Dd, Dd, Dd, Dd, Dd^Esd, Dd, Dd, Ds, Dd, Dd, Dd, Dd, Dd, Ds, Dd, Dd, Dd, Dd, Dd, Dd, Dd, Dd, Dd, Dd, Dd^Esd, Dd, Dd, Dd, Dd, Dd, Ds, Dd, Ds, Dd, Ds, Dd, Dd, Dd, Dd, Dd
Dd, Dd, Dd, Dd, Dd, Dd, Dd^Es, Dd, Dd, Dd, Ds^Esd, Ds, Ds, Ds, Ds^Esd, Ds, Ds, Ds, Ds, Ds, Dd^Esd, Dd, Dd, Dd, Dd, Dd^Esd, Dd, Dd, Dd, Dd^Edp, Dd, Dd, Dd, Dd^Es, Dd, Rd, Dd, Dd, Dd, Dd, Dd, Dd, Dd, Dd, Dd, Dd, Dd, Dd, Dd, Dd, Dd, Dd, Dd^Esd, Dd, Dd^Esd, Dd, Dd^Esd, Dd, Dd, Dd, Dd, Dd^Esd, Dd, Dd, Ds, Ds, Ds, Ds, Ds, Ds, Ds^Edp, Ds, Dd, Dd, Dd^Es, Dd
Dd, Dd, Dd, Dd, Dd, Dd, Dd, Dd, Dd^Esd, Dd, Ds, Ds, Ds, Ds, Ds, Ds, Ds, Ds, Ds, Ds, Dd, Dd^Esd, Dd, Dd, Dd, Dd, Dd, Dd, Dd, Dd, Dd, Dd, Dd, Dd, Dd, Rd, Dd, Dd, Dd, Dd, Dd, Dd, Dd, Dd, Dd, Dd, Dd, Dd, Dd^Es, Dd, Dd, Dd, Dd, Dd, Dd, Dd^Esd, Dd, Dd^Dc, Dd, Dd, Dd, Dd, Dd, Ds, Ds, Ds^Esd, Ds, Ds, Ds, Ds, Ds, Dd, Dd, Dd, Dd, Dd
Dd, Dd, Cdr, 3 Kdr, Cdr, Dd, Dd, Dd, Dd, Dd, Dd, Dd, Dd, Ds, Ds, Ds, Ds, Ds^Esd, Ds, Ds, Ds, Dd, Dd, Dd, Dd, Dd^Esd, Dd, Dd, Dd^Es, Dd, Dd^Edp, Dd^Esd, Dd, Dd, Cdr, Rd, Cdr, Dd, Cdr, Dd^Edp, Dd, Dd, Dd, Dd, Dd, Dd^Esd, Dd, Dd, Dd, Dd, Dd, Dd, Dd, Dd, Dd, Dd^Es, Dd, Dd, Dd, Dd, Dd^Edp, Dd, Dd, Ds, Ds^Esd, Ds, Ds, Ds, Ds^Es, Ds, Dd, Dd, Dd, Dd, Dd, Dd
Rd, Rd, Rd, Cdr, Cdr, Dd, Dd, Dd, Dd, Dd, Dd, Dd, Dd, Ds, Ds, Ds, Ds, Ds, Ds, Ds, Ds, Dd, Dd^Esd, Dd^Es, Dd, Dd, Dd^Edp, Dd, Dd, Dd, Dd, Dd, Cdr, Cdr, Dd^Edpp, Rd, Dd, Cdr, Dd, Dd, Dd^Edpp, Dd, Dd, Dd, Dd, Dd, Dd^Edp, Dd, Dd, Dd, Dd, Dd, Dd, Dd, Dd, Dd, Dd, Dd, Dd, Dd, Dd, Dd, Dd, Ds, Ds^Esd, Ds, Ds, Ds, Ds, Ds, Dd, Dd, Dd, Dd, Dd, Dd
Dd, Dd, Dd, Rd, Rd, Dd, Dd, Dd, Dd, Dd, Dd, Dd, Dd, Dd, Dd^Esd, Ds, Ds^Vdt, Ds, Ds, Ds, Ds, Dd, Dd, Dd, Dd, Dd, Dd, Dd, Dd^Ftp, Dd, Dd, Dd^Edp, Dd^Ftp, Dd^Edpp, Dd, Rd, Dd^Edpp, Dd^Ftp, Dd, Dd, Dd^Vdt, Dd, Dd^Ftp, Dd, Dd^Edpp, Dd^Edp, Dd, Dd, Dd, Dd, Dd^Edp, Dd, Dd, Dd, Dd, Dd, Dd, Dd^Esd, Dd, Dd, Dd^Es, Dd, Ds, Ds, Ds^Esd, Ds, Ds, Ds, Dd, Dd, Dd^Esd, Dd^Esd, Dd, Dd, Dd, Dd
Dd, Dd, Dd, Dd, Rd, Dd, Dd, Dd, Dd, Dd^Edp, Dd, Dd, Dd, Dd, Dd, Ds, Ds, Ds, Ds, Ds^Edp, Ds, Dd, Dd, Dd, Dd, Dd^Edpp, Dd, Dd^Ftp, Dd^Vdt, Dd^Edpp, Rd, Dd, Dd^Ftp, Dd^Vdt, Dd^Ftp, Rd, Rd, Dd^Edpp, Rd, Dd^Ftp, Rd, Dd^Ftp, Dd, Dd^Edpp, Dd, Dd, Dd^Edpp, Dd, Dd, Dd, Dd, Dd, Dd, Dd, Dd, Dd, Dd, Dd, Dd, Dd, Dd, Dd, Ds, Ds, Dd^Esd, Ds, Dd, Dd, Dd, Dd, Dd, Dd, Dd, Dd, Dd, Dd
Dd, Dd, Dd, Dd, Dd, Rd, Rd, Dd, Dd, Dd, Dd^Esd, Dd, Dd, Dd, Dd, Dd, Dd, Ds, Ds, Ds, Dd, Dd, Dd, Dd^Edp, Dd, Dd, Dd^Vdt, Dd^Ftp, Rd, Rd, Dd, Rd, Rd, Rd, Rd, Dd^Edpp, Rd, Rd, Dd^Ftp, Rd, Dd^Ftp, Rd, Rd, Dd^Vdt, Dd^Ftp, Dd, Dd^Edpp, Dd^Ftp, Dd, Dd^Edpp, Dd^Edpp, Dd, Dd, Dd, Dd, Dd, Dd, Dd, Dd, Dd, Dd, Dd, Dd, Ds, Dd, Dd, Dd, Dd, Dd, Dd, Dd, Dd, Dd^Vdt, Dd^Esd, Dd^Esd, Dd
Dd, Dd, Dd, Dd, Dd, Dd, Dd, Rd, Rd, Dd, Dd, Dd^Esd, Dd, Dd^Es, Dd, Dd^Esd, Dd, Dd, Dd, Ds, Dd, Dd, Dd, Dd, Dd^Edpp, Dd^Ftp, Rd, Rd, Dd^Ftp, Dd^Ftp, Dd^Ftp, Dd^Ftp, Dd^Ftp, Dd^Vda, Dd^Edpp, Rd, Rd, Dd^Edpp, Dd^Ftp, Dd, Dd^Vda, Dd^Ftp, Dd^Ftp, Rd, Rd, Dd, Dd^Vdt, Dd^Ftp, Dd^Ftp, Dd, Dd, Dd, Dd, Dd^Edp, Dd, Dd, Dd, Dd, Dd, Dd^Esd, Dd, Dd, Dd, Dd^Es, Dd, Dd, Dd, Dd, Dd, Dd^Edp, Dd, Dd, Dd, Dd^Esd, Dd, Dd
Dd, Dd, Dd, Dd, Dd, Dd^Esd, Dd, Dd, Dd, Rd, Rd, Dd, Dd, Dd, Dd, Dd, Dd, Dd, Dd, Dd, Dd, Dd, Dd, Dd^Vdt, Rd, Rd, Dd^Ftp, Dd^Ftp, Dd^Ftp, Dd^Edpp, Dd^Vda, Dd^Ftp, Dd^Edpp, Dd^Ftp, Dd^Ftp, Dd^Ftp, Rd, Dd^Ftp, Dd^Edpp, Dd, Dd^Edpp, Dd, Dd, Dd^Ftp, Dd^Ftp, Rd, Rd, Dd, Dd^Ftp, Dd, Dd^Ftp, Dd^Edpp, Dd, Dd^Edp, Dd, Dd, Dd^Edp, Dd, Dd, Dd, Dd, Dd, Dd, Dd, Dd, Dd, Dd, Dd^Esd, Dd^Esd, Dd, Dd, Dd, Dd, Dd^Es, Dd, Dd
Dd, Dd, Dd, Dd, Dd^Es, Dd^Es, Dd, Dd, Dd, Dd, Rd, Dd, Dd, Dd, Dd, Dd, Dd, Dd^Esd, Dd, Dd^Edp, Cdr, Dd, Dd^Ftp, Dd^Edpp, Rd, Dd, Dd^Vda, Dd^Ftp, Dd^Ftp, Dd^Edpp, Dd^Ftp, Dd, Dd^Ftp, Dd^Ftp, Dd^Edpp, Dd^Vda, Rd, Dd, Dd^Vda, Dd^Ftp, Dd, Dd^Ftp, Dd^Edpp, Dd, Dd^Edpp, Dd^Vda, Dd, Rd, Rd, Dd^Ftp, Dd^Ftp, Dd^Ftp, Dd^Ftp, Dd, Dd, Dd, Dd, Dd, Dd, Dd, Dd, Dd^Edp, Dd, Dd, Dd, Dd, Dd, Dd, Dd, Dd, Ds, Dd, Dd, Dd, Dd, Dd
Dd, Dd^Esd, Dd, Dd, Dd, Dd, Dd, Dd, Dd, Dd, Dd, Rd, Rd, Rd, Rd, Dd, Rd, Dd, Dd, Dd, Dd, Cdr, Dd, Dd, Rd, Dd, Dd, Dd^Edp, Dd^Ftp, Dd^Ftp, Dd^Edpp, Dd^Ftp, Cdr, Dd^Ftp, Cdr, Dd^Edpp, Rd, Dd, Gd^Ftp, Cdr, Cdr, Dd, Dd^Ftp, Dd^Ftp, Dd^Ftp, Dd, Dd, Dd^Ftp, Dd^Ftp, Rd, Rd, Dd^Vdt, Dd^Edpp, Dd, Dd, Dd^Edp, Dd, Dd, Dd, Dd, Dd, Dd, Dd, Dd, Dd, Dd, Dd, Dd, Ds, Dd, Ds^Esd, Dd^Esd, Dd, Dd, Dd, Dd
Dd, Dd, Dd, Dd, Dd^Edp, Dd, Dd, Dd, Dd, Dd, Dd, Dd, Dd, Dd, Dd, Rd, Dd, Rd, Rd, Dd, Rd, Cdr, Dd^Edpp, Dd^Ftp, Rd, Dd^Ftp, Dd^Ftp, Dd^Ftp, Dd^Ftp, Dd^Ftp, Cdr, Cdr, Gd^Ftp, Cdr, Gd^Ftp, Dd, Rd, Cdr, Rd, Gd^Ftp, Gd^Ftp, Cdr, Cdr, Dd^Ftp, Dd, Dd^Ftp, Dd^Edpp, Dd^Ftp, Dd^Edpp, Dd^Ftp, Rd, Dd, Dd, Dd, Dd^Ftp, Dd, Dd, Dd, Dd, Dd^Esd, Dd, Dd, Dd, Dd, Dd^Es, Dd, Dd, Dd, Ds^Esd, Ds, Ds, Dd^Esd, Dd, Dd, Dd, Dd
Dd, Dd, Dd, Dd, Dd, Dd, Dd, Dd^Esd, Dd, Dd, Dd^Es, Dd, Dd^Edp, Dd, Dd, Dd, Dd, Dd, Dd, Rd, Cdr, Rd, Rd, Dd^Vdt, Rd, Dd^Ftp, Dd, Dd^Edp, Cdr, Cdr, Gd^Ftp, Gd^Ftp, Rd, Gd^Ftp, Rd, Rd, Rd, Cdr, Kdr, Rd, Rd, Gd^Ftp, Gd^Ftp, Cdr, Dd, Dd^Vda, Dd^Edp, Dd^Ftp, Dd, Dd, Rd, Dd^Ftp, Dd^Vdt, Dd^Ftp, Dd^Ftp, Dd, Dd^Edp, Dd, Dd, Dd, Dd, Dd, Dd, Dd^Esd, Dd, Dd, Ds, Ds, Ds, Ds, Dd, Dd, Dd, Dd, Dd, Dd
Dd, Dd, Dd, Dd, Dd, Dd, Dd^Dc, Dd, Dd, Dd, Dd, Dd, Dd, Dd, Dd, Dd^Esd, Dd^Edp, Dd, Dd, Dd, Cdr, Dd^Vdt, Dd^Edpp, Rd, Rd, Dd^Ftp, Dd^Ftp, Dd^Vda, Rd, Gd^Ftp, Rd, Rd, Gd^Ftp, Rd, Dd^Vda, Dd, Gd, Cdr, Cdr, Dd, Dd^Vda, Rd, Rd, Cdr, Cdr, Dd^Ftp, Dd^Ftp, Dd, Dd^Edpp, Dd^Vda, Dd, Rd, Dd^Ftp, Dd^Edp, Dd^Ftp, Dd^Vdt, Dd^Edpp, Dd, Dd, Dd, Dd^Edp, Dd, Dd, Dd, Dd, Dd, Ds, Ds, Ds, Ds, Ds, Dd^Edp, Dd, Dd, Dd, Dd
Dd, Dd, Dd^Esd, Dd, Dd, Dd, Dd, Dd, Dd, Dd, Dd, Dd, Dd^Edp, Dd, Dd, Dd, Dd, Dd, Dd^Edpp, Dd^Edp, Cdr, Dd^Ftp, Rd, Rd, Dd, Rd, Rd, Rd, Cdr, Rd, Dd, Gd^Ftp, Dd^Edp, Dd, Gd^Ftp, Gd^Ftp, Gd, Gd^Ftp, Gd^Ftp, Gd^Ftp, Gd^Ftp, Dd, Rd, Gd^Ftp, Cdr, Dd^Ftp, Dd^Edp, Dd, Dd^Ftp, Dd^Edpp, Dd^Ftp, Rd, Rd, Dd^Ftp, Dd, Dd, Dd, Dd, Dd, Dd, Dd, Dd, Dd, Dd, Dd, Dd, Ds, Ds, Ds, Ds, Ds, Dd, Dd, Dd, Dd, Dd
Dd, Dd^Es, Dd, Dd, Dd, Dd, Dd^Vdt, Dd, Dd, Dd, Dd, Dd, Dd, Dd, Dd, Dd^Edp, Dd, Dd, Dd, Dd^Edpp, Rd, Rd, Dd, Dd, Dd^Ftp, Dd^Ftp, Dd^Vda, Rd, Rd, Cdr, 1 Kdr, Dd^Vda, Cdr, Gd^Ftp, Gd^Ftp, Gd^Ftp, Gs^Vdt, Gd^Ftp, Gs^Ii, Gd^Ftp, Gd^Ftp, Dd^Edp, Dd^Vda, Rd, Gd^Ftp, Cdr, Cdr, Dd, Dd^Vda, Dd^Ftp, Dd^Ftp, Dd, Dd^Edpp, Rd, Rd, Dd^Ftp, Dd^Edpp, Dd^Ftp, Dd, Dd, Dd^Esd, Dd, Dd, Dd, Dd, Dd, Dd, Ds, Ds, Ds, Ds, Ds^Esd, Dd, Dd, Dd, Dd
Dd, Dd, Dd, Dd, Dd, Dd, Dd, Dd, Dd^Esd, Dd, Dd, Dd, Dd, Dd, Dd, Dd, Dd, Dd, Dd^Ftp, Rd, Dd, Dd^Ftp, Dd, Dd^Edpp, Dd, Dd^Edpp, Dd^Ftp, Dd, Rd, Cdr, Cdr, Cdr, Gd^Ftp, Gd^Ftp, Gd^Ftp, Gd^Ftp, Gs^Ii, Gs^Ii, Wwt^Ii, Gs^Ii, Gs^Ii, Gs^Vdt, Gd^Ftp, Rd, Rd, Gd^Ftp, Gd^Ftp, Cdr, Cdr, Dd^Edpp, Dd^Ftp, Dd^Ftp, Dd^Ftp, Dd, Rd, Dd, Dd^Vdt, Dd^Edpp, Dd, Dd, Dd, Dd, Dd, Dd, Dd^Es, Dd^Es, Dd, Dd^Edp, Dd, Dd, Ds, Ds, Dd, Dd, Dd, Dd
Dd, Dd, Dd, Dd, Dd^Edp, Dd, Dd, Dd, Dd, Dd, Ds, Dd, Dd, Dd, Dd, Dd, Dd^Edp, Dd^Edpp, Dd^Ftp, Rd, Dd^Ftp, Dd^Edpp, Dd^Ftp, Dd^Ftp, Dd^Ftp, Dd^Ftp, Dd, Dd^Edp, Rd, Rd, Gd, Gd, Gd, Gd, Gd, Gd^Ftp, Gs^Ii, Wwt^Ii, Wwt^Ii, Wwt^Ii, Gs^Ii, Gd^Ftp, Gd^Ftp, Gd^Ftp, Gd^Ftp, Rd, Gd^Ftp, Gd^Ftp, Dd^Vda, Cdr, Dd, Dd^Ftp, Dd^Edpp, Dd, Dd, Rd, Dd^Ftp, Dd^Edpp, Dd^Edpp, Dd, Dd^Edp, Dd, Dd, Dd, Dd, Dd, Dd, Dd, Dd, Ds, Ds, Ds, Dd, Dd^Es, Dd, Dd
Dd, Dd, Dd, Dd, Dd, Dd, Dd, Ds, Ds, Dd, Ds, Dd^Esd, Dd, Dd, Dd, Dd, Dd, Dd, Rd, Rd, Rd, Dd^Vda, Dd, Dd^Ftp, Dd, Dd^Ftp, Dd, Cdr, Rd, Dd^Edp, Gd^Ftp, Gd^Ftp, Gd^Ftp, Gd, Gd^Ftp, Gs^Vdt, Gs^Ii, Wwt^Ii, Gs^Ii, Gs^Ii, Gd, Gs^Vdt, Gd, Gd^Ftp, Rd, Rd, Dd, Gd^Ftp, Gd^Ftp, Cdr, Dd, Dd^Ftp, Dd, Dd^Vda, Dd, Rd, Dd^Ftp, Dd, Dd^Vdt, Dd, Dd, Dd, Dd, Dd, Dd, Dd, Dd, Dd, Dd^Vdt, Ds, Dd, Ds, Dd^Esd, Dd, Dd, Dd
Dd, Dd, Dd, Dd, Dd^Esd, Dd, Dd, Ds, Ds, Ds, Ds^Edp, Dd, Dd, Dd, Dd, Dd, Dd, Dd^Edpp, Dd^Edpp, Dd^Vdt, Rd, Dd, Dd, Dd^Edpp, Dd, Dd^Edpp, Dd, Cdr, Rd, Dd^Vda, Dd, Gd^Ftp, Gd^Ftp, Gd^Ftp, Gd^Ftp, Gd^Ftp, Gd^Ftp, Gs^Ii, Gd^Ftp, Gd^Ftp, Gd^Ftp, Gd^Ftp, Gd^Ftp, Gd, Gd, Cdr, Cdr, Kdr, Gd^Ftp, Cdr, Dd^Vda, Dd^Edpp, Dd, Dd^Ftp, Dd^Ftp, Rd, Dd, Dd^Ftp, Dd, Dd^Edpp, Dd, Dd, Dd, Dd^Edp, Dd, Dd, Dd, Dd, Dd, Dd, Dd, Dd, Dd, Dd, Dd, Dd
Dd, Dd, Dd, Dd, Dd, Dd, Ds^Es, Ds, Ds, Ds, Ds, Dd, Dd, Dd^Edp, Dd, Dd, Dd, Dd, Dd, Dd, Dd^Ftp, Rd, Dd, Dd^Ftp, Dd, Dd^Vda, Dd, Cdr, Gd^Ftp, Rd, Dd^Vda, Gd^Ftp, Gd^Ftp, Gd^Ftp, Gd^Ftp, Gd^Ftp, Gd^Ftp, Gd, Gd, Gd^Ftp, Gd^Ftp, Gd^Ftp, Gd^Ftp, Gd^Ftp, Dd^Vda, Rd, Rd, Cdr, Cdr, Dd^Ftp, Dd^Ftp, Dd, Dd^Ftp, Dd^Edpp, Dd, Rd, Dd^Edpp, Dd^Ftp, Dd, Dd^Edpp, Dd, Dd, Dd, Dd, Dd, Dd, Dd, Dd^Esd, Dd^Es, Dd, Dd^Es, Dd, Dd, Dd, Dd, Dd
Dd, Dd, Dd, Dd, Dd, Dd, Ds, Ds, Ds, Ds, Dd, Dd, Dd, Dd, Dd, Dd, Dd^Es, Dd^Edpp, Dd, Dd^Ftp, Dd^Vdt, Rd, Dd^Edpp, Dd^Ftp, Dd, Dd, Dd^Edp, Cdr, Gd^Ftp, Rd, Rd, Dd, Dd, Gd^Ftp, Gd^Ftp, Gd^Ftp, Gd^Ftp, Gd^Ftp, Gd, Gd^Ftp, Gd^Ftp, Gd^Ftp, Gd^Ftp, Gd^Ftp, Dd^Edp, Gd^Ftp, Rd, Rd, Rd, Dd^Ftp, Dd^Ftp, Dd^Ftp, Dd^Edpp, Dd^Ftp, Dd, Rd, Dd^Vdt, Dd^Edp, Dd, Dd, Dd, Dd, Dd^Edp, Dd, Dd, Dd, Dd, Dd, Dd, Dd, Dd, Dd, Dd^Edp, Dd, Dd, Dd
Dd, Dd, Dd, Dd, Ds^Esd, Ds, Ds, Ds, Ds, Ds, Dd, Dd^Esd, Dd, Dd, Dd, Dd, Dd, Dd, Dd^Edpp, Dd, Dd^Ftp, Rd, Dd^Ftp, Dd, Dd^Edp, Dd^Ftp, Dd, Cdr, Gd^Ftp, Gd^Ftp, Rd, Gd^Ftp, Dd^Edp, Dd^Vda, Gd^Ftp, Dd, Rd, Rd, Cdr, Gd, Dd^Vda, Gd^Ftp, Dd^Edp, Dd, Dd^Vda, Gd^Ftp, Rd, Dd, Dd, Rd, Rd, Dd, Dd^Vda, Dd^Ftp, Rd, Rd, Dd^Ftp, Dd^Ftp, Dd^Edpp, Dd, Dd, Dd, Dd, Dd, Dd, Dd, Ds, Ds, Ds, Dd, Dd, Dd, Dd, Dd, Dd, Dd
Dd, Dd, Dd, Ds, Ds, Ds, Ds, Ds, Dd, Dd, Dd, Dd, Dd, Dd^Edp, Dd, Dd, Dd, Dd, Dd^Edpp, Dd^Edpp, Dd^Edp, Rd, Dd, Dd^Vda, Dd^Ftp, Dd, Dd, Cdr, Cdr, Gd^Ftp, Gd^Ftp, Rd, Rd, Rd, Rd, Gd^Ftp, Rd, Cdr, Kdr, Rd, Gd^Ftp, Gd^Ftp, Rd, Dd, Rd, Rd, Gd^Ftp, Cdr, Dd^Ftp, Dd^Edp, Dd, Rd, Rd, Rd, Dd^Ftp, Dd^Ftp, Dd, Dd^Vdt, Dd, Dd^Edpp, Dd, Dd, Dd, Dd, Dd, Dd^Esd, Dd, Ds, Ds, Dd, Dd, Dd, Dd, Dd, Dd^Esd, Dd
Dd, Dd, Ds, Ds, Ds, Ds^Edp, Ds, Dd, Dd, Dd^Es, Dd, Dd, Dd, Dd, Dd, Dd, Dd, Dd, Dd^Edpp, Dd^Edpp, Dd^Vdt, Rd, Dd, Dd^Ftp, Dd^Ftp, Dd^Ftp, Dd^Ftp, Dd^Edpp, Dd, Cdr, Cdr, Gd^Ftp, Gd^Ftp, Gd^Ftp, Gd^Ftp, Rd, Rd, Cdr, Cdr, Rd, Rd, Rd, Gd^Ftp, Rd, Gd^Ftp, Gd^Ftp, Cdr, Cdr, Dd^Edp, Dd^Ftp, Dd^Vda, Dd^Ftp, Rd, Rd, Rd, Dd^Edp, Dd, Dd^Ftp, Dd^Edp, Dd^Edp, Cdr, Dd^Edp, Dd, Dd, Dd, Dd, Dd, Ds, Ds, Ds, Ds, Dd, Dd, Dd, Dd^Es, Dd
Dd, Dd^Esd, Dd, Ds, Dd, Dd, Ds, Dd, Dd, Dd, Dd^Vdt, Dd, Dd, Dd, Dd, Dd, Dd^Esd, Dd, Dd, Dd^Edpp, Dd^Ftp, Rd, Dd^Ftp, Dd^Ftp, Dd^Vda, Dd, Dd^Edpp, Dd^Ftp, Dd^Vda, Dd^Ftp, Dd^Ftp, Cdr, Cdr, Gd^Ftp, Cdr, Gd^Ftp, Cdr, Gd^Ftp, Dd, Cdr, Rd, Gd^Ftp, Dd, Gd^Ftp, Cdr, Cdr, Dd, Dd, Dd^Ftp, Dd, Dd^Edpp, Dd, Rd, Dd, Dd, Rd, Rd, Dd^Edpp, Dd, Cdr, Dd, Dd, Dd, Dd, Dd, Dd^Es, Dd, Dd, Dd, Ds^Edp, Ds, Ds, Dd, Dd, Dd, Dd
Dd, Dd, Dd, Dd, Dd, Dd, Dd, Dd, Dd, Dd, Dd, Dd^Esd, Dd, Dd^Es, Dd, Dd, Dd, Dd, Dd^Edp, Dd^Edpp, Dd^Vdt, Rd, Dd^Ftp, Dd^Edpp, Dd^Ftp, Dd, Dd^Ftp, Dd, Dd^Ftp, Dd, Dd^Ftp, Dd^Edpp, Dd, Cdr, Dd^Ftp, Cdr, Dd^Ftp, Dd, Dd^Ftp, Dd, Rd, Dd, Dd^Edp, Cdr, Dd^Edpp, Dd^Ftp, Dd^Edpp, Dd^Vda, Dd, Dd^Ftp, Dd^Vda, Dd^Ftp, Rd, Dd^Ftp, Dd^Vdt, Dd^Edpp, Dd^Edpp, Rd, Rd, Cdr, Rd, Dd, Dd, Dd, Rd, Rd, Rd, Dd, Dd, Ds, Ds, Ds, Dd, Dd, Dd, Dd
Dd, Dd, Dd, Dd, Dd, Dd, Dd, Dd, Dd^Esd, Dd, Dd, Dd, Dd, Dd, Dd, Dd, Dd, Dd, Dd, Dd^Edpp, Dd, Rd, Rd, Dd, Rd, Dd^Ftp, Rd, Dd, Dd, Dd^Edpp, Dd^Ftp, Dd^Ftp, Dd^Ftp, Dd, Dd^Vda, Dd^Edpp, Dd^Ftp, Dd^Ftp, Dd^Edpp, Dd^Ftp, Dd^Ftp, Rd, Dd^Ftp, Dd, Dd^Vda, Dd^Ftp, Dd^Ftp, Dd, Dd^Edpp, Dd, Dd, Dd, Rd, Dd^Edpp, Dd, Dd^Edpp, Dd, Dd, Cdr, Rd, Dd, Rd, Rd, Rd, Dd, Dd, Dd, Rd, Rd, Ds, Dd, Dd, Cdr, Dd, Cdr, Dd
Dd, Dd, Dd, Dd^Esd, Dd, Dd, Dd, Dd, Dd, Dd, Dd, Dd, Dd, Dd, Dd, Dd^Edp, Dd, Dd, Dd, Dd^Edpp, Dd, Dd^Ftp, Dd^Edpp, Rd, Dd^Ftp, Rd, Dd^Vdt, Rd, Rd, Dd^Ftp, Dd, Dd^Edpp, Dd, Dd^Edpp, Dd^Ftp, Dd^Ftp, Dd, Dd^Vda, Rd, Dd^Ftp, Rd, Rd, Rd, Rd, Rd, Rd, Rd, Dd, Rd, Dd^Ftp, Rd, Rd, Dd^Vdt, Dd, Dd^Ftp, Dd, Dd, Cdr, Dd, Dd^Edp, Dd, Dd, Dd, Dd, Dd, Dd, Dd^Dc, Dd, Dd, Rd, Rd, Dd, Cdr, Cdr, Cdr, Dd
Dd, Dd, Dd, Dd, Dd, Dd^Es, Dd, Dd, Dd, Dd, Dd, Dd, Dd, Dd, Dd, Dd, Dd, Dd, Dd^Es, Dd, Dd, Dd^Edpp, Dd^Edpp, Dd^Ftp, Dd, Dd^Edp, Dd^Edp, Dd, Dd, Rd, Rd, Dd^Vda, Dd, Dd^Ftp, Dd, Dd^Edpp, Rd, Rd, Dd, Rd, Dd^Vdt, Rd, Dd, Dd^Edp, Dd^Ftp, Dd^Ftp, Dd^Vdt, Rd, Dd^Ftp, Rd, Dd^Ftp, Dd^Ftp, Dd^Edp, Dd^Ftp, Dd, Dd, Dd^Edp, Cdr, Dd, Dd, Dd, Dd, Dd, Dd, Dd^Es, Dd^Esd, Dd, Dd, Dd, Dd, Dd, Rd, Rd, 5 Kdr, Cdr, Dd
Dd, Dd, Dd, Dd, Dd, Dd, Dd, Dd, Dd, Dd, Dd, Dd, Dd^Edp, Dd, Dd, Dd^Esd, Dd, Dd, Dd, Dd, Dd, Dd, Dd, Dd, Dd^Edpp, Dd, Dd, Dd^Ftp, Dd^Edpp, Dd^Ftp, Dd^Vdt, Rd, Rd, Rd, Rd, Rd, Dd, Dd^Ftp, Dd^Ftp, Dd^Edp, Dd^Edpp, Rd, Rd, Dd, Dd, Dd^Edpp, Cdr, Dd^Ftp, Dd^Edpp, Dd, Dd^Ftp, Dd^Ftp, Dd^Edpp, Dd^Edp, Dd, Dd^Edp, Dd, Dd, Dd, Dd, Dd, Dd, Dd, Dd, Dd, Dd, Dd, Dd, Ds^Edp, Dd, Dd, Dd, Dd, Rd, Rd, Dd
Dd, Dd, Dd, Dd, Dd, Dd, Dd, Dd, Dd, Dd, Dd, Dd, Dd, Dd^Vdt, Dd, Dd, Dd^Edp, Dd, Dd, Dd^Esd, Dd, Dd^Edp, Dd, Dd, Dd, Dd, Dd^Edp, Dd, Dd, Ds^Edpp, Ds^Edpp, Dd^Edpp, Dd^Edp, Dd^Vdt, Dd^Edp, Dd^Edpp, Dd^Ftp, Dd, Dd^Edp, Dd^Ftp, Dd^Edp, Dd^Edp, Cdr, Rd, Cdr, Cdr, Dd^Edp, Dd^Edp, Dd, Dd, Dd^Ftp, Dd, Dd^Edpp, Dd, Dd, Dd, Dd, Dd, Dd, Dd, Dd, Dd, Dd, Dd, Dd, Dd, Dd, Ds, Ds, Ds, Dd, Dd, Dd, Dd, Dd, Rd
Dd, Dd, Dd, Dd, Dd, Dd, Dd^Esd, Dd, Dd, Dd, Dd, Dd, Ds, Ds, Dd, Dd, Dd, Dd, Dd, Dd, Dd, Dd, Dd, Dd, Dd, Dd^Edp, Dd, Dd, Dd, Ds, Ds, Ds, Ds, Dd^Edpp, Dd, Dd, Dd, Dd, Dd, Dd^Edp, Cdr, Cdr, Dd, Rd, Rd, Dd, Dd, Dd, Dd, Dd, Dd, Dd, Dd, Dd, Dd, Dd^Edp, Dd, Dd, Dd, Dd, Dd, Dd, Dd, Dd, Dd^Esd, Dd, Dd, Ds, Ds^Es, Ds, Ds, Dd, Dd, Dd, Dd, Dd
Dd, Dd, Dd^Esd, Dd, Dd, Dd, Dd, Dd, Dd, Dd, Dd, Ds, Ds, Ds^Esd, Dd, Dd, Dd, Dd, Dd, Dd, Dd, Dd, Dd, Dd, Dd^Vdt, Dd^Edp, Dd, Dd, Dd^Edp, Ds, Ds, Ds, Ds, Ds^Edpp, Dd, Dd, Dd, Dd^Edp, Dd, Dd, Dd, Dd, Dd^Edp, Dd, Rd, Dd, Dd, Dd^Edp, Dd, Dd^Edp, Dd, Dd, Dd^Edp, Dd, Dd, Dd, Dd, Dd, Dd, Dd, Dd, Dd, Dd, Dd, Dd^Edp, Dd, Dd, Ds, Ds, Ds, Ds, Ds^Esd, Dd, Dd, Dd, Dd
Dd, Dd, Dd, Dd, Dd, Dd, Dd, Dd, Ds, Ds, Ds, Ds, Ds, Ds, Dd, Dd, Dd, Dd^Es, Dd, Dd, Dd, Dd^Es, Dd, Dd, Dd, Dd, Dd, Dd, Dd, Dd, Ds, Ds, Ds, Ds, Ds, Dd, Dd, Dd, Dd, Dd, Dd, Dd, Dd^Es, Dd, Rd, Dd, Dd, Dd, Dd, Dd, Dd, Dd, Dd, Dd, Dd, Dd, Dd, Dd^Esd, Dd, Dd, Dd, Dd, Dd, Dd, Dd, Dd, Dd, Ds, Ds, Ds, Ds, Ds, Dd, Dd, Dd, Dd
Dd, Dd, Dd, Dd, Dd^Edp, Dd, Dd, Ds, Ds, Ds^Esd, Ds, Ds, Ds, Dd, Dd, Dd, Dd, Dd, Dd, Dd, Dd, Dd, Dd, Dd^Esd, Dd, Dd, Dd, Dd, Ds, Dd, Ds^Es, Ds, Ds^Esd, Ds, Ds^Edp, Dd, Dd, Dd, Dd, Dd, Dd, Dd, Dd, Dd, Rd, Dd, Dd, Dd^Esd, Dd, Dd, Dd, Dd, Dd, Dd, Dd, Dd, Dd, Dd, Dd, Dd, Dd, Dd, Dd^Es, Dd, Dd, Dd, Dd^Vdt, Ds, Dd, Ds, Ds, Ds, Dd, Dd, Dd^Esd, Dd
Dd, Dd, Dd, Dd, Dd, Dd, Ds, Ds, Ds, Ds, Ds, Ds, Ds, Dd, Dd, Dd, Dd, Dd, Dd^Esd, Dd, Dd, Dd, Dd, Dd, Dd, Dd, Dd^Esd, Dd, Dd, Ds, Ds, Ds, Ds, Ds, Ds, Ds, Ds, Dd^Vdt, Dd, Dd, Dd^Esd, Dd, Dd, Dd, Rd, Dd, Dd, Dd, Dd, Dd, Dd, Dd, Dd^Es, Dd, Dd, Dd, Dd, Dd, Dd, Ds, Ds, Dd, Dd, Dd, Dd, Dd, Dd, Dd, Dd, Dd, Dd, Dd, Dd^Es, Dd, Dd, Dd
Dd, Dd, Dd, Dd, Dd, Dd, Ds, Ds, Ds, Ds, Ds, Ds, Dd, Dd, Dd, Dd^Es, Dd, Dd, Dd, Dd, Dd, Dd, Dd, Dd, Dd, Dd, Dd, Dd, Dd, Ds, Ds, Ds, Ds, Ds, Ds, Ds, Ds^Es, Dd, Dd, Dd, Dd, Dd, Dd, Dd, Dd, Rd, Dd, Dd, Dd, Dd, Dd^Edp, Dd, Dd, Dd, Dd, Dd, Dd, Dd^Esd, Dd, Dd, Dd, Ds, Ds, Ds^Esd, Dd, Dd, Dd, Dd, Dd, Dd, Dd, Dd, Dd, Dd, Dd, Dd
Dd, Dd, Dd, Dd, Dd, Dd, Ds, Ds, Ds, Ds, Ds, Ds, Dd, Dd, Dd, Dd, Dd, Dd, Dd, Dd, Dd^Edp, Dd, Dd, Dd, Dd, Dd, Dd, Dd, Dd, Dd, Ds^Es, Ds, Ds^Edp, Ds, Ds, Ds, Dd^Esd, Ds, Dd, Dd^Edp, Dd, Dd, Dd, Dd, Dd, Rd, Rd, Dd, Dd, Dd, Dd, Dd, Dd, Dd, Dd^Esd, Dd, Dd, Dd, Dd, Dd, Ds, Ds, Ds, Ds, Ds, Dd, Dd^Es, Dd, Dd, Dd, Dd, Dd^Edp, Dd, Dd, Dd, Dd
Dd, Dd, Dd^Esd, Dd, Dd, Dd, Ds, Ds, Ds, Ds^Esd, Dd, Dd, Dd, Dd, Dd, Dd, Dd, Dd, Dd, Dd, Dd, Dd, Dd, Dd, Dd, Dd, Dd, Dd, Dd, Dd, Dd, Ds, Ds, Ds, Ds, Ds, Dd, Ds, Ds, Dd, Dd, Dd, Dd, Dd, Dd, Dd, Dd, Rd, Dd, Dd, Dd, Dd, Dd, Dd, Dd, Dd, Dd, Dd, Dd, Ds, Ds, Ds, Ds, Ds, Ds, Ds, Ds, Dd, Dd, Dd^Esd, Dd, Dd, Dd, Dd, Dd, Dd
Dd, Dd, Dd, Dd, Dd, Ds, Ds, Ds, Dd, Dd, Dd, Dd, Dd, Dd, Dd, Dd, Dd, Dd, Dd, Dd, Dd, Dd, Dd, Dd, Dd, Dd, Dd, Dd, Dd, Dd, Dd, Dd, Dd, Dd, Dd, Ds, Dd, Dd, Ds, Dd, Dd, Dd, Dd, Dd^Esd, Dd, Dd, Dd, Rd, Rd, Dd, Dd, Dd, Dd, Dd, Dd, Dd, Dd, Dd, Dd, Dd, Ds^Esd, Ds, Ds^Es, Ds, Ds, Ds, Ds, Dd, Dd^Esd, Dd, Dd, Dd, Dd, Dd, Dd^Esd, Dd
Dd, Dd, Dd, Dd, Dd, Dd, Dd^Esd, Dd, Dd, Dd, Dd, Dd^Edp, Dd, Dd, Dd, Dd, Dd, Dd^Es, Dd, Dd, Dd, Dd, Dd^Esd, Dd^Es, Dd, Dd, Dd^Vdt, Dd, Dd, Dd, Dd^Esd, Dd, Dd, Dd, Dd, Dd, Dd, Dd, Dd, Dd, Dd, Dd, Dd, Dd, Dd, Dd^Es, Dd, Dd, Rd, Dd, Dd, Dd^Esd, Dd, Dd, Dd, Dd, Dd, Dd^Es, Dd, Dd, Dd, Ds, Ds^Esd, Ds, Ds, Ds, Ds, Ds, Dd, Dd, Dd, Dd, Dd, Dd, Dd, Dd
Dd, Dd, Dd, Dd, Dd, Dd, Dd, Dd, Dd, Dd, Dd, Dd, Dd, Dd, Dd, Dd, Dd, Dd, Dd, Dd, Dd, Dd, Dd, Dd, Dd, Dd, Dd, Dd, Dd, Dd, Dd, Dd, Dd, Dd, Dd, Dd, Dd, Dd, Dd, Dd, Dd, Dd, Dd, Dd, Dd, Cdr, Cdr, Dd, Rd, Dd, Dd, Dd, Dd, Dd^Es, Dd, Dd, Dd^Esd, Dd, Dd, Dd, Dd, Ds, Ds, Ds, Ds, Dd, Dd, Dd, Dd, Dd, Dd, Dd, Dd, Dd, Dd, Dd
Dd, Dd^Esd, Dd, Dd, Dd, Dd, Dd, Dd, Dd^Esd, Dd, Dd, Dd, Dd, Dd, Dd^Esd, Dd, Dd, Dd, Dd, Dd, Dd, Dd, Dd, Dd, Dd, Dd, Dd, Dd^Es, Dd, Dd^Esd, Dd, Dd, Dd, Dd, Dd^Edp, Dd, Dd, Dd, Dd, Dd^Esd, Dd, Dd, Dd, Dd, Dd, Cdr, 4 Kdr, Cdr, Rd, Dd, Dd, Dd, Dd^Esd, Dd, Dd, Dd^Vdt, Dd, Dd, Dd, Dd, Dd, Dd, Dd, Ds, Ds, Ds, Dd, Dd, Dd, Dd, Dd, Dd, Dd, Dd, Dd, Dd
Dd, Dd, Dd, Dd, Dd, Dd, Dd, Dd, Dd, Dd, Dd, Dd, Dd, Dd, Dd^Es, Dd, Dd, Dd, Dd, Dd, Dd, Dd, Dd, Dd^Edp, Dd, Dd, Dd, Dd, Dd, Dd, Dd, Dd, Dd, Dd, Dd, Dd, Dd, Dd, Dd, Dd^Esd, Dd, Dd, Dd, Dd, Dd, Cdr, Cdr, Cdr, Rd, Dd, Dd, Dd, Dd, Dd, Dd, Dd, Dd, Dd, Dd, Dd, Dd^Edp, Dd, Dd, Dd, Dd, Dd, Dd, Dd, Dd^Esd, Dd, Dd, Dd, Dd, Dd, Dd, Dd
Dd, Dd, Dd^Edp, Dd, Dd, Dd, Dd, Dd, Dd, Dd, Dd, Dd, Dd, Dd, Dd, Dd, Dd, Dd^Esd, Dd, Dd, Dd, Dd, Dd, Dd, Dd, Dd, Dd, Dd, Dd, Dd, Dd, Dd, Dd, Dd, Dd, Dd, Dd, Dd, Dd, Dd, Dd, Dd, Dd, Dd, Dd, Dd, Rd, Rd, Dd, Dd, Dd, Dd, Dd, Dd, Dd, Dd, Dd, Dd, Dd, Dd, Dd, Dd, Dd, Dd, Dd, Dd, Dd, Dd, Dd, Dd, Dd, Dd, Dd, Dd, Dd, Dd
Dd, Dd, Dd, Dd, Dd, Dd, Dd, Dd, Dd, Dd, Dd, Dd, Dd, Dd, Dd, Dd, Dd, Dd, Dd, Dd, Dd, Dd, Dd, Dd, Dd, Dd, Dd, Dd, Dd, Dd, Dd, Dd, Dd, Dd, Dd, Dd, Dd, Dd, Dd, Dd, Dd, Dd, Dd, Dd, Dd, Dd, Rd, Dd, Dd, Dd, Dd, Dd, Dd, Dd, Dd, Dd^Esd, Dd, Dd, Dd, Dd, Dd, Dd, Dd, Dd, Dd, Dd, Dd, Dd, Dd, Dd, Dd, Dd, Dd, Dd, Dd, Dd
