border_size=1
usage=map

Mm          , Ww^Bw\      , Ww^Bw\      , Mm          , Mm          , Mm          , Mm          , Mm          , Mm          , Mm          , Mm          , Mm          , Mm          , Mm          , Mm          , Mm          , Mm          , Mm          , Mm          , Mm          , Mm          , Mm          , Mm          , Mm          , Mm          , Mm          , Mm          , Mm          , Mm          , Gg          , Mm          , Mm          , Mm          , Mm          , Mm          , Mm          , Mm^Xm       , Mm          , Mm          , Hh          , Ww          , Hh          , Rr          , Hh          , Hh^Vc       
Mm          , Mm          , Mm          , Ww^Bw|      , Mm          , Mm          , Mm          , Mm          , Mm          , Mm          , Mm          , Mm          , Mm^Xm       , Mm^Xm       , Mm          , Mm          , Mm          , Mm          , Mm          , Mm          , Mm          , Mm^Xm       , Mm          , Hh^Fms      , Hh^Fms      , Mm          , 7 Khr       , Mm          , Chr         , Mm          , Mm          , Mm          , Mm          , Hh^Vc       , Mm          , Mm          , Mm          , Mm^Xm       , Mm          , Mm          , Ww^Bw/      , Rr          , Cud         , Hh          , Hh          
Mm          , Mm          , Mm          , Ww^Bw\      , Rr          , Mm          , Mm          , Mm          , Mm          , Mm          , Mm          , Mm^Xm       , Mm          , Mm          , Mm          , Mm          , Mm          , Mm^Xm       , Mm          , Mm          , Mm          , Mm          , Mm          , Hh^Fms      , Hh^Fds      , Chr         , Chr         , Chr         , Hh^Fms      , Hh^Fds      , Hh^Fp       , Mm          , Mm          , Hh          , Mm          , Mm          , Mm          , Mm          , Ww^Bw/      , Ww^Bw/      , Cud         , Cud         , 5 Kud       , Cud         , Hh          
Hh^Fms      , Hh^Fms      , Ww          , Ww          , Rr          , Co          , Co          , Mm          , Mm          , Mm          , Mm          , Mm          , Mm          , Mm          , Mm          , Mm          , Mm          , Mm          , Mm          , Mm          , Mm          , Mm          , Hh^Fms      , Hh^Fds      , Hh^Fms      , Chr         , Hh^Fms      , Hh^Fms      , Gs^Fds      , Hh^Fms      , Hh^Vc       , Hh^Fms      , Rr          , Rr          , Rr          , Mm          , Rr          , Rr          , Ww          , Mm          , Mm          , Cud         , Cud         , Cud         , Hh          
Hh^Vc       , Hh^Fp       , Ww          , Hh^Fp       , Rr          , Co          , 4 Ko        , Co          , Mm          , Mm          , Mm          , Mm          , Mm          , Mm          , Mm          , Mm          , Mm          , Mm          , Mm          , Mm          , Mm          , Mm          , Hh^Fms      , Hh^Fms      , Gs^Fds      , Hh^Fms      , Gs^Fds      , Gs^Fms      , Gs^Fds      , Gs^Fds      , Rr          , Rr          , Chr         , Hh^Fms      , Hh^Fp       , Rr          , Mm          , Ww          , Mm          , Mm          , Mm          , Hh          , Hh          , Hh          , Hh          
Hh^Fds      , Hh^Fms      , Ww          , Hh^Fms      , Hh^Vc       , Rr          , Co          , Co          , Hh^Fms      , Mm          , Mm          , Mm          , Mm          , Mm          , Mm          , Mm          , Mm          , Mm          , Hh^Fms      , Mm          , Hh^Fms      , Hh^Fms      , Gs^Fds      , Gs^Fds      , Gs^Fds      , Gs^Fds      , Gs^Fds      , Gs^Fds      , Rr          , Rr          , Gs^Fds      , Chr         , 6 Khr       , Hh^Fms      , Hh^Fds      , Hh^Fms      , Ww          , Ww          , Mm          , Mm          , Mm^Xm       , Mm          , Mm          , Mm          , Mm          
Hh^Fms      , Hh^Fms      , Ww          , Hh^Fds      , Hh^Fms      , Rr          , Co          , Hh^Fms      , Hh^Fds      , Hh^Vc       , Hh^Fms      , Hh^Fms      , Hh^Fms      , Hh^Fms      , Hh^Vc       , Hh^Fms      , Hh^Fms      , Hh^Fms      , Hh^Fp       , Hh^Fms      , Hh^Fms      , Hh^Fms      , Gs^Fds      , Gs^Fms      , Gs^Fds      , Gs^Fds      , Rr          , Rr          , Re^Gvs      , Gs^Fms      , Gg^Ve       , Chr         , Gs^Fms      , Chr         , Ww          , Ww          , Hh^Fms      , Mm          , Mm          , Mm          , Mm          , Mm^Xm       , Mm          , Mm          , Mm          
Gs^Fms      , Gs^Fds      , Ww          , Gs^Fds      , Gs^Fds      , Rr          , Gs^Fms      , Hh^Fms      , Hh^Fms      , Hh^Fms      , Hh^Fms      , Hh^Fp       , Hh^Fms      , Hh^Fds      , Hh^Fms      , Hh^Fms      , Hh^Fms      , Hh^Fms      , Hh^Fms      , Hh^Fms      , Hh^Fms      , Hh^Fms      , Gs^Fms      , Gs^Fds      , Gg          , Gg          , Rr          , Re^Gvs      , Re^Gvs      , Gs^Fds      , Gs^Fds      , Gs^Fds      , Gs^Fds      , Gs^Fds      , Ww          , Hh^Fms      , Hh^Fms      , Mm          , Hh^Fms      , Mm          , Chr         , Mm          , Mm          , Mm          , Mm          
Gs^Fds      , Gs^Fds      , Ww          , Gs^Fms      , Gg          , Rr          , Gg          , Gs^Fds      , Gs^Fds      , Gs^Fds      , Gs^Fds      , Hh^Fds      , Hh^Fms      , Hh^Fms      , Hh^Fms      , Hh^Fms      , Hh^Fms      , Hh^Fms      , Hh^Fms      , Hh^Fms      , Hh^Fds      , Hh^Fms      , Gg          , Gg          , Gg          , Gg          , Rr          , Gg^Vh       , Re^Gvs      , Re^Gvs      , Gg          , Gs^Fds      , Ww          , Ww          , Gs^Fds      , Gs^Fds      , Hh^Fds      , Hh^Fms      , Hh^Vc       , Chr         , 8 Kh        , Chr         , Mm          , Mm          , Mm^Xm       
Gg          , Gs^Fds      , Ww          , Gg          , Gg          , Rr          , Rr          , Gg          , Gs^Fds      , Gs^Fms      , Gs^Fds      , Gs^Fds      , Gs^Fms      , Gs^Fds      , Gs^Fds      , Hh^Fds      , Hh^Fms      , Hh^Fms      , Hh^Vc       , Hh^Fms      , Hh^Fms      , Hh^Fms      , Re^Gvs      , Gg          , Gg          , Gg          , Rr          , Re^Gvs      , Gg          , Gg          , Ww          , Ww          , Gs^Fds      , Gs^Fds      , Gs^Fms      , Gs^Fds      , Gs^Fds      , Hh^Fms      , Hh^Fms      , Chr         , Chr         , Mm          , Mm          , Mm          , Mm^Xm       
Gg          , Gg          , Gg          , Ww          , Gg          , Gg          , Rr          , Gg          , Gg          , Gs^Fds      , Gs^Fds      , Gs^Fds      , Gs^Fds      , Gs^Fds      , Gs^Fds      , Gs^Fds      , Gs^Fds      , Hh^Fms      , Hh^Fms      , Hh^Fp       , Gs^Fds      , Re^Gvs      , Gg^Vh       , Re^Gvs      , Re^Gvs      , Rr          , Gg          , Gg          , Gs^Fds      , Ww          , Ww          , Gs^Fms      , Gs^Fds      , Gs^Fds      , Gs^Fds      , Gs^Fds      , Gs^Fds      , Gs^Fds      , Gs^Fds      , Hh^Fms      , Hh^Fms      , Hh^Fms      , Mm          , Mm          , Mm          
Gg          , Gg          , Gg          , Ww          , Ww          , Gg          , Gg          , Rr          , Gg          , Gg          , Gg          , Gs^Fds      , Gs^Fds      , Gs^Fds      , Gs^Fds      , Gs^Fms      , Gs^Fds      , Gs^Fds      , Hh^Fms      , Hh^Fms      , Gs^Fds      , Gs^Fds      , Re^Gvs      , Re^Gvs      , Re^Gvs      , Rr          , Ds          , Gg          , Ww          , Gs^Fds      , Ww          , Ww          , Ww          , Gs^Fds      , Gs^Fds      , Gs^Fds      , Gs^Fds      , Gs^Fds      , Hh^Fms      , Hh^Fms      , Hh^Fms      , Hh^Fms      , Hh^Fms      , Mm          , Mm          
Gg          , Re^Gvs      , Re^Gvs      , Gg          , Gg          , Ww          , Gg          , Rr          , Rr          , Gg          , Gg          , Gs^Fds      , Gs^Fds      , Gs^Fds      , Gs^Fds      , Gs^Fds      , Gg^Ve       , Gs^Fds      , Gs^Fds      , Gs^Fds      , Gg^Ve       , Gs^Fds      , Re^Gvs      , Re^Gvs      , Re^Gvs      , Rr          , Gs^Fds      , Ww          , Ds          , Ww          , Gs^Fms      , Ds          , Ww          , Gs^Fds      , Gs^Fds      , Gg^Ve       , Gs^Fds      , Gs^Fds      , Gs^Fds      , Hh^Fds      , Gs^Fds      , Hh^Fms      , Hh^Fms      , Mm          , Gs^Fds      
Re^Gvs      , Re^Gvs      , Re^Gvs      , Gg          , Gg          , Ww          , Ww          , Gg          , Gg          , Rr          , Gg          , Gs^Fds      , Ww          , Gs^Fms      , Gs^Fds      , Gs^Fds      , Gs^Fds      , Gs^Fds      , Gs^Fds      , Gs^Fds      , Gs^Fms      , Gs^Fds      , Gs^Fds      , Re^Gvs      , Rr          , Rr          , Gs^Fds      , Ww          , Ww          , Gs^Fds      , Gs^Fds      , Ds          , Ww          , Gs^Fds      , Gs^Fds      , Gs^Fds      , Gs^Fds      , Gs^Fds      , Gs^Fds      , Gs^Fds      , Gs^Fds      , Ds          , Ww          , Ds          , Gs^Fds      
Re^Gvs      , Re^Gvs      , Re^Gvs      , Gg^Vh       , Re^Gvs      , Gg          , Gg          , Ww          , Ww          , Rr          , Ww          , Ww          , Gs^Fds      , Ww          , Ww          , Gs^Fds      , Gs^Fds      , Gs^Fms      , Gs^Fds      , Gs^Fds      , Gs^Fds      , Gs^Fds      , Rr          , Rr          , Gg          , Gg          , Gs^Fds      , Gs^Fds      , Ww          , Gs^Fds      , Ww          , Ww          , Ds          , Gs^Fds      , Gs^Fds      , Gs^Fds      , Gs^Fms      , Gs^Fds      , Gs^Fds      , Gs^Fms      , Ww          , Ww          , Gs^Fds      , Ww          , Ww          
Gg          , Gg          , Gg          , Re^Gvs      , Re^Gvs      , Re^Gvs      , Gg^Vh       , Gg          , Gg          , Ww^Bsb|     , Rr          , Rr          , Rr          , Gs^Fms      , Gs^Fds      , Ww          , Ww          , Gs^Fds      , Rr          , Gs^Fds      , Rr          , Rr          , Gg          , Rr          , Rr          , Gg          , Gs^Fds      , Gs^Fms      , Ds          , Ww          , Ds          , Ww          , Ww          , Gs^Fds      , Gs^Fds      , Gs^Fms      , Gs^Fds      , Gs^Fds      , Ww          , Ww          , Hh^Fds      , Gs^Fds      , Hh^Vc       , Gs^Fms      , Hh^Fds      
Gg          , Gg          , Gg          , Re^Gvs      , Re^Gvs      , Re^Gvs      , Gg          , Gg          , Gg          , Rr          , Gg          , Gg          , Rr          , Gs^Fds      , Gs^Fds      , Gs^Fds      , Rr          , Ww^Bsb/     , Gg          , Rr          , Gs^Fds      , Gs^Fds      , Gg          , Gg          , Rr          , Gg          , Gs^Fds      , Gs^Fds      , Ww          , Ds          , Ww          , Ww          , Ww          , Gs^Fds      , Ww          , Gs^Fds      , Ww          , Ww          , Hh^Fds      , Gs^Fds      , Hh^Fds      , Hh^Fds      , Mm          , Hh^Fms      , Mm          
Gg          , Gg          , Gg          , Re^Gvs      , Gg          , Gg          , Gg          , 3 Gg        , Rr          , Rr          , Gg          , Gg          , Rr          , Gs^Fds      , Rr          , Rr          , Gg          , Ww          , Gg          , Gg          , Gg          , Gg          , Re^Gvs      , Rr          , Gg          , Gg          , Gg          , Gs^Fds      , Ww          , Ww          , Ds          , Ww          , Gs^Fds      , Ww          , Gs^Fds      , Ww          , Hh^Fds      , Gs^Fms      , Hh^Fds      , Hh^Fms      , Mm          , Mm          , Mm          , Mm          , Mm          
Re^Gvs      , Re^Gvs      , Gg          , Gg          , Gg          , Gg          , Rr          , Rr          , Gg          , Gg          , Gg          , Gg          , Rr          , Rr          , Gg          , Gg          , Gg          , Ww          , Ww          , Gg          , Gg          , Re^Gvs      , Rr          , Rr          , Re^Gvs      , Re^Gvs      , Re^Gvs      , Gs^Fds      , Ww          , Ww          , Gs^Fms      , Ds          , Gs^Fds      , Gg^Ve       , Gs^Fds      , Gs^Fds      , Hh^Fds      , Hh^Fms      , Mm          , Mm          , Mm          , Mm          , Ur          , Mm          , Mm          
Re^Gvs      , Re^Gvs      , Gg^Vh       , Gg          , Gg          , Rr          , Ch          , Rr          , Ch          , Ch          , Ch          , Gg          , Rr          , Gg          , Gg          , Gg          , Re^Gvs      , Gg          , Gg          , Ww          , Ww          , Re^Gvs      , Rr          , Gg^Vh       , Re^Gvs      , Re^Gvs      , Ww          , Ww          , Gg          , Gs^Fds      , Gs^Fds      , Gs^Fds      , Gs^Fds      , Gs^Fds      , Hh^Fds      , Hh^Fms      , Mm          , Mm          , Mm          , Mm          , Ur          , 2 Ur        , Ur          , Ur          , Mm          
Re^Gvs      , Re^Gvs      , Gg          , Gg          , Gg          , Rr          , Rp          , Rp          , Rp          , Rp^Vhc      , Rp          , Ch          , Ch          , Rr          , Re^Gvs      , Re^Gvs      , Re^Gvs      , Gg          , Gg          , Gg          , Gg          , Ww          , Rr          , Re^Gvs      , Re^Gvs      , Re^Gvs      , Ww          , Re^Gvs      , Re^Gvs      , Re^Gvs      , Gs^Fds      , Gs^Fds      , Gs^Fds      , Gs^Fds      , Hh^Fms      , Hh^Fds      , Mm          , Mm          , Mm          , Ur          , Ww          , Ww          , Ww          , Ur          , Ur          
Re^Gvs      , Re^Gvs      , Gg          , Gg          , Gg          , Ch          , Rp          , Rp^Vhc      , Ch          , Ch          , Rp          , Rp          , Ch          , Rr          , Gg          , Re^Gvs      , Re^Gvs      , Re^Gvs      , Gg          , Gg          , Gg          , Ww          , Rr          , Gg          , Ww          , Ww          , Re^Gvs      , Re^Gvs      , Re^Gvs      , Re^Gvs      , Gs^Fds      , Gs^Fds      , Gs^Fds      , Gs^Fds      , Hh^Fms      , Hh^Vc       , Mm          , Mm          , Ur          , Ur          , Ww          , Uu          , Ww          , Ur          , Ur          
Re^Gvs      , Gg          , Gg          , Gg          , Gg          , Ch          , Rp          , Ch          , Kh          , Ch          , Rp^Vhc      , Rp          , Ch          , Rr          , Gg          , Re^Gvs      , Gg          , Gg          , Re^Gvs      , Re^Gvs      , Re^Gvs      , Ww          , Ww          , Rr          , Ww^Bsb\     , Re^Gvs      , Gg^Vh       , Re^Gvs      , Re^Gvs      , Re^Gvs      , Gs^Fds      , Gs^Fds      , Gs^Fds      , Hh^Fds      , Mm          , Mm          , Mm          , Mm          , Mm          , Ur          , Ur          , Ww^Bw|      , Ur          , Ur          , Ur          
Gg          , Gg          , Gg          , Gg          , Rr          , Rr          , Rp^Vhc      , Ch          , Rp          , Rp          , Ch          , Ch          , Rr          , Rr          , Gg          , Gg          , Gg          , Gg          , Gg          , Gg^Vh       , Re^Gvs      , Re^Gvs      , Re^Gvs      , Ww          , Gg          , Rr          , Gg          , Gg          , Gg          , Gs^Fds      , Gs^Fds      , Gs^Fds      , Gs^Fds      , Hh^Fms      , Mm          , Mm          , Mm          , Mm          , Mm          , Ur          , Ur          , Ur          , Ur          , Ur          , Mm          
Gg          , Gg          , Gg          , Rr          , Gg          , Ch          , Rp          , Rp          , Rp^Vhc      , Rp          , Ch          , Rr          , Gs^Fds      , Gg          , Gs^Fds      , Gs^Fds      , Gs^Fds      , Gg          , Gs^Fds      , Re^Gvs      , Re^Gvs      , Re^Gvs      , Re^Gvs      , Ww          , Gg          , Rr          , Rr          , Gg          , Gg          , Gs^Fds      , Gs^Fds      , Gs^Fds      , Gs^Fds      , Hh^Fms      , Hh^Fds      , Mm          , Mm          , Mm          , Re          , Ur          , Ur          , Ur          , Ur          , Ur          , Mm          
Gs^Fds      , Gg          , Gg          , Rr          , Gg          , Ch          , Ch          , Rp          , Ch          , Ch          , Rr          , Rr          , Gs^Fds      , Gs^Fds      , Gs^Fds      , Gs^Fds      , Gs^Fds      , Gs^Fds      , Gs^Fds      , Gs^Fds      , Gs^Fds      , Re^Gvs      , Re^Gvs      , Ww          , Ww          , Gg          , Rr          , Gg          , Gg          , Gs^Fds      , Gs^Fds      , Gs^Fds      , Gg^Ve       , Gs^Fds      , Hh^Fds      , Hh^Fds      , Hh^Fds      , Re          , Mm          , Mm          , Mm          , Mm          , Mm          , Mm          , Mm          
Gs^Fds      , Gs^Fds      , Gg          , Rr          , Gg          , Gg          , Rr          , Ch          , Rr          , Rr          , Gs^Fds      , Gs^Fds      , Gs^Fds      , Gs^Fds      , Gs^Fds      , Gs^Fms      , Gs^Fds      , Gs^Fds      , Gs^Fds      , Gs^Fds      , Gs^Fds      , Gg          , Re^Gvs      , Re^Gvs      , Re^Gvs      , Ww          , Ww          , Rr          , Rr          , Gg          , Gs^Fds      , Gs^Fds      , Gs^Fds      , Gs^Fds      , Gs^Fds      , Hh^Fds      , Re          , Re          , Hh^Fms      , Mm          , Mm          , Mm          , Mm          , Mm          , Mm          
Gs^Fds      , Gs^Fds      , Gs^Fds      , Rr          , Rr          , Rr          , Gs^Fds      , Rr          , Gs^Fds      , Gs^Fds      , Gs^Fms      , Gs^Fds      , Gs^Fds      , Gg^Ve       , Gs^Fds      , Gs^Fds      , Gs^Fds      , Gs^Fds      , Gs^Fds      , Gs^Fds      , Gs^Fds      , Gs^Fds      , Gs^Fds      , Re^Gvs      , Re^Gvs      , Re^Gvs      , Ww          , Gg          , Rr          , Gg          , Gs^Fds      , Gs^Fds      , Gs^Fds      , Gs^Fds      , Re^Gvs      , Gs^Fds      , Re          , Hh^Fds      , Gg          , Gg          , Gg          , Mm          , Mm          , Mm          , Mm          
Hh^Fms      , Hh^Fms      , Hh^Fms      , Hh^Fms      , Hh^Fms      , Hh^Fms      , Hh^Fds      , Hh^Fms      , Hh^Fms      , Gs^Fds      , Hh^Fms      , Gs^Fds      , Hh^Fds      , Gs^Fds      , Gs^Fds      , Gs^Fds      , Gs^Fds      , Gs^Fds      , Gs^Fds      , Gs^Fds      , Gs^Fds      , Gs^Fds      , Gg^Ve       , Gs^Fds      , Gs^Fds      , Re^Gvs      , Gg^Vh       , Ww          , Re^Gvs      , Rr          , Rr          , Gs^Fds      , Gg          , Re^Gvs      , Re          , Re          , Gg          , Gg          , Gg          , Gg          , Gg          , Gg          , Gg          , Hh^Fms      , Hh^Fms      
Mm          , Hh^Fms      , Hh          , Hh          , Mm          , Hh^Vc       , Hh          , Hh^Fms      , Hh^Fms      , Hh^Fms      , Hh^Fds      , Hh^Fms      , Hh^Fms      , Hh^Fms      , Hh^Fms      , Hh^Fms      , Hh^Fms      , Gs^Fds      , Gs^Fds      , Gs^Fds      , Gs^Fds      , Gs^Fds      , Gs^Fds      , Gs^Fds      , Gs^Fds      , Gg          , Gg          , Ww          , Re^Gvs      , Re^Gvs      , Re^Gvs      , Rr          , Rr          , Re          , Gg          , Gg          , Gg          , Gg          , Gg          , Gg          , Re^Gvs      , Re^Gvs      , Re^Gvs      , Gg          , Gg          
Mm          , Mm          , Mm          , Hh          , Mm          , Mm          , Mm          , Mm          , Mm          , Hh^Fms      , Hh^Fms      , Hh^Fds      , Hh^Fms      , Hh^Fms      , Hh^Fms      , Hh^Fds      , Hh^Fms      , Hh^Fds      , Hh^Fms      , Gs^Fds      , Gs^Fds      , Gs^Fds      , Gs^Fds      , Gs^Fds      , Gs^Fds      , Gs^Fds      , Gs^Fds      , Ww          , Ww          , Re^Gvs      , Re^Gvs      , Gg^Vh       , Gg          , Rr          , Gg          , Gg          , Gg          , Gg          , Gg          , Gg          , Re^Gvs      , Gg^Vh       , Re^Gvs      , Gg          , Gg          
Mm          , Mm          , Mm          , Mm          , Mm          , Hh          , Mm          , Mm          , Mm          , Mm          , Mm          , Hh^Fms      , Hh^Fms      , Hh^Fds      , Hh^Fms      , Hh^Vc       , Hh^Fms      , Hh^Fds      , Hh^Fms      , Hh^Fms      , Hh^Fms      , Gs^Fds      , Gs^Fms      , Gs^Fds      , Gs^Fds      , Gs^Fds      , Gs^Fds      , Gs^Fds      , Gs^Fds      , Ww          , Ww          , Re^Gvs      , Gg          , Rr          , Rr          , Gg          , Gg          , Gg          , Gg          , Gg          , Re^Gvs      , Re^Gvs      , Re^Gvs      , Gg          , Gg          
Hh          , Mm          , Mm          , Mm          , Hh^Vc       , Mm          , Mm          , Mm          , Mm          , Mm          , Mm          , Hh          , Hh          , Hh^Fms      , Hh          , Hh^Fms      , Hh          , Hh^Fms      , Hh^Fms      , Hh^Fms      , Hh^Fms      , Hh^Fms      , Hh^Fds      , Gs^Fds      , Gs^Fds      , Gs^Fds      , Gs^Fds      , Gs^Fds      , Gs^Fds      , Gs^Fds      , Gs^Fds      , Ww          , Gg          , Gg          , Re^Gvs      , Ch          , 1 Kh        , Ch          , Gg          , Gg          , Gg          , Re^Gvs      , Gg          , Gg          , Gg          
Mm          , Mm          , Mm          , Mm          , Hh          , Mm          , Mm          , Mm          , Mm          , Mm          , Mm          , Mm          , Mm          , Mm          , Mm          , Mm          , Mm          , Mm          , Mm          , Mm          , Mm          , Hh          , Mm          , Gs^Fds      , Gs^Fds      , Gs^Fds      , Gs^Fms      , Gs^Fds      , Gs^Fds      , Gs^Fds      , Gs^Fds      , Ww          , Ww          , Ch          , Ch          , Ch          , Ch          , Ch          , Gg          , Gg          , Gg          , Gg          , Gg          , Gg          , Gg          
Mm          , Mm          , Mm          , Mm          , Mm          , Hh          , Mm          , Mm          , Mm          , Mm          , Mm          , Mm          , Mm          , Hh^Vc       , Hh          , Mm          , Mm          , Mm          , Mm          , Hh          , Mm          , Mm          , Hh          , Gs^Fds      , Gs^Fds      , Gs^Fds      , Gs^Fds      , Gs^Fds      , Gs^Fds      , Gg^Ve       , Gs^Fds      , Gs^Fds      , Gs^Fds      , Ww          , Ww          , Ch          , Ch          , Ch          , Gg          , Gg          , Gg          , Gg          , Gg          , Gg          , Gg          
Mm          , Mm          , Mm          , Mm          , Hh          , Hh          , Hh          , Hh          , Hh          , Mm          , Hh          , Mm          , Mm          , Mm          , Mm          , Mm          , Mm          , Mm          , Mm          , Mm          , Mm          , Mm          , Mm          , Gs^Fds      , Gs^Fds      , Gs^Fds      , Gs^Fds      , Gs^Fds      , Gs^Fds      , Gs^Fds      , Gs^Fds      , Gs^Fds      , Gs^Fds      , Gs^Fds      , Gs^Fds      , Ww          , Gg          , Rr          , Rr          , Gg          , Gg          , Gg          , Gg          , Gg          , Gg          
