border_size=1
usage=map

Xu          , Xu          , Mm^Xm       , Mm^Xm       , Mm^Xm       , Mm^Xm       , Mm^Xm       , Mm^Xm       , Mm^Xm       , Mm^Xm       , Mm^Xm       , Mm^Xm       , Mm^Xm       , Mm^Xm       , Mm^Xm       , Mm^Xm       , Mm^Xm       , Mm^Xm       , Mm^Xm       , Mm^Xm       , Mm^Xm       , Mm^Xm       , Mm^Xm       , Mm^Xm       , Mm^Xm       , Mm^Xm       , Mm^Xm       , Mm^Xm       , Mm^Xm       , Mm^Xm       , Mm^Xm       , Mm^Xm       , Mm^Xm       , Mm^Xm       , Mm^Xm       , Mm^Xm       , Mm^Xm       , Mm^Xm       , Mm^Xm       , Mm^Xm       , Mm^Xm       , Mm^Xm       , Mm^Xm       , Mm^Xm       , Mm^Xm       , Mm^Xm       
Xu          , Xu          , Uh          , Hh          , Hh          , Mm^Xm       , Mm          , Mm          , Mm          , Mm          , Mm          , Mm          , Mm          , Mm^Xm       , Mm          , Mm          , Mm          , Mm          , Mm          , Mm^Xm       , Mm          , Mm          , Mm          , Mm          , Mm          , Mm^Xm       , Mm          , Mm          , Mm          , Mm^Xm       , Mm          , Mm^Xm       , Mm          , Mm          , Mm          , Mm          , Hh          , Mm          , Mm          , Mm          , Mm          , Mm          , Mm          , Mm          , Mm          , Mm^Xm       
Xu          , Xu          , Uh          , Hh          , Hh          , Hh          , Mm          , Mm          , Mm          , Mm          , Mm          , Mm          , Hh          , Hh          , Hh          , Hh          , Hh          , Hh          , Hh          , Hh          , Hh          , Hh          , Hh          , Mm          , Mm          , Mm          , Mm          , Mm          , Mm          , Mm          , Mm          , Mm          , Mm          , Mm          , Hh          , Hh          , Ch          , Ch          , 3 Kh        , Mm          , Mm          , Mm          , Mm          , Mm          , Mm^Xm       , Mm^Xm       
Xu          , Xu          , Uh          , Uh          , Uh          , Hh          , Hh          , Hh          , Hh          , Mm          , Hh          , Mm          , Hh          , Hh          , Hh          , Hh          , Hh          , Hh          , Hh          , Hh          , Hh          , Hh          , Hh          , Mm          , Mm          , Hh          , Hh          , Mm          , Hh          , Hh          , Hh          , Hh          , Hh          , Hh          , Hh          , Hh          , Hh          , Ch          , Ch          , Ch          , Hh          , Mm          , Mm          , Mm          , Mm          , Mm^Xm       
Xu          , Uh          , Uh          , Uh          , Uu^Uf       , Ur          , Ur          , Hh          , Hh          , Hh          , Hh          , Hh          , Gg^Efm      , Gg^Efm      , Gg^Efm      , Hh          , Hh          , Hh          , Hh          , Hh          , Gg          , Hh          , Gg          , Hh          , Hh          , Hh          , Hh          , Hh          , Hh          , Hh          , Hh          , Hh          , Hh          , Hh          , Hh          , Hh          , Hh          , Hh          , Hh          , Hh          , Hh          , Hh          , Mm          , Mm          , Mm^Xm       , Mm^Xm       
Xu          , Uh          , Uh          , Uh          , Ur          , Ur          , Ur          , Gg          , Gg^Efm      , Gg^Efm      , Gg          , Hh          , Gg^Efm      , Gg^Efm      , Gg^Efm      , Hh          , Gg          , Gg          , Gg          , Gg          , Gg          , Gg          , Gg          , Gg          , Hh          , Hh          , Hh          , Hh          , Hh          , Hh          , Gg          , Hh          , Hh          , Hh          , Hh          , Hh          , Hh          , Hh          , Hh          , Hh          , Hh          , Hh          , Mm          , Mm          , Mm          , Mm^Xm       
Xu          , Uh          , Uh          , Uh          , Ur          , Ur          , Uu          , Gg          , Gg          , Gg^Efm      , Gg          , Gg          , Gg          , Gg          , Gg          , Gg          , Gg          , Gg          , Gg          , Gg          , Gg          , Gg          , Gg^Efm      , Gg          , Gg          , Gg          , Gg          , Gg          , Gg^Efm      , Gg          , Gg          , Gg          , Gg^Efm      , Gg^Efm      , Gg          , Gg          , Gg          , Hh          , Hh          , Hh          , Hh          , Hh          , Hh          , Mm          , Mm          , Mm^Xm       
Xu          , Uh          , Uh          , Ur          , Ur          , Ur          , Uu^Uf       , Ur          , Gg          , Gg          , Gg^Efm      , Gg          , Gg^Efm      , Gg          , Gg          , Gg          , Gg          , Gg          , Gg          , Gg^Efm      , Gg          , Gg          , Gg^Efm      , Gg          , Gg          , Gg          , Gg^Efm      , Gg          , Gg^Efm      , Gg          , Gg          , Gg          , Gg          , Gg          , Gg          , Gg^Efm      , Gg          , Gg          , Hh          , Hh          , Hh          , Hh          , Hh          , Hh          , Mm^Xm       , Mm^Xm       
Xu          , Xu          , Uh          , Ur          , Uu^Uf       , Ur          , Ur          , Ur          , Gg          , Gg          , Gg^Efm      , Gg          , Gg^Efm      , Gg          , Gg          , Gg          , Gg          , Gg          , Gg          , Gg^Efm      , Gg          , Gg          , Gg          , Gg          , Gg          , Gg          , Gg^Efm      , Gg          , Gg          , Gg          , Gg          , Gg          , Gg          , Gg          , Gg          , Gg^Efm      , Gg^Efm      , Gg          , Gg          , Hh          , Hh          , Hh          , Hh          , Hh          , Mm^Xm       , Mm^Xm       
Xu          , Xu          , Uh          , Ur          , Ur          , Ur          , Ur          , Ur          , Gg          , Gg          , Gg^Efm      , Gg          , Gg          , Gg          , Gg          , Gg          , Gg          , Gg          , Gg          , Gg          , Gg          , Gg          , Gg          , Gg          , Gg          , Gg          , Gg          , Gg          , Gg^Efm      , Gg          , Gg          , Gg          , Gg          , Gg          , Gg^Efm      , Gg^Efm      , Gg          , Gg          , Hh          , Hh          , Hh          , Hh          , Hh          , Hh          , Mm          , Mm^Xm       
Xu          , Uh          , Ur          , Ur          , Uu          , Uu          , Ur          , Gg          , Gg          , Gg          , Gg          , Gg          , Gg          , Gg          , Gg          , Gg          , Gg          , Gg          , Gg          , Gg          , Gg          , Gg          , Gg          , Gg          , Gg          , Gg          , Gg          , Gg          , Gg          , Gg          , Gg          , Gg          , Gg          , Gg^Efm      , Gg          , Gg          , Gg          , Hh          , Hh          , Hh          , Hh          , Hh          , Hh          , Hh          , Mm          , Mm^Xm       
Xu          , Uh          , Ur          , Ur          , Uu          , Ur          , Ur          , Gg          , Gg          , Gg          , Gg          , Gg          , Gg          , Gg          , Gg          , Gg          , Gg^Efm      , Gg^Efm      , Gg          , Gg          , Gg          , Gg          , Gg          , Gg          , Gg          , Gg^Efm      , Gg^Efm      , Gg          , Gg          , Gg          , Gg          , Gg          , Gg          , Gg          , Gg          , Gg          , Hh          , Hh          , Hh          , Hh          , Hh          , Hh          , Hh          , Hh          , Mm          , Mm^Xm       
Xu          , Xu          , Uu^Uf       , Ur          , Uu          , Ur          , Uu          , Gg          , Gg          , Gg          , Gg          , Gg^Efm      , Gg          , Gg          , Gg          , Gg          , Gg          , Gg          , Gg          , Gg          , Gg^Efm      , Gg          , Gg          , Gg          , Gg          , Gg^Efm      , Gg          , Gg          , Gg          , Gg          , Gg          , Gg          , Gg          , Gg          , Hh          , Hh          , Hh          , Hh          , Hh          , Hh          , Hh          , Hh          , Mm          , Mm          , Mm^Xm       , Mm^Xm       
Xu          , Uh          , Uu^Uf       , Uu^Uf       , Ur          , Ur          , Ur          , Gg          , Gg          , Gg          , Gg          , Gg          , Gg          , Gg          , Gg          , Gg^Efm      , Gg          , Gg          , Gg          , Gg          , Gg          , Gg^Efm      , Gg^Efm      , Gg          , Gg          , Gg          , Gg          , Gg          , Gg          , Gg^Efm      , Gg^Efm      , Gg          , Gg          , Gg          , Hh          , Hh          , Mm          , Hh          , Mm          , Mm          , Mm          , Mm          , Mm          , Mm          , Mm          , Mm^Xm       
Xu          , Uh          , Uh          , Ur          , Uu          , Ur          , Ur          , Uu          , Gg          , Gg          , Gg          , Gg          , Gg          , Gg          , Gg          , Gg          , Gg          , Gg          , Gg          , Gg          , Gg          , Gg          , Gg          , Gg^Efm      , Gg          , Gg          , Gg          , Gg          , Gg          , Gg          , Gg          , Gg          , Gg          , Hh          , Hh          , Mm          , Mm          , Mm          , Mm          , Mm          , Mm          , Mm          , Mm          , Mm          , Mm          , Mm^Xm       
Xu          , Uh          , Uh          , Ur          , Ur          , Uu          , Ur          , Ur          , Ur          , Gg          , Gg          , Gg          , Gg          , Gg          , Gg          , Gg          , Gg          , Gg          , Gg          , Gg^Efm      , Gg          , Gg          , Gg          , Gg          , Gg          , Gg          , Gg          , Gg          , Gg^Efm      , Gg^Efm      , Gg          , Gg          , Gg          , Hh          , Mm          , Mm          , Mm          , Md          , Md          , Mm          , Md          , Md          , Md          , Md          , Md          , Md^Xm       
Xu          , Uh          , Uh          , Ur          , Ur          , Uu          , Uu^Uf       , Uu^Uf       , Ur          , Gg          , Gg          , Gg          , Gg          , Gg          , Gg          , Gg          , Gg          , Gg          , Gg          , Gg          , Ce          , Ce          , Ce          , Gg          , Gg          , Gg          , Gg          , Gg^Efm      , Gg          , Gg          , Gg          , Gg          , Gg          , Hh          , Mm          , Md          , Md          , Md          , Hd          , Hd          , Hd          , Hd          , Hd          , Hd          , Md          , Md^Xm       
Xu          , Xu          , Uh          , Uu          , Ur          , Uu          , Uu          , Uu^Uf       , Ur          , Ur          , Gg          , Gg          , Gg          , Gg^Efm      , Gg          , Gg          , Gg          , Gg          , Gg          , Gg          , Ce          , 1 Ke        , Ce          , Ce          , Gg          , Gg          , Gg          , Gg^Efm      , Gg          , Gg^Efm      , Gg^Efm      , Gg          , Gg          , Hh          , Md          , Md          , Hd          , Md          , Hd          , Hd          , Hd          , Ds          , Ds          , Hd          , Md          , Md^Xm       
Xu          , Xu          , Uh          , Uu          , Ur          , Ur          , Ur          , Uu^Uf       , Ur          , Ur          , Ur          , Gg          , Gg          , Gg          , Gg          , Gg          , Gg          , Gg          , Gg          , Gg          , Gg          , Ce          , Ce          , Ce          , Gg          , Gg          , Gg          , Gg^Efm      , Gg          , Gg          , Gg          , Gg^Efm      , Gg^Efm      , Hd          , Hd          , Md          , Hd          , Hd          , Hd          , Ds          , Ds          , Ds          , Hd          , Hd          , Md          , Md^Xm       
Xu          , Uh          , Uu          , Ur          , Uu          , Ur          , Uu          , Ur          , Uu          , Ur          , Ur          , Ur          , Ur          , Gg          , Gg          , Gg          , Gg          , Gg^Efm      , Gg          , Gg          , Gg          , Gg          , Gg          , Gg          , Gg          , Gg          , Gg          , Gg          , Gg          , Gg          , Gg          , Gg          , Ds          , Ds          , Ds          , Hd          , Ds          , Hd          , Ds          , Ds          , Ds          , Ds          , Hd          , Md          , Md          , Md^Xm       
Xu          , Uh          , Uh          , Ur          , Ur          , Uu          , Uu          , Ur          , Ur          , Ur          , Ur          , Ur          , Uu          , Uu          , Ur          , Gg          , Gg          , Gg          , Gg          , Gg^Efm      , Gg          , Gg          , Gg          , Gg          , Gg          , Gg          , Gg          , Gg^Efm      , Gg          , Gg          , Gg          , Ds          , Ds          , Ds          , Ds          , Ds          , Ds          , Ds          , Ds          , Ds          , Dd          , Dd          , Dd          , Md          , Md^Xm       , Md^Xm       
Xu          , Uh          , Uh          , Uu          , Uu^Uf       , Uu^Uf       , Uu^Uf       , Uu          , Ur          , Uu          , Ur          , Uu          , Ur          , Ur          , Ur          , Ur          , Ur          , Ur          , Gg          , Gg          , Gg          , Gg          , Gg          , Gg          , Gg          , Gg          , Gg          , Gg^Efm      , Gg^Efm      , Gg          , Gg          , Gg          , Ds          , Ds          , Ds          , Ds          , Dd          , Ds          , Ds          , Ds          , Dd          , Hd          , Md          , Md          , Md^Xm       , Md^Xm       
Xu          , Uh          , Uh          , Uu          , Uu          , Uu^Uf       , Uu          , Ur          , Uu          , Ur          , Ur          , Uu          , Uu          , Ur          , Ur          , Ur          , Ur          , Ur          , Ur          , Gg          , Gg          , Gg          , Gg          , Gg^Efm      , Gg^Efm      , Gg          , Gg          , Gg          , Gg          , Gg          , Ds          , Ds          , Ds          , Ds          , Ds          , Dd          , Dd          , Dd          , Ds          , Ds          , Ds          , Hd          , Md          , Md          , Md^Xm       , Md^Xm       
Xu          , Xu          , Uh          , Uu          , Uu          , Uu          , Ur          , Uu          , Ur          , Ur          , Ur          , Ur          , Uu          , Ur          , Uu^Uf       , Uu^Uf       , Ur          , Ur          , Ur          , Ur          , Ur          , Gg          , Gg          , Gg          , Gg          , Gg          , Gg          , Gg          , Gg          , Ds          , Ds          , Ds          , Dd          , Ds          , Ds          , Ds          , Ds          , Dd          , Ds          , Ds          , Ds          , Hd          , Md          , Md          , Md          , Md^Xm       
Xu          , Uh          , Uu          , Uu          , Uu          , Uu          , Uu          , Uu          , Uu          , Ur          , Ur          , Ur          , Uu          , Ur          , Ur          , Uu^Uf       , Uu          , Ur          , Ur          , Ur          , Uu          , Ur          , Ur          , Gg          , Gg          , Gg          , Gg          , Gg          , Gg          , Ds          , Ds          , Ds          , Ds          , Ds          , Dd          , Ds          , Ds          , Dd          , Ds          , Dd          , Hd          , Hd          , Md          , Md          , Md^Xm       , Md^Xm       
Xu          , Uh          , Uh          , Uu          , Ur          , Uu          , Ur          , Uu          , Uu          , Uu          , Uu          , Ur          , Uu          , Ur          , Ur          , Ur          , Uu          , Uu          , Ur          , Ur          , Uu          , Uu          , Ur          , Gg          , Gg          , Gg          , Gg^Efm      , Gg          , Gg          , Ds          , Ds          , Ds          , Dd          , Ds          , Ds          , Ds          , Ds          , Ds          , Ds          , Ds          , Ds          , Hd          , Md          , Md          , Md          , Md^Xm       
Xu          , Xu          , Uh          , Uu          , Ur          , Ur          , Ur          , Ur          , Uu^Uf       , Ur          , Ur          , Uu          , Uu          , Ur          , Ur          , Uu          , Ur          , Uu          , Ur          , Uu          , Ur          , Uu          , Ur          , Ur          , Ur          , Gg          , Gg          , Gg          , Ds          , Ds          , Ds          , Ds          , Ds          , Ds          , Dd          , Ds          , Ds          , Ds          , Ds          , Ds          , Dd          , Hd          , Md          , Md          , Md          , Md^Xm       
Xu          , Uh          , Uh          , Uh          , Uu          , Uu          , Ur          , Uu^Uf       , Uu^Uf       , Uu          , Uu          , Uu          , Uu          , Ur          , Uu          , Uu          , Ur          , Ur          , Uu          , Ur          , Ur          , Ur          , Uu          , Ur          , Ur          , Ur          , Ur          , Gg          , Ds          , Ds          , Ds          , Ds          , Ds          , Ds          , Ds          , Ds          , Ds          , Ds          , Ds          , Ds          , Ds          , Hd          , Md          , Md          , Hd          , Md^Xm       
Xu          , Uh          , Ur          , Ur          , Uu          , Uu          , Uu          , Uu^Uf       , Ur          , Uu          , Ur          , Ur          , Ur          , Uu          , Uu          , Uu          , Uu          , Ur          , Ur          , Ur          , Ur          , Ur          , Uu          , Ur          , Uu          , Uu          , Ur          , Ur          , Ur          , Ds          , Ds          , Ds          , Ds          , Ds          , Ds          , Ds          , Ds          , Ds          , Ds          , Ds          , Ds          , Hd          , Hd          , Md          , Md          , Md^Xm       
Xu          , Uh          , Ur          , Ur          , Uh          , Ur          , Uu          , Uu          , Uu          , Uu          , Uu          , Ur          , Ur          , Ur          , Uu          , Uu          , Uu          , Uu          , Uu^Uf       , Ur          , Ur          , Ur          , Uu          , Ur          , Ur          , Ur          , Ds          , Ds          , Ds          , Ds          , Ds          , Ds          , Dd          , Ds          , Dd          , Ds          , Ds          , Dd          , Ds          , Dd          , Ds          , Ds          , Hd          , Hd          , Md          , Md^Xm       
Xu          , Uh          , Uh          , Uh          , Uh          , Uu          , Cud         , Uu          , Ur          , Uu          , Uu          , Ur          , Ur          , Uu          , Ur          , Uu          , Uu          , Uu^Uf       , Uu^Uf       , Ur          , Ur          , Uu          , Ur          , Ur          , Ds          , Ds          , Ds          , Ds          , Ds          , Ds          , Ds          , Ds          , Ds          , Ds          , Ds          , Ds          , Ds          , Ds          , Ds          , Ds          , Chr         , Ds          , Chr         , Hd          , Md          , Md^Xm       
Xu          , Xu          , Uh          , Uh          , Uh          , Uh          , Cud         , Cud         , 4 Kud       , Uu          , Ur          , Ur          , Uu          , Uu          , Uu          , Ur          , Uu          , Uh          , Uu^Uf       , Uu^Uf       , Uu          , Ur          , Ur          , Ds          , Ds          , Dd          , Ds          , Ds          , Dd          , Ds          , Hd          , Ds          , Hd          , Hd          , Hd          , Ds          , Hd          , Ds          , Ds          , Dd          , Chr         , 2 Khr       , Chr         , Hd          , Md          , Md^Xm       
Xu          , Uh          , Uh          , Uh          , Uh          , Uh          , Uh          , Cud         , Cud         , Cud         , Uu          , Uu          , Uu          , Uu          , Ur          , Uh          , Uh          , Uh          , Uh          , Ur          , Ur          , Ur          , Hd          , Hd          , Hd          , Hd          , Hd          , Hd          , Hd          , Hd          , Md          , Hd          , Md          , Md          , Md          , Md          , Md          , Hd          , Hd          , Ds          , Hd          , Chr         , Hd          , Md          , Md^Xm       , Md^Xm       
Xu          , Uh          , Uh          , Uh          , Xu          , Uh          , Xu          , Uh          , Uh          , Uh          , Uh          , Uh          , Uh          , Uh          , Xu          , Uh          , Uh          , Uh          , Uu^Uf       , Uu          , Md          , Hd          , Md          , Md          , Md^Xm       , Hd          , Md          , Hd          , Md          , Md          , Md^Xm       , Md          , Md          , Md          , Md^Xm       , Md^Xm       , Md^Xm       , Md          , Md          , Md          , Md          , Md          , Md          , Md          , Md^Xm       , Md^Xm       
Xu          , Xu          , Xu          , Xu          , Xu          , Xu          , Xu          , Xu          , Xu          , Xu          , Xu          , Xu          , Xu          , Xu          , Xu          , Xu          , Xu          , Xu          , Xu          , Xu          , Md^Xm       , Md^Xm       , Md^Xm       , Md^Xm       , Md^Xm       , Md^Xm       , Md^Xm       , Md^Xm       , Md^Xm       , Md^Xm       , Md^Xm       , Md^Xm       , Md^Xm       , Md^Xm       , Md^Xm       , Md^Xm       , Md^Xm       , Md^Xm       , Md^Xm       , Md^Xm       , Md^Xm       , Md^Xm       , Md^Xm       , Md^Xm       , Md^Xm       , Md^Xm       
