Xos, Xos, Xos, Xos, Xos, Xos, Xos, Xos, Xos, Xos, Xos, Xos, Xos, Xor, Qxu, Qxu, Qxu, Qxu, Qxu, Qxu, Qxu, Xor, Xos, Xos, Xos, Xos, Xos, Xos, Xos, Xos, Xos, Xos, Xos, Xos, Xos, Xos, Xos, Xos, Xos, Xos, Xos, Xos, Xos, Xos, Xos, Xos
Xos, Xos, Xos, Xos, Xos, Xos, Xos, Xos, Xos, Xos, Xos, Xos, Xos, Xor, Xof, Qxu, Qxu^Ii, Qxu^Ii, Qxu^Ii, Qxu, Xur, Xor, Xor, Xor, Xor, Xos, Urb, Xos, Xos, Xos, Urb, Xos, Xos, Xos, Xos, Xos, Xos, Xos, Xos, Xos, Xos, Xos, Xos, Xos, Xos, Xos
Xos, Xos, Xos, Xos, Xos, Xos, Xor, Xor, Xor, Xos, Xos, Xos, Xor, Xor, Uu^Qhh, Uu^Vu, Qxu, Qxu^Ii, Qxu, Urb, Xur, Urb, Urb^Dr, Urb^Dr, Urb, Urb, Urb, Uu^Vu, Urb, Urb, Urb, Urb, Urb, Urb, Urb, Xos, Urb, Uu^Vu, Urb, Xos, Urb, Xos, Xos, Xos, Xos, Xos
Xos, Xos, Xos, Xos, Xor, Xor, Urb, Xor, Urb, Xor, Xor, Xor, Urb^Dr, Uh^Qhh, Uu^Qhh, Uu, Uu, Qxu, Qxu^Bp/, Urb^Dr, Uu^Vu, Xur, Xur, Urb, Uh, Urb, Urb^Dr, Xor, Urb, Urb, Cud, Urb, Urb, Urb, Urb, Urb, Urb, Urb, Urb, Urb, Urb, Urb, Urb, Xos, Xos, Xos
Xos, Xos, Xos, Xos, Xor, Urb, Xor, Urb^Dr, Urb, Urb^Dr, Urb^Dr, Xor, Urb^Dr, Uh^Qhh, Uh^Qhh, Xor, Uu^Qhh, Uu, Qxu, Xur, Urb, Urb^Qhh, Urb^Qhh, Uh^Qhh, Uh^Qhh, Uh^Ii, Uh, Xor, Urb, Cud, Cud, Cud, Kud, Urb, Urb, Urb, Xos, Xos, Xos, Xos, Urb, Urb, Uu^Vu, Xos, Xos, Xos
Xos, Xos, Xos, Xos, Xor, Urb^Dr, Urb, Urb^Dr, Xor, Urb^Dr, Urb, Urb, Xor, Xor, Uu^Vu, Uu^Qhh, Xos, Uu, Qxu, Ur, Uu, Urb^Qhh, Urb^Qhh, Uu^Qhh, Uu^Qhh, Xor, Uh, Urb^Dr, Urb^Br\, Cud, Cud, Cud, Xos, Xos, Xos, Uu^Vu, Urb, Xos, Urb, Urb, Urb, Urb, Xos, Xos, Xos, Xos
Xos, Xos, Xos, Xos, Xos, Urb, Xor, Urb, Urb, Xor, Uu, Xor, Uh, Uu, Uh, Uu^Qhh, Xor, Uu, Urc, Uh, Uu, Uu, Urb^Qhh, Urb^Qhh, Urb^Qhh, Uh^Qhh, Xof, Xof, Urb, Urb^Br\, Urb^Br|, Urb, Urb, Xos, Xos, Xos, Urb, Urb, Urb, Uu, Xos, Xos, Xos, Xos, Xos, Xos
Xos, Xos, Xos, Xos, Xos, Xos, Uu^Vu, Urb, Urb^Ebn, Urb, Uu^Br/, Uu^Br/, Uh, Xor, Urc^Qhh, Uh^Qhh, Uu^Qhh, Ur^Qhh, Uu, Uu, Uh, Xor, Urb, Urb^Qhh, Uu^Vu, Uu^Qhh, Uh^Qhh, Uh^Ii, Urb^Dr, Xor, Urb^Br\, Xos, Urb, Xos, Urb, Urb, Uu, Urb, Uh, Uh, Uh^Qhh, Xos, Xot, Xos, Xos, Xos
Xos, Xos, Xos, Xos, Urb, Urb, Urb, Urb, Urb, Urb^Br|, Xos, Ur, Xor, Uh^Qhh, Uu^Qhh, Uu^Qhh, Uh^Qhh, Uu^Qhh, Ur^Qhh, Uu, Xos, Urb, Xos, Urb^Qhh, Xos, Uu^Qhh, Xos, Uh, Urb^Dr, Uu, Xor, Urb^Br\, Urb^Br|, Uu^Vu, Uu, Urb, Uh, Uh, Uh^Qhh, Xos, Xor, Uu^Qhh, Ur, Xor, Xor, Xos
Xos, Xos, Xos, Xos, Urb, Urb, Urb, Urb, Urb, Urb^Br|, Urb, Uh, Uh, Xor, Xos, Uh^Qhh, Uu^Qhh, Uh^Qhh, Xos, Xos, Xos, Xos, Xor, Xor, Xor, Xos, Xor, Xos, Uh, Uh, Uh, Xor, Uh, Uh, Xor, Xor, Uh^Qhh, Uu^Qhh, Urb^Qhh, Uu^Qhh, Ur, Uu^Vu, Xor, Uu, Qxu, Xof
Xos, Xos, Xos, Xos, Urb, Urb, Urb, Urb, Xos, Urb^Br|, Urb^Br\, Urb, Urb, Urb, Uu^Vu, Xos, Xos, Xos, Xos, Xos, Xos, Xor, Uu, Urb^Qhh, Uu, Xor, Uu, Xor, Urb^Qhh, Xor, Uu^Qhh, Uh^Qhh, Uh^Qhh, Uu^Qhh, Uu^Qhh, Uh^Qhh, Urb^Qhh, Uu^Qhh, Ur, Ur, Uu, Ur^Dr, Qxu, Qxu, Qxu^Ii, Qxu
Xos, Xos, Xos, Xos, Xos, Urb, Xos, Xos, Uu^Vu, Urb^Ebn, Urb, Urb^Br\, Urb^Br\, Urb, Urb, Xos, Xos, Xos, Xos, Xos, Xos, Urb^Qhh, Urb^Qhh, Uu, Qxu, Uu, Qxu, Uu, Ur, Urb^Qhh, Urb^Qhh, Uh^Qhh, Xur, Xur, Ur^Vu, Urb^Qhh, Ur, Ur, Ur^Dr, Xor, Qxu, Qxu, Qxu, Qxu^Ii, Qxu, Qxu
Xos, Xos, Xos, Xos, Xos, Urb, Urb, Xos, Urb, Urb, Xos, Xos, Urb, Urb^Br\, Urb^Br|, Xos, Xos, Xos, Xos, Xos, Xos, Xos, Xor, Uu, Uu, Qxu, Qxu^Ii, Qxu, Ur^Dr, Ur, Ur, Ur^Br|, Ur^Br\, Xur, Xur, Ur, Qxu, Qxu, Qxu, Uu, Qxu^Bp\, Qxu, Urb^Dr, Qxu, Xor, Qxu
Xos, Xos, Xos, Xos, Uu^Vu, Urb, Urb, Urb, Urb, Urb, Xos, Xos, Urb, Xos, Urb^Br\, Xos, Xos, Xos, Xos, Xos, Xos, Xos, Xos, Xor, Xor, Uu, Uu, Qxu, Qxu, Uu, Uu, Xur, Qxu, Ur^Br\, Qxu^Bp\, Qxu, Qxu, Qxu^Ii, Qxu, Qxu, Xor, Urb, Urb, Urb^Dr, Xos, Qxu
Xos, Xos, Xos, Xos, Xos, Urb, Urb, Urb, Urb, Urb^Ebn, Urb, Xos, Urb, Urb, Cud, Urb^Br\, Urb^Br\, Urb, Uu^Vu, Xos, Xos, Xos, Xos, Xos, Xos, Xor, Uu, Qxu, Uu, Qxu^Bp/, Qxu, Qxu, Xor, Qxu, Qxu, Qxu^Bp\, Urb^Br\, Xor, Qxu, Urb, Urb, Urb^Vu, Urb, Urb, Xos, Xos
Xos, Xos, Xos, Xos, Xos, Urb, Urb, Urb, Urb, Xos, Urb, Urb, Cud, 3 Kud, Cud, Urb, Urb^Br|, Xos, Xos, Urb, Urb, Xos, Xos, Xos, Xos, Xor, Xor, Uu, Uu, Uu, Ur, Qxu, Urb, Urb^Dr, Urb, Urb, Urb^Br|, Qxu, Qxu, Urb, Urb, Urb, Urb, Urb, Xos, Xos
Xos, Xos, Xos, Xos, Xos, Urb, Urb, Urb, Urb, Urb, Xos, Cud, Cud, Cud, Urb, Xos, Urb^Br|, Urb^Ebn, Urb, Xos, Xos, Urb, Xos, Xos, Xos, Xos, Xos, Xor, Xor, Uu, Xor, Ur, Uu^Vu, Urb, Urb, Urb, Xos, Urb^Br\, Urb, Qxu, Xos, Urb, Urb, Urb, Xos, Xos
Xos, Xos, Xos, Xos, Xos, Uu^Vu, Urb, Urb, Urb, Urb, Urb, Xos, Xos, Cud, Urb, Xos, Urb^Br|, Urb, Urb, Urb, Urb, Urb, Xos, Xos, Xos, Xos, Xos, Xos, Xos, Xor, Xos, Xor, Urb, Urb, Urb, Urb, Urb, Urb^Br|, Urb, Urb, Urb, Urb, Xos, Xos, Xos, Xos
Xos, Xos, Xos, Xos, Xos, Xos, Xos, Xos, Xos, Urb, Urb, Urb, Urb, Urb, Urb, Urb, Urb^Br|, Xos, Xos, Urb, Uu^Vu, Urb, Urb, Xos, Xos, Xos, Xos, Xos, Xos, Xos, Xos, Xor, Urb, Urb, Cud, Cud, Cud, Urb^Br|, Urb^Br\, Urb, Urb, Urb, Xos, Xos, Xos, Xos
Xos, Xos, Xos, Xos, Xos, Xos, Xos, Xos, Xos, Urb, Urb, Xos, Xos, Uu^Vu, Urb, Urb, Urb^Br|, Urb, Urb, Xos, Xos, Xos, Xos, Urb, Xos, Xos, Xos, Xos, Xos, Xos, Xos, Urb, Urb, Urb, Urb, Cud, Kud, Cud, Urb, Urb^Br|, Urb^Br\, Urb, Urb, Xos, Xos, Xos
Xos, Xos, Xos, Xos, Xos, Xos, Xos, Xos, Xos, Xos, Urb, Urb, Xos, Urb, Xos, Urb, Urb^Ebn, Urb^Br\, Urb^Br\, Xos, Urb^Ebn, Xos, Urb, Urb, Xos, Xos, Xos, Xos, Xos, Xos, Xos, Urb, Urb, Urb, Urb, Urb, Urb, Cud, Urb, Urb, Urb, Uu^Vud, Urb, Xos, Xos, Xos
Xos, Xos, Xos, Xos, Xos, Xos, Xos, Xos, Xos, Xos, Urb, Urb, Urb, Urb, Xos, Xos, Urb, Urb, Xos, Urb^Br\, Urb^Br\, Urb, Urb, Urb, Uu^Vu, Xos, Xos, Xos, Xos, Xos, Xos, Xos, Xos, Urb, Urb, Urb, Urb, Urb, Urb, Urb, Urb, Urb, Urb, Xos, Xos, Xos
Xos, Xos, Xos, Xos, Xos, Xos, Xos, Xos, Xos, Xos, Xos, Xos, Urb, Urb, Urb, Xos, Urb, Urb, Urb, Xos, Urb^Br|, Urb, Xos, Urb, Urb, Urb, Urb^Ebn, Xos, Urb, Xos, Urb, Xos, Xos, Xos, Xos, Urb, Urb, Urb, Urb, Urb, Urb, Urb, Xos, Xos, Xos, Xos
Xos, Xos, Xos, Xos, Xos, Xos, Xos, Xos, Xos, Xos, Xos, Xos, Xos, Xos, Xos, Urb, Urb, Urb, Urb, Xos, Urb^Br|, Urb, Xos, Xos, Xos, Urb, Urb, Urb, Uu^Vu, Urb, Xos, Urb, Urb, Xos, Xos, Xos, Xos, Xos, Xos, Uu^Vu, Xos, Xos, Xos, Xos, Xos, Xos
Xos, Xos, Xos, Xos, Xos, Xos, Xos, Xos, Xos, Xos, Xos, Xos, Xos, Xos, Xos, Urb, Uu^Vu, Xos, Urb, Urb, Urb^Br|, Urb, Xos, Xos, Xos, Xos, Urb, Urb, Urb, Xos, Xos, Urb, Xos, Urb, Xos, Xos, Xos, Xos, Xos, Xos, Xos, Xos, Xos, Xos, Xos, Xos
Xos, Xos, Xos, Xos, Xos, Xos, Xos, Xos, Xos, Xos, Xos, Xos, Xos, Xos, Xos, Xos, Xos, Xos, Urb, Urb, Urb^Br|, Urb, Xos, Xos, Urb, Urb, Zaw, Urb, Zaw, Urb, Xos, Xos, Urb, Urb, Xos, Xos, Xos, Xos, Xos, Xos, Xos, Xos, Xos, Xos, Xos, Xos
Xos, Xos, Xos, Xos, Xos, Xos, Xos, Xos, Xos, Xos, Xos, Xos, Xos, Xos, Xos, Xos, Xos, Xos, Zic, Urb, Zaw, Urb^Br\, Urb^Br\, Urb, Urb, Urb, Zaw, Zaw, Zaw, Zaw, Zaw, Urb, Urb, Urb, Xos, Xos, Xos, Xos, Xos, Xos, Xos, Xos, Xos, Xos, Xos, Xos
Xos, Xos, Xos, Xos, Xos, Xos, Xos, Xos, Xos, Xos, Xos, Xos, Xos, Xos, Xos, Xos, Xos, Xos, Zic, Zaw, Zaw^Esa, Zaw, Zaw, Zaw^Br\, Zaw^Br\, Zaw, Zaw, Zaw, Zaw^Esa, Zaw, Zaw, Zaw, Xos, Xos, Xos, Xos, Xos, Xos, Xos, Xos, Xos, Xos, Xos, Xos, Xos, Xos
Xos, Xos, Xos, Xos, Xos, Xos, Xos, Xos, Xos, Xos, Xos, Xos, Xos, Xos, Xos, Xos, Xos, Xos, Zic, Zic, Zic, Zaw, Zaw, Zaw, Zaw, Zaw^Vud, Zaw, Zaw, Zaw, Zaw, Zic, Zic, Xos, Xos, Xos, Xos, Xos, Xos, Xos, Xos, Xos, Xos, Xos, Xos, Xos, Xos
Xos, Xos, Xos, Xos, Xos, Xos, Xos, Xos, Xos, Xos, Xos, Xos, Xos, Xos, Xos, Xos, Xos, Xos, Zic, Zic, Zic, Zic, Zic, Zaw^Esa, Zaw, Zaw^Esa, Zaw, 1 Zaw, Zaw, Zaw, Zic, Zic, Zic, Xos, Xos, Xos, Xos, Xos, Xos, Xos, Xos, Xos, Xos, Xos, Xos, Xos
Xos, Xos, Xos, Xos, Xos, Xos, Xos, Xos, Xos, Xos, Xos, Xos, Xos, Xos, Xos, Xos, Xos, Xos, Zic, Zic, Zic, Zic, Zic, Zic, Zic, Zaw^Esa, Zaw^Esa, Zaw, Zaw^Esa, Zaw^Esa, Zic, Zic, Zic, Xos, Xos, Xos, Xos, Xos, Xos, Xos, Xos, Xos, Xos, Xos, Xos, Xos
Xos, Xos, Xos, Xos, Xos, Xos, Xos, Xos, Xos, Xos, Xos, Xos, Xos, Xos, Xos, Xos, Xos, Xos, Zic, Zic, Zic, Zic, Zic, Zic, Zic, Zic, Zaw^Esa, Zaw^Esa, Zaw^Esa, Zaw^Esa, Zic, Zic, Zic, Xos, Xos, Xos, Xos, Xos, Xos, Xos, Xos, Xos, Xos, Xos, Xos, Xos
Xos, Xos, Xos, Xos, Xos, Xos, Xos, Xos, Xos, Xos, Xos, Xos, Xos, Xos, Xos, Xos, Xos, Xos, Xos, Zic, Zic, Zic, Zic, Zic, Zic, Zic, Zic, Zaw^Esa, Zaw^Esa, Zaw^Esa, Zaw^Esa, Zic, Zic, Zic, Zic, Xos, Xos, Xos, Xos, Xos, Xos, Xos, Xos, Xos, Xos, Xos
Xos, Xos, Xos, Xos, Xos, Xos, Xos, Xos, Xos, Xos, Xos, Xos, Xos, Xos, Xos, Xos, Xos, Xos, Xos, Zic, Zic, Zic, Zic, Zic, Zic, Zic, Zic, Zic, Zaw^Esa, Zaw^Esa, Zaw^Esa, Zic, Zic, Zic, Zic, Xos, Xos, Xos, Xos, Xos, Xos, Xos, Xos, Xos, Xos, Xos
Xos, Xos, Xos, Xos, Xos, Xos, Xos, Xos, Xos, Xos, Xos, Xos, Xos, Xos, Xos, Xos, Xos, Xos, Xos, Xos, Xos, Zic, Zic, Zic, Zic, Zic, Zic, Zic, Zaw^Br|, Zaw^Esa, Zaw^Esa, Zic, Zic, Zic, Zic, Xos, Xos, Xos, Xos, Xos, Xos, Xos, Xos, Xos, Xos, Xos
