Xuc, Xuc, Xuc, Xuc, Xuc, Xuc, Xuc, Xuc, Xuc, Xuc, Xuc, Xuc, Xuc, Xuc, Xuc, Xuc, Xuc, Xuc, Xuc, Xuc, Xuc, Xuc, Xuc, Xol, Xol, Xol, Xol, Xol, Xol, Xol, Xol, Xol, Xol, Xol, Xol, Xol, Xol, Xol, Xol, Xol, Xol, Xol, Xol, Xol
Xuc, Xuc, Xuc, Xuc, Xuc, Xuc, Xuc, Xuc, Xuc, Xuc, Xuc, Xuc, Xuc, Xuc, Xuc, Xuc, Xuc, Xuc, Xuc, Xuc, Xuc, Xuc, Xuc, Xol, Xol, Xol, Xol, Xol, Xol, Xol, Xol, Xol, Xol, Xol, Xol, Xol, Xol, Xol, Xol, Xol, Xol, Xol, Xol, Xol
Xuc, Xuc, Xuc, Xuc, Ur, Xuc, Cud, 3 Kud, Cud, Cud, Ur^Xo, Xuc, Ur^Xo, Xuc, Ur, Xuc, Xuc, Xuc, Xuc, Xuc, Xuc, Xuc, Xuc, Xol, Xol, Xol, Iwr, Iwr, Iwr, Xol, Xol, Xol, Iwr^Xo, Iwr, Iwr, Iwr, Iwr^Xo, Xol, Xol, Xol, Xol, Xol, Xol, Xol
Xuc, Xuc, Xuc, Xuc, Ur, Ur, Rrc, Cud, Ur, Ur, Ur, Ur, Ur, Ur, Ur, Ur^Xo, Rrc, Xuc, Xuc, Xuc, Xuc, Xuc, Xuc, Xol, Iwr, Iwr, Xol, Xol, Xol, Iwr, Iwr, Iwr, Iwr, Iwr, Iwr, Iwr, Iwr, Iwr, Iwr^Xo, Xol, Xol, Xol, Xol, Xol
Xuc, Xuc, Ur, Ur^Xo, Ur, Ur, Rrc, Ur, Ur, Ur, Ur, Ur, Ur, Ur, Ur, Ur, Rrc, Rrc^Xo, Rrc, Xuc, Xuc, Xuc, Iwr, Iwr, Xol, Xol, Xol, Xol, Xol, Iwr, Iwr, Iwr, Iwr, Iwr, Iwr, Iwr, Iwr, Iwr, Iwr, Iwr, Xol, Xol, Xol, Xol
Xuc, Xuc, Ur, Ur, Ur, Ur, Ur, Rrc, Ur, Ur, Ur, Ur, Ur, Ur, Rrc, Rrc, Rrc, Rrc, Rrc, Rrc, Iwr, Iwr, Xol, Xol, Xol, Xol, Xol, Xol, Xol, Iwr, Iwr, Iwr, Iwr, Iwr, Iwr, Iwr, Iwr, Iwr, Iwr, Iwr, Xol, Xol, Xol, Xol
Xuc, Xuc, Xuc, Ur, Ur, Ur, Ur, Rrc, Rrc, Ur, Ur, Ur, Rrc, Rrc, Xuc, Xuc, Xuc, Xuc, Xuc, Xuc, Xuc, Xuc, Xol, Xol, Xol, Xol, Xol, Xol, Xol, Xol, Xol, Iwr, Iwr, Iwr, Iwr, Iwr, Iwr, Iwr, Iwr, Xol, Xol, Xol, Xol, Xol
Xuc, Xuc, Xuc, Ur, Ur, Ur, Ur, Ur, Ur, Rrc, Rrc, Rrc, Xuc, Xuc, Xuc, Xuc, Xuc, Xuc, Xuc, Xuc, Xuc, Xol, Xol, Xol, Xol, Xol, Xol, Xol, Iwr^Xo, Xol, Iwr, Xol, Xol, Xol, Xol, Xol, Xol, Iwr, Iwr, Xol, Xol, Xol, Xol, Xol
Xuc, Xuc, Xuc, Ur^Xo, Ur, Ur, Ur, Ur, Ur, Ur, Rrc, Xuc, Xuc, Xuc, Xuc, Xuc, Xuc, Xuc, Xuc, Xuc, Xol, Xol, Xol, Xol, Xol, Xol, Iwr^Xo, Iwr, Iwr, Iwr, Iwr, Iwr^Xo, Iwr, Xol, Xol, Xol, Xol, Iwr, Iwr, Iwr^Xo, Xol, Xol, Xol, Xol
Xuc, Xuc, Xuc, Ur, Ur, Ur, Ur, Ur, Ur, Ur, Rrc, Xuc, Xuc, Xuc, Xuc, Xuc, Xuc, Xuc, Xuc, Xuc, Xol, Xol, Xol, Xol, Xol, Xol, Iwr, Iwr, Iwr, Iwr, Iwr, Iwr, Iwr, Iwr, Iwr^Xo, Xol, Xol, Iwr, Iwr, Iwr, Xol, Xol, Xol, Xol
Xuc, Xuc, Xuc, Xuc, Xuc, Ur, Ur, Ur, Ur, Ur, Rrc, Xuc, Xuc, Xuc, Xuc, Xuc, Xuc, Xuc, Xol, Xol, Xol, Xol, Xol, Xol, Xol, Xol, Iwr, Iwr, Iwr, Iwr, Iwr, Iwr, Iwr, Iwr, Xol, Xol, Xol, Iwr, Iwr, Iwr, Xol, Xol, Xol, Xol
Xuc, Xuc, Xuc, Xuc, Xuc, Ur, Ur, Ur, Ur, Ur, Rrc, Xuc, Xuc, Xuc, Xuc, Xuc, Xuc, Xuc, Xol, Xol, Xol, Xol, Xol, Xol, Xol, Xol, Xol, Iwr, Iwr, Iwr, Xol, Xol, Xol, Xol, Xol, Xol, Iwr, Iwr, Iwr, Iwr, Xol, Xol, Xol, Xol
Xuc, Xuc, Xuc, Xuc, Xuc, Xuc, Xuc, Ur, Xuc, Rrc, Iwr, Xuc, Xuc, Xuc, Xol, Xol, Xol, Xol, Xol, Xol, Xol, Xol, Xol, Xol, Xol, Xol, Xol, Xol, Xol, Iwr, Iwr, Xol, Xol, Xol, Iwr, Iwr, Iwr, Iwr, Xol, Xol, Xol, Xol, Xol, Xol
Xuc, Xuc, Xuc, Xuc, Xuc, Xuc, Xuc, Xuc, Xuc, Iwr, Iwr, Xuc, Xuc, Xuc, Xol, Xol, Xol, Xol, Xol, Xol, Xol, Xol, Xol, Xol, Xol, Xol, Xol, Xol, Xol, Xol, Xol, Iwr, Iwr^Cov, Iwr, Iwr, Iwr, Xol, Xol, Xol, Xol, Xol, Xol, Xol, Xol
Xuc, Xuc, Xuc, Xuc, Xuc, Xuc, Xuc, Xuc, Xuc, Iwr, Iwr, Xuc, Xol, Xol, Xol, Xol, Xol, Xol, Xol, Xol, Xol, Xol, Xol, Xol, Xol, Xol, Xol, Xol, Xol, Xol, Iwr, Iwr^Cov, Iwr^Kov, Iwr^Cov, Iwr, Xol, Xol, Xol, Xol, Xol, Xol, Xol, Xol, Xol
Xuc, Xuc, Xuc, Xuc, Xuc, Xuc, Xuc, Xuc, Xol, Iwr, Iwr, Xol, Xol, Xol, Xol, Xol, Xol, Xol, Xol, Xol, Xol, Xol, Xol, Xol, Xol, Xol, Xol, Xol, Iwr, Iwr, Xol, Iwr^Cov, Iwr^Cov, Iwr^Cov, Iwr, Xol, Xol, Xol, Xol, Xol, Xol, Xol, Xol, Xol
Xuc, Xuc, Xuc, Xuc, Xol, Xuc, Xol, Xol, Iwr, Iwr, Xol, Xol, Xol, Xol, Xol, Xol, Xol, Xol, Xol, Xol, Iwr, Iwr, Iwr, Iwr^Xo, Iwr, Iwr, Iwr, Iwr, Xol, Xol, Iwr, Iwr, Iwr, Iwr, Iwr, Xol, Xol, Xol, Xol, Xol, Xol, Xol, Xol, Xol
Xol, Xol, Xol, Xol, Xol, Xol, Xol, Xol, Iwr, Xol, Xol, Xol, Xol, Xol, Xol, Xol, Xol, Xol, Iwr, Iwr^Xo, Iwr, Iwr, Iwr, Iwr, Iwr, Iwr, Iwr, Iwr, Iwr, Iwr, Xol, Xol, Iwr, Iwr, Iwr, Xol, Xol, Xol, Xol, Xol, Iwr^Xo, Iwr, Iwr^Xo, Xol
Gg, Xol, Xol, Xol, Xol, Xol, Xol, Xol, Iwr, Xol, Xol, Xol, Xol, Xol, Xol, Xol, Iwr, Iwr, Iwr, Iwr, Iwr, Iwr, Iwr, Iwr, Iwr, Iwr, Iwr, Iwr, Iwr, Iwr, Xol, Xol, Xol, Iwr, Iwr, Iwr, Iwr, Xol, Xol, Iwr, Iwr, Iwr, Iwr, Xol
Gg, Gg, Gg, Xol, Xol, Xol, Xol, Xol, Iwr, Xol, Iwr^Xo, Iwr, Iwr, Xol, Iwr, Iwr, Xol, Xol, Iwr, Iwr, Iwr, Iwr, Iwr, Iwr, Iwr, Iwr, Iwr, Iwr, Xol, Xol, Xol, Xol, Xol, Xol, Xol, Iwr, Iwr, Xol, Xol, Iwr, Iwr, Iwr, Iwr, Xol
Gg, Gg^Xo, Gg^Xo, Gg, Gg, Xol, Xol, Xol, Iwr, Iwr, Iwr, Iwr, Iwr, Iwr, Xol, Xol, Iwr, Iwr, Xol, Iwr, Iwr, Iwr, Iwr, Iwr, Iwr, Iwr, Xol, Xol, Xol, Xol, Xol, Xol, Xol, Xol, Xol, Xol, Iwr, Xol, Iwr, Iwr, Iwr, Iwr, Iwr, Xol
Gg, Gg, Gg, Gg^Xo, Gg^Xo, Gg, Gg, Xol, Xol, Iwr, Iwr, Iwr, Iwr, Iwr, Iwr, Iwr, Iwr, Xol, Xol, Xol, Xol, Xol, Xol, Xol, Xol, Iwr, Iwr, Xol, Xol, Xol, Xol, Xol, Xol, Xol, Xol, Xol, Iwr, Iwr, Xol, Xol, Xol, Iwr, Xol, Xol
Gg, Gg, Gg, Gg, Gg, Gg^Xo, Gg^Xo, Gg, Gg, Xol, Xol, Iwr, Iwr, Iwr, Iwr, Iwr, Xol, Xol, Xol, Xol, Xol, Xol, Xol, Xol, Xol, Xol, Iwr, Xol, Xol, Xol, Xol, Xol, Xol, Xol, Xol, Xol, Iwr, Xol, Xol, Xol, Xol, Xol, Xol, Xol
Gg, Gg^Efm, Gs^Fds, Gg, Gg, Gg, Gg, Gg^Xo, Gg^Xo, Gg, Gg, Xol, Xol, Iwr, Xol, Xol, Xol, Xol, Xol, Xol, Xol, Xol, Xol, Xol, Xol, Xol, Iwr, Xol, Xol, Xol, Xol, Xol, Xol, Xol, Xol, Xol, Iwr, Xol, Xol, Xol, Xol, Xol, Xol, Xol
Gs^Fds, Gs^Fds, Gg^Fet, Gs^Fds, Gs^Fds, Gg, Gg, Gg, Gg, Gg^Xo, Gg^Xo, Gg, Gg, Xol, Xol, Xol, Xol, Xol, Xol, Xol, Xol, Xol, Xol, Xol, Iwr, Iwr, Xol, Xol, Xol, Xol, Xol, Xol, Xol, Xol, Xol, Xol, Iwr, Xol, Xol, Xol, Xol, Xol, Xol, Xol
Gs^Fms, Gs^Fds, Gs^Fds, Gs^Fds, Gg, Gg, Gg, Gg, Gg, Gg, Gg, Gg^Xo, Gg^Xo, Gg, Gg, Xol, Xol, Xol, Xol, Xol, Xol, Xol, Xol, Xol, Iwr, Xol, Xol, Xol, Xol, Xol, Xol, Xol, Xol, Xol, Xol, Xol, Iwr, Xol, Xol, Xol, Xol, Xol, Xol, Xol
Gs^Fds, Gs^Fds, Gg, Gg, Gg^Efm, Gg^Efm, Gg^Efm, Gg^Efm, Gg^Efm, Gg, Gg, Gg, Gg, Gg^Xo, Gg^Xo, Gg, Gg, Xol, Xol, Xol, Xol, Xol, Iwr, Iwr, Xol, Xol, Xol, Xol, Xol, Xol, Xol, Xol, Xol, Xol, Xol, Xol, Iwr, Xol, Xol, Xol, Xol, Xol, Xol, Xol
Gs^Fds, Gs^Fms, Gg, Gg^Efm, Gg^Efm, Gg^Efm, Gg^Efm, Gg^Efm, Gg^Efm, Gg, Gg, Gg, Gg, Gg, Gg, Gg^Xo, Gg, Xol, Xol, Xol, Iwr^Xo, Iwr^Xo, Iwr, Iwr, Iwr, Xol, Xol, Xol, Xol, Xol, Xol, Xol, Xol, Xol, Xol, Xol, Iwr, Xol, Xol, Xol, Xol, Xol, Rrc, Rrc
Gs^Fds, Gs^Fds, Gg, Gg^Efm, Gg^Efm, Gg^Efm, Gg^Efm, Gg^Efm, Gg^Efm, Gg^Efm, Gg, Gg, Gg, Gg, Gg, Gg^Xo, Gg, Xol, Xol, Xol, Iwr, Iwr, Iwr, Iwr, Iwr, Iwr^Xo, Iwr, Xol, Xol, Xol, Xol, Xol, Xol, Xol, Xol, Xol, Xol, Iwr, Iwr, Xol, Rrc, Rrc, Rrc, Rrc
Gs^Fds, Gg, Gg, Gg^Efm, Gg^Efm, Gg^Efm, Gg^Efm, Gg^Efm, Gg, Gg, Gs^Fds, Gs^Fds, Gg, Gg, Gg, Gg^Xo, Gg, Xol, Xol, Iwr, Iwr, Iwr, Iwr, Iwr, Iwr, Iwr, Xol, Xol, Xol, Xol, Xol, Xol, Xol, Xol, Xol, Xol, Xol, Xol, Rrc, Rrc, Rrc, Rrc, Ch, Ch
Gs^Fds, Gg, Gg, Gg, Gg, Gg, Gg, Gg, Gs^Fds, Gs^Fds, Gs^Fds, Gs^Fms, Gg, Gg, Gg, Gg^Xo, Gg, Xol, Xol, Xol, Xol, Iwr, Iwr, Iwr, Iwr, Iwr, Xol, Xol, Xol, Xol, Xol, Xol, Xol, Xol, Xol, Xol, Rrc, Rrc, Rrc, Rrc, 1 Rrc, 2 Kh, Rrc, Rrc
Gs^Fds, Gs^Fds, Gs^Fds, Gs^Fds, Gs^Fds, Gs^Fds, Gg, Gs^Fms, Gs^Fds, Gg^Fet, Gs^Fds, Gs^Fds, Gg, Gg, Gg, Gg^Xo, Gg, Xol, Xol, Xol, Xol, Xol, Xol, Xol, Xol, Xol, Xol, Xol, Xol, Xol, Xol, Xol, Xol, Xol, Rrc, Rrc, Rrc, Rrc, Ch, Ch, Rrc, Rrc, Rrc, Rrc
