border_size=1
usage=map

Ch          , Ch          , Rrc         , Rrc         , Rrc         , Rrc         , Rrc         , Rrc         , Ch          , Rrc         , Rrc         , Rrc         , Rrc         , Rrc         , Rr^Vhc      , Rrc         , Rrc         , Rrc         , Ch          , Rrc         , Ch          , Ch          
Kh          , Rrc         , Rrc         , Rp^Vhcr     , Rrc         , Rr^Vhc      , Rrc         , Kh          , Rr^Vhc      , Rrc         , Rrc         , Rrc         , Rrc         , Rrc         , Rrc         , Rrc         , Rrc         , Ch          , Rrc         , Rrc         , Rrc         , Rrc         
Rrc         , Rrc         , Rr^Vhc      , Rrc         , Rrc         , Rrc         , Kh          , Rrc         , Rrc         , Rrc         , Rrc         , Rrc         , Rrc         , Rrc         , Ch          , Ch          , Rrc         , Rrc         , Rrc         , Rrc         , Rrc         , Rrc         
Rrc         , Rrc         , Rrc         , Rrc         , Rp^Vhcr     , Rrc         , Ch          , Rrc         , Rp^Vhcr     , Rrc         , Rrc         , Rr^Vhc      , Rrc         , Rrc         , Rrc         , Rrc         , Rrc         , Rrc         , Kh          , Kh          , Kh          , Kh          
Rrc         , Rrc         , Rrc         , Rrc         , Rrc         , Rrc         , Rrc         , Rrc         , Rrc         , Rrc         , Rrc         , Rrc         , Rrc         , Rrc         , Ch          , Rrc         , Rrc         , Kh          , Kh          , 1 Kh        , Kh          , Kh          
Rrc         , Rr^Vhc      , Rrc         , Rrc         , Rr^Vhc      , Rrc         , Ch          , Rrc         , Rr^Vhc      , Rrc         , Rrc         , Rrc         , Rr^Vhc      , Rrc         , Ch          , Rrc         , Rrc         , Rrc         , Rrc         , Kh          , Kh          , Kh          
Rrc         , Rrc         , Rp^Vhcr     , Rrc         , Rrc         , Rrc         , Kh          , Rrc         , Rrc         , Rrc         , Rrc         , Rrc         , Rrc         , Rrc         , Rrc         , Rrc         , Rrc         , Rrc         , Ch          , Ch          , Gg^Efm      , Kh          
Kh          , Rrc         , Rrc         , Rrc         , Rrc         , Rrc         , Rrc         , Rrc         , Rrc         , Rrc         , Rrc         , Rrc         , Rrc         , Rr^Vhc      , Ch          , Rrc         , Rrc         , Rrc         , Ch          , Gg^Efm      , Dd^Do       , Gg^Efm      
Ch          , Rrc         , Rrc         , Rr^Vhc      , Rrc         , Rrc         , Rrc         , Kh          , Ch          , Rrc         , Rr^Vhc      , Rrc         , Rrc         , Rrc         , Rrc         , Ch          , Rrc         , Rrc         , Gg^Es       , Gg^Efm      , Gg^Efm      , Gg^Fet      
Rrc         , Ch          , Ch          , Rrc         , Rrc         , Rr^Vhc      , Rrc         , Rrc         , Rrc         , Ch          , Ch          , Rrc         , Rrc         , Rr^Vhc      , Rrc         , Rrc         , Rrc         , Ch          , Ch          , Gg^Efm      , Wwt         , Wwt         
