border_size=1
usage=map

Ms, Ms, Ms, Ms, Ms, Ms, Ms, Qxua, Xuc, Xuc, Uu^Uf, Uu^Uf, Uh, Uh, Uu^Uf, Uu^Ufi, Uu^Ufi, Uu^Ufi, Uu^Ufi, Uu^Ufi, Uu^Ufi, Uh, Uh, Uh, Urb, Urb^Br\, Urb^Br\, Xuc, Xuc, Xuc, Urb, Urb, Urb, Urb, Urb^Br/, Urb^Br|, Xu, Xv, Xv, Ql, Ql, Ql, Ql, Qlf, Ql, Qlf, Xv, Xv, Xv, Xv, Wwt, Wwrt, Wwrt, Wwrt, Wwrt, Wwrt, Sm, Sm, Ss, Ss, Ss
Ms, Ms, Ms, Ms, Ms, Ms, Ms, Qxua, Xv, Uu^Uf, Uu^Uf, Uh, Urb, Uu^Vu, Urb, Uu^Ufi, Urb, Uu^Ufi, Urb, Uu^Ufi, Uu^Ufi, Uh, Urb, Urb, Uue, Urb, Urb, Urb^Br\, Urb^Br\, Uu^Vu, Uu^Uf, Uu^Uf, Uu^Br/, Urb^Br/, Urb, Urb, Xuc, Xv, Xv, Qlf, Qlf, Ql, Ql, Ql, Qlf, Qlf, Xv, Xv, Ww^Vm, Wwt, Wwt, Wwrt, Wwrt, Wwrt, Sm, Sm, Sm, Ss, Ss, Gs^Ft, Gs^Ft
Ms, Ms, Ms, Ms, Ms, Ms, Ms, Qxua, Xv, Xv, Urb, Urb, Urb, Urb, Urb, Urb, Urb, Urb, Urb, Urb, Urb, Urb, Uue^Emf, Uue^Emf, Urb^Emf, Uue^Emf, Uue, Urb, Urb, Uu^Br\, Uu^Br\, Urb^Br/, Urb, Urb, Uh, Urb, Urb, Xv, Xv, Qxua, Qxua, Qlf, Qlf, Qlf, Qxua, Xv, Xv, Wwt, Wwt, Wwt, Wwrt, Wwrt, Wwrt, Wwrt, Sm, Sm, Ss, Ss, Gs^Ft, Gs^Ft, Gs^Ft
Ms, Ms, Ms, Ms, Ms, Mv, Ms, Qxua, Rrc, Qxua^Bsb/, Qxua, Xv, Xv, Uu^Uf, Uu^Uf, Urb, Uu, Uu, Uu, Uu^Vu, Urb, Urb^Emf, Urb^Emf, Urb^Emf, Urb^Emf, Urb^Emf, Uue^Emf, Uue, Urb, Urb, Uu^Uf, Urb, Uh, Uh, Uh, Urb, Urb, Qxua^Bw\, Qxua^Bw\, Xv, Qxua, Qxua, Qxua, Qxua, Qxua, Qxua, Wwt, Wwt, Wwt, Wwt, Wwrt, Wwrt, Wwrt, Wwrt, Sm, Ss^Vhs, Ss, Ss, Gs^Ft, Gs^Ft, Gs^Ft
Ms, Ms, Ms, Ms, Ms, Ms, Rrc, Rrc, Aa^Fpa, Aa^Fpa, Ha^Fma, Qxua, Qxua, Xv, Xv, Uu, Uh, Uu, Uu^Uf, Urb, Urb, Urb^Emf, Urb^Emf, Urb^Emf, Uue^Emf, Uue^Emf, Urb^Emf, Urb^Emf, Urb, Urb, Urb, Urb, Uh, Uh, Urb, Uu^Vu, Xuc, Xuc, Xuc, Hd^Bw\, Hd^Bw\, Qxua, Qxua, Qxua, Qxua, Qxua, Wwt, Wwt, Wwt, Wwt, Wwrt, Wwrt, Wwrt, Sm, Sm, Sm, Sm, Gs^Ft, Gs^Ft, Gs^Ft, Gs^Ft
Ms, Ms, Ms, Ms, Ms, Ms, Rrc, Ha^Vhha, Aa^Fpa, Aa^Fpa, Ha^Fma, Ha^Fma, Qxua, Xv, Xv, Xv, Uh, Uh, Uu^Uf, Uu^Uf, Uu^Uf, Urb, Urb, Urb^Emf, Uue^Emf, Urb^Emf, Urb^Emf, Urb^Emf, Urb, Uu^Uf, Uu^Uf, Uu, Urb, Uh, Urb, Urb, Xuc, Xuc, Xuc, Xv, Xv, Hd^Bw\, Qxua^Bw\, Qxua, Qxua, Qxua, Wwt, Wwt, Wwt, Wwt, Wwt, Wwrt, Sm, Sm, Sm, Sm, Ss, Gs^Vht, Gs^Ft, Gs^Ft, Gs^Ft
Ms, Ms, Ms, Ms, Ms, Aa^Fpa, Rrc, Aa^Fpa, Aa^Fpa, Ha^Fma, Ha^Fma, Ha^Fma, Aa^Fma, Qxua, Xv, Xv, Xuc, Uh, Uu, Urb, Uu, Urb, Urb, Urb, Uue, Urb^Emf, Cud, Kud, Uu^Uf, Uu^Uf, Uu, Uu, Uu^Vu, Uh, Urb, Xuc, Xuc, Xuc, Xv, Xv, Xv, Xv, Qxua, Qxua^Bw\, Qxua^Bw\, Qxua, Qxua, Wwt, Wwt, Wwt, Wwt, Wwrt, Wwrt, Sm, Sm, Sm, Ss, Gs^Ft, Gs^Ft, Gs^Ft, Gs^Ft
Ms, Ms, Aa^Fpa, Aa^Fpa, Rrc, Rrc, Aa^Fpa, Rrc, Rrc, Ha^Fma, Ha^Fma, Ha^Fma, Aa^Fma, Qxua, Xv, Xv, Xuc, Uh, Urb, Urb, Urb, Uh, Uh, Urb, Urb, Urb, Cud, Cud, Uu, Uu, Uu, Uu, Urb, Urb, Xuc, Xuc, Xv, Xv, Xv, Xv, Qxua, Qxua, Qxua, Qxua, Qxua, Qxua^Bw\, Wwt, Wwt, Wwf, Wwt, Wwrt, Wwrt, Wwrt, Wwrt, Wwf, Wwf, Ss, Gs^Ft, Gs^Ft, Gs^Ft, Gs^Ft
Rrc, Aa^Fpa, Rrc, Rrc, Aa^Fpa, Aa^Fpa, Ha^Fma, Ha^Fma, Ha^Fma, Rrc, Ha^Fma, Ha^Fma, Aa^Fma, Qxua, Xv, Xv, Xuc, Xuc, Uu^Uf, Urb, Uu^Uf, Urb, Uh, Urb, Uue, Uu^Vu, Urb, Cud, Urb, Uu, Urb, Xuc, Xuc, Xuc, Xuc, Xuc, Xv, Xv, Xv, Qxua, Qxua, Qxua, Qxua, Qxua, Qxua, Qxua, Wwt, Wwrt, Wwt, Wwf, Wwf, Wwrt, Wwf, Wwf, Wwf, Wwf, Wwf, Gs^Ft, Gs^Ft, Gs^Ft, Gs^Ft
Ha^Fma, Rrc, Aa^Fpa, Aa^Fpa, Aa^Fpa, Ha^Vhha, Aa^Fma, Ha^Fma, Ha^Fma, Rrc, Ha^Fma, Ha^Fma, Aa^Fma, Qxua, Xv, Xv, Xuc, Xuc, Xuc, Xuc, Xuc, Uh, Uh, Urb, Urb, Urb, Uu, Uu, Uu, Uu, Urb, Xuc, Xuc, Xuc, Xuc, Xuc, Xv, Xv, Xv, Qxua, Qxua, Qxua, Qxua, Qxua, Wwt, Wwt, Wwt, Wwt, Wwt, Wwt, Wwrt, Wwf, Wwrt, Wwf, Sm, Wwf, Chs, Gs^Ft, Chs, Gs^Ft, Gs^Ft
Ha^Fma, Aa^Fpa, Aa^Fpa, Aa^Fpa, Aa^Fpa, Aa^Fpa, Ai, Aa^Fma, Ha^Fma, Rrc, Rrc, Ha^Fma, Aa^Fma, Qxua, Qxua, Xv, Xv, Xuc, Xuc, Xuc, Xuc, Xuc, Xuc, Uh, Uh, Uh, Uh, Uh, Uh, Uh, Xuc, Xuc, Xuc, Xuc, Xv, Xv, Xv, Xv, Qxua, Qxua, Qxua, Qxua, Wwt, Wwt, Wwt, Wwt, Wwt, Ww^Vm, Wwt, Wwt, Wwt, Wwrt, Wwrt, Sm, Sm, Ss, Chs, Khw, Chs, Chs, Gs^Ft
Ha^Fma, Aa^Fma, Aa^Fma, Aa^Fma, Aa, Aa^Fma, Ha^Fma, Ha^Fma, Ha^Fma, Ha^Fma, Aa^Fma, Rrc, Aa^Fma, Qxua, Qxua, Xv, Qxua, Xv, Xv, Xuc, Xuc, Xuc, Xuc, Xuc, Xuc, Xuc, Xuc, Xuc, Xuc, Xuc, Xuc, Xuc, Xv, Xv, Xv, Xv, Gs^Fdw, Qxua, Qxua, Qxua, Wwt, Wwt, Wwt, Wwt, Wwt, Wwt, Wwt, Wwt, Wwt, Wwt, Wwrt, Wwrt, Wwrt, Wwrt, Sm, Ss, Gs^Ft, Chs, Gs^Ft, Gs^Ft, Gs^Ft
Ai, Aa^Fma, Aa^Fma, Aa^Fma, Aa^Fma, Ha^Fma, Ha^Fma, Ha^Fma, Aa^Fma, Aa, Aa^Fma, Rrc, Aa^Fma, Qxua, Qxua, Qxua, Aa, Xv, Xv, Xv, Xv, Xuc, Xuc, Xuc, 3 Xv, Xuc, Xv, Xuc, Xuc, Xuc, Xuc, Xv, Xv, Xv, Gs^Fdw, Gs^Edp, Gs^Fdw, Qxua, Qxua, Qxua, Wwt, Wwt, Wwt, Wwt, Wwt, Wwt, Wwt, Wwt, Wwt, Wwt, Wwrt, Wwrt, Sm, Sm, Sm, Ss, Ss, Gs^Ft, Gs^Ft, Gs^Vht, Gs^Ft
Aa, Ha^Vhha, Aa, Aa^Fma, Ha^Fma, Ha^Fma, Aa^Fma, Aa^Fma, Aa^Fma, Aa^Fma, Aa^Vha, Rrc, Aa, Aa, Aa, Ai, Ai, Aa, Aa, Xv, Xv, Xv, Xv, Xv, Xv, Xv, Xv, Xv, Xv, Xv, Xv, Xv, Xv, Xv, Gd^Fetd, Gd^Fdf, Gd^Fetd, Qxua, Qxua, Qxua, Qxua, Wwt, Wwt, Wwt, Wwt, Wwt, Wwt, Wwt, Wwt, Wwt, Wwt, Wwrt, Wwrt, Sm, Wwrt, Sm, Sm, Ss, Ss, Gs^Ft, Gs^Ft
Aa^Fma, Aa^Fma, Ha^Fma, Ha^Fma, Aa^Fma, Aa^Fma, Aa, Aa^Fma, Aa^Fma, Aa^Fma, Aa^Fma, Rrc, Rrc, Ai, Ai, Aa^Es, Aa, Ai, Aa, Aa^Es, Ai, Xv, Xv, Xv, Xv, Xv, Qxua, Xv, Xv, Xv, Qxua, Xv, Gs^Fdw, Gd^Fetd, Gs^Fdw, Gs^Fdw, Qxua, Qxua, Qxua, Qxua, Qxua, Wwt, Wwt, Wwt, Wwt, Wwt, Wwt, Wwt, Wwt, Wwt, Wwt, Wwrt, Wwrt, Wwrt, Wwrt, Wwrt, Sm, Ss, Ss, Ss, Wwf
Ha^Fma, Ha^Fma, Aa^Fma, Aa, Aa^Fma, Aa, Ai, Aa^Fma, Ai, Aa^Vha, Aa^Fma, Aa^Fma, Aa^Fma, Rrc, Rrc, Aa^Fma, Aa^Fma, Aa^Fma, Ai, Aa, Aa, Ai, Ai, Xv, Xv, Qxua, Qxua, Qxua, Qxua, Qxua, Qxua, Qxua, Qxua, Gs^Fdw, Qxua, Qxua, Qxua, Qxua, Qxua, Qxua, Qxua, Qxua, Qxua, Wwt, Wwt, Wwt, Wwt, Wwt, Wwt, Wwt, Wwt, Wwt, Wwt, Wwrt, Wwrt, Wwrt, Sm, Sm, Sm, Wwf, Sm
Ha^Fma, Ha^Fma, Aa, Aa^Fma, Aa^Fma, Aa, Aa, Ai, Aa, Ai, Ai, Aa^Fma, Aa^Fma, Ai, Ai, Rrc, Aa, Aa^Fma, Aa, Ai, Aa, Aa, Ai, Aa, Aa^Fma, Xv, Aa, Qxua, Qxua, Qxua, Qxua, Qxua, Qxua, Qxua, Qxua, Qxua, Qxua, Qxua, Qxua, Qxua, Qxua, Qxua, Qxua, Qxua, Qxua, Wwt, Wwt, Wwt, Wwt, Wwt, Wwt, Wwt, Ww^Vm, Wwt, Wwt, Wwt, Wwt, Wwrt, Wwf, Wwf, Wwt
Ha^Fma, Aa^Fma, Aa^Fma, Aa^Fma, Aa^Fma, Ai^Es, Aa, Ai, Aa^Fma, Aa, Aa^Fma, Ai, Aa, Aa^Fma, Cha, Rrc, Ai, Aa, Ai, Aa, Ai, Aa, Aa, Aa, Aa^Vha, Aa^Fma, Aa^Fma, Aa, Aa, Aa, Aa, Qxua, Qxua, Qxua, Qxua, Qxua, Qxua, Qxua, Qxua, Qxua, Qxua, Qxua, Qxua, Qxua, Qxua^Bw/, Qxua^Bw/, Qxua, Wwt, Wwt, Wwt, Wwt, Wwt, Wwt, Wwt, Wwt, Wwt, Wwt, Wwf, Wwt, Wwt, Wwt
Aa, Aa, Aa^Fma, Aa^Fma, Aa, Aa^Fma, Aa^Fma, Aa^Fma, Aa^Fma, Aa^Fma, Aa, Aa^Fma, Aa, Kha, Cha, Rrc, Rrc, Ai, Ai, Ai, Ai, Aa^Es, Aa, Aa^Fma, Aa^Fma, Aa^Fma, Aa^Fma, Aa^Fma, Aa^Fma, Aa, Aa, Aa, Aa, Qxua, Qxua, Qxua, Qxua, Qxua, Qxua, Qxua, Qxua, Qxua, Qxua^Bw/, Qxua^Bw/, Qxua, Qxua, Qxua, Qxua, Qxua, Wwt, Wwt, Wwt, Wwt, Wwt, Wwt, Wwt, Wwrt, Wwrt, Wwt, Wwt, Wwt
Aa, Aa, Aa^Fma, Aa^Vha, Ai, Aa^Fma, Aa, Aa^Fma, Aa^Fma, Ai, Ai, Ai, Aa, Aa, Aa, Cha, Aa, Rrc, Rrc, Ai, Aa, Aa, Aa, Aa^Fma, Aa^Fma, Aa^Fma, Aa^Fma, Aa^Fma, Aa^Fma, Aa^Fma, Aa^Fma, Aa, Aa, Aa, Aa, Qxua, Qxua, Qxua, Qxua, Qxua, Qxua^Bw/, Qxua^Bw/, Xv, Qxua^Bw\, Qxua^Bw\, Qxua, Qxua, Qxua, Qxua, Wwt, Qxua, Wwt, Qxua, Wwt, Wwt, Wwt, Wwt, Wwt, Wwt, Wwt, Wwt
Aa, Aa, Aa^Fma, Ai, Ai, Aa, Aa, Aa, Aa, Aa, Aa, Aa, Aa, Aa^Vha, Aa, Aa, Aa^Es, Aa, Aa, Rrc, Rrc, Rrc, Rrc, Rrc, Rrc, Aa^Fma, Rrc, Aa^Fma, Aa^Fma, Aa^Fma, Rrc, Aa, Aa, Aa^Es, Aa, Aa, Aa, Aa, Rrc, Qxua^Bw/, Qxua, Xv, Xv, Xv, Qxua, Qxua^Bw\, Qxua^Bw\, Qxua, Qxua, Qxua, Qxua, Qxua, Qxua, Qxua, Qxua, Wwt, Qxua, Wwt, Qxua, Wwt, Wwt
Ai, Ai, Aa, Aa, Aa, Aa, Aa, Ai, Aa, Aa^Es, Aa, Aa, Aa, Aa, Aa, Aa, Ai, Aa, Ai, Aa, Aa, Aa, Aa, Aa, Aa, Rrc, Aa^Fma, Rrc, Rrc, Rrc, Aa, Rrc, Rrc, Ai, Ai, Aa, Rrc, Rrc, Aa, Aa, Qxua, Xv, Xv, Xv, Xv, Qxua, Qxua, Qxua^Bw\, Rd, Dd, Dd, Dd, Dd, Qxua, Qxua, Qxua^Bw|, Qxua, Qxua, Qxua, Qxua, Qxua
Ai, Ai, Aa, Aa, Ai, Aa, Aa, Aa, Ai, Aa, Ai, Aa, Ai, Aa, Ai, Ai, Ai, Ai, Ai, Ai, Aa, Aa^Vha, Aa, Aa, Aa, Aa, Aa, Aa, Aa^Vha, Aa, Aa, Aa, Aa, Rrc, Rrc, Rrc, Ai, Aa, Aa, Aa, Aa, Qxua, Qxua, Xv, Xv, Xv, Qxua, Qxua, Dd, Rd, Rd, Dd, Dd, Dd, Dd, Rd, Dd, Qxua, Dd, Qxua, Qxua
Ai, Ai, Aa, Aa, Aa, Aa, Ai, Ai, Ai, Ai, Xv, Xv, Xv, Ai, Xv, Ai, Qxua, Ai, Qxua, Qxua, Qxua, Aa, Aa, Aa, Qxua, Aa, Aa, Aa, Aa, Aa, Aa, Aa, Ai, Ai, Rrc, Ai, Ai, Aa, Aa, Aa, Aa, Aa, Qxua, Xv, Xv, Xv, Qxua, Dd, Dd, Dd, Dd, Rd, Rd, Dd, Rd, Rd, Dd, Dd, Dd, Dd, Dd
Xv, Ai, Xv, Ai, Xv, Ai, Xv, Xv, Xv, Xv, Xv, Xv, Xv, Xv, Xv, Qxua, Qxua, Qxua, Qxua, Qxua, Qxua, Qxua, Qxua, Qxua, Qxua, Qxua, Qxua, Aa, Aa, Aa^Es, Aa, Aa, Rrc, Rrc, Aa, Aa, Aa, Aa, Aa, Aa^Es, Aa, Aa, Qxua, Xv, Xv, Xv, Qxua, Dd, Dd, Dd, Dd^Vda, Dd, Dd, Rd, Dd, Dd, Dd^Vda, Dd, Dd, Dd, Dd
Xv, Xv, Xv, Xv, Xv, Xv, Xv, Xv, Xv, Xv, Xv, Xv, Xv, Xv, Xv, Xv, Xv, Xv, Xv, Xv, Xv, Qxua, Qxua, Qxua, Xv, Qxua, Qxua, Qxua, Qxua, Aa, Rrc, Rrc, Aa, Aa, Aa, Aa, Aa, Aa, Aa, Aa^Vha, Aa, Aa, Aa, Xv, Xv, Xv, Qxua, Dd, Dd, Dd, Dd, Dd, Rd, Rd, Rd, Dd, Dd, Dd, Dd, Dd, Dd
Xv, Xv, Xv, Xv, Xv, Xv, Xv, Xv, Xv, Xv, Xv, Xv, Xv, Xv, Xv, Xv, Xv, Xv, Xv, Xv, Xv, Xv, Xv, Xv, Xv, Xv, Qxua, Qxua, Qxua^Bw/, Qxua^Bw/, Qxua, Aa, Aa, Aa, Aa^Es, Aa, Aa, Aa, Aa^Es, Aa, Aa, Aa, Xv, Xv, Xv, Xv, Qxua, Dd, Dd, Dd, Rd, Rd, Dd, Dd, Dd, Rd, Dd, Dd, Dd, Dd^Vda, Dd
Wwt, Wwt, Wwt, Wwt, Wwt, Wwt, Wwt, Wwt, Wwt, Wwt, Wwt, Wwt, Wwt, Wwt, Wwt, Wwt, Wwt, Wwt, Wwt, Wwt, Wwt, Wwt, Wwt, Xv, Wwt, Xv, Wwg^Bw/, Qxua^Bw/, Qxua, Qxua, Xv, Qxua, Qxua, Qxua, Qxua, Aa, Aa, Aa, Aa, Aa, Xv, Xv, Xv, Xv, Xv, Xv, Qxua, Dd, Dd, Dd, Rd, Dd, Dd, Dd, Dd, Rd, Rd, Dd, Dd, Dd, Dd
Wwt, Wwt, Wwt, Wwt, Wwt, Wwt, Gg, Wwt, Wwt, Wwt, Wwt, Wwt, Wwt, Wwt, Wwt, Wwt, Gg, Wwt, Wwt, Wwt, Gg, Wwt, Wwt, Wwt, Wwt^Bw/, Wwg^Bw/, Xv, Xv, Xv, Xv, Xv, Xv, Xv, Qxua, Qxua, Qxua, Qxua, Qxua, Qxua, Xv, Xv, Xv, Xv, Xv, Qxua, Xv, Qxua, Qxua, Qxua^Bsb/, Rd, Dd, Dd, Dd, Dd, Dd, Dd, Dd, Rd, Rd, Dd, Dd
Gg, Wwt, Gs^Fds, Wwt, Gs^Fds, Gg, Gg^Efm, Gg^Efm, Gg, Gg, Wwt, Wwt, Wwt, Wwt, Wwt, Gg^Efm, Gg^Efm, Gg, Gs^Fds, Gg, Gs^Fms, Gs^Fms, Gs^Fms, Wwt^Bw/, Wwt, Wwt, Wwt, Xv, Xv, Xv, Xv, Xv, Xv, Xv, Xv, Qxua, Xv, Qxua, Xv, Xv, Xv, Xv, Qxua, Qxua, Qxua, Qxua, Qxua^Bsb/, Qxua^Bsb/, Qxua, Qxua, Dd, Dd, Dd, Dd, Dd^Vda, Dd, Dd, Dd, Dd, Rd, Dd
Gs^Fds, Gs^Fds, Gg, Gs^Fds, Gs^Fms, Gs^Fds, Gs^Fms, Gs^Fms, Gs^Fms, Gs^Fms, Gs^Fms, Wwt, Wwt, Wwt, Gs^Fms, Gs^Fds, Gg^Fet, Gs^Fds, Gs^Fms, Gs^Fds, Gs^Fds, Gs^Fms, Gs^Fds, Gs^Fds, Gs^Fds, Gg, Wwt, Wwt, Wwt, Xv, Xv, Xv, Xv, Xv, Xv, Xv, Xv, Xv, Xv, Xv, Qxua, Qxua, Ch, Kh, Rrc, Qxua^Bsb/, Qxua, Qxua, Qxua, Qxua, Qxua, Dd, Dd, Dd, Dd, Dd, Dd, Dd, Dd, Rd, Rd
Gs^Fds, Gs^Fds, Gg^Ve, Gs^Fms, Gs^Fms, Gs^Fms, Gg^Fet, Gs^Fms, Gs^Fms, Gs^Fms, Gs^Fds, Gs^Fms, Gs^Fms, Gs^Fms, Gs^Fms, Gs^Fms, Gs^Fms, Gs^Fms, Gs^Fms, Gg^Ve, Gs^Fms, Gs^Fms, Gg, Gg, Wwt, Wwt, Gg, Gg, Gg, Wwt, Wwt, Xv, Xv, Xv, Xv, Xv, Xv, Xv, Xv, Xv, Qxua, Qxua, Ch, Rrc, Rrc, Kh, Ch, Qxua, Ch, Qxua, Qxua, Qxua, Qxua, Dd, Dd, Dd, Dd, Dd, Dd, Dd, Rd
Gs^Fms, Gg, Gs^Fms, Gs^Fms, Gs^Fms, Gs^Fds, Gs^Fms, Gs^Fms, Gs^Fms, Gs^Fms, Gg, Gs^Fds, Gs^Fds, Gs^Fms, Gg, Gs^Fms, Gs^Fds, Gs^Fds, Gs^Fms, Gs^Fms, Gg^Efm, Gg^Efm, Wwt, Wwt, Gg, Gs^Fms, Gg, Gg^Efm, Gs^Fds, Gs^Fms, Gg, Wwt, Wwt, Xv, Xv, Xv, Xv, Xv, Qxua, Qxua, Qxua, Ch, Rrc, Rrc, Rr^Vhc, Rrc, Rrc, Ch, Rrc, Ch, Qxua, Qxua, Qxua, Qxua, Qxua, Dd, Dd, Dd, Dd, Dd, Dd
Gg^Efm, Gs^Fms, Gs^Fds, Gs^Fds, Gs^Fds, Gs^Fms, Gs^Fds, Gg^Efm, Gg^Efm, Gs^Fms, Gs^Fms, Gs^Fds, Gg, Gg^Efm, Gg^Efm, Gs^Fds, Gs^Fds, Gg^Efm, Gg, Gg, Gg, Gg, Wwt, Gg, Gs^Fds, Gs^Fms, Gs^Fds, Gg^Ve, Gs^Fms, Gs^Fds, Gs^Fms, Gg, Gg, Wwt, Xv, Xv, Xv, Xv, Qxua, Qxua, Qxua, Ch, Rrc, Rrc, Rrc, Rrc, Rr^Vhc, Rrc, Rrc, Ch, Ch, Qxua, Qxua, Qxua, Qxua, Qxua, Qxua, Dd, Dd, Dd, Dd
Gg, Gg^Efm, Gs^Fds, Gg^Efm, Gs^Fds, Gs^Fms, Gs^Fms, Gs^Fds, Gs^Fds, Gs^Fds, Gs^Fds, Gg^Ve, Gg, Gs^Fds, Gs^Fms, Gg, Gg, Gg, Cv, Cv, Kv, Gg, Wwt, Gg, Gs^Fds, Gs^Fds, Gg^Efm, Gg, Gg, Gs^Fms, Gs^Fds, Gs^Fms, Gg^Efm, Wwt, Wwt, Xv, Xv, Xv, Xv, Qxua, Ch, Ch, Rrc, Rrc, Rrc, Rrc, Rrc, Rrc, Rrc, Rrc, Ch, Ch, Ch, Qxua, Qxua, Qxua, Qxua, Dd, Dd, Dd, Dd
Gs^Fds, Gs^Fms, Gs^Fms, Gs^Fds, Gs^Fms, Gs^Fms, Gs^Fds, Gs^Fms, Gs^Fms, Gs^Fms, Gs^Fms, Gs^Fms, Gs^Fms, Gs^Fms, Gs^Fms, Gg, Kv, Kv, Wwt, Wwt, Wwt, Wwt, Cv, Gg, Gg, Gs^Fds, Gs^Fds, Gg^Efm, Gs^Fds, Gg^Efm, Gs^Fms, Gs^Fds, Gs^Fms, Gg, Gg, Wwt, Xv, Xv, Xv, Xos, Rrc, Rrc, Rr^Vhc, Rrc, Rrc, Rrc, Ch, Kh, Ch, Ch, Ch, Ch, Ch, Ch, Qxua, Qxua, Qxua, Qxua, Qxua, Dd, Dd
Gs^Fds, Gs^Fms, Gs^Fms, Gg, Gs^Fds, Gs^Fds, Gs^Fds, Gs^Fds, Gg^Efm, Gg, Gs^Fds, Gs^Fms, Gs^Fds, Gs^Fms, Gs^Fds, Gg, Kv, Wwt, Wwt, Kv, Cv, Wwt, Wwt, Cv, Gg^Efm, Gg^Efm, Gs^Fds, Gs^Fds, Gs^Fds, Gs^Fds, Gs^Fds, Gs^Fms, Gg, Gg^Efm, Gg^Efm, Wwt, Wwt, Xv, Xv, Xos, Rrc, Rrc, Rrc, Rrc, Ch, Ch, Rrc, Ch, Rrc, Ch, Rrc, Ch, Rrc, Ch, Ch, Qxua, Qxua, Qxua, Qxua, Qxua, Qxua
Gg, Gs^Fms, Gs^Fms, Gg^Fet, Gs^Fds, Gg^Efm, Gs^Fds, Gs^Fms, Gs^Fms, Gg^Efm, Gg, Gs^Fds, Gs^Fds, Gs^Fds, Gs^Fds, Gg, Kv, Wwt, Cv, Cv, Gg, Cv, Wwt, Kv, Gg^Efm, Gs^Fds, Gg, Gs^Fms, Gg, Gs^Fms, Gg^Fet, Gs^Fms, Gg^Efm, Gg, Gg, Wwt, Wwt, Xv, Xv, Xos, Xos, Rrc, Ch, Ch, Rrc, Rrc, Rrc, Rrc, Rrc, Rrc, Rrc, Rr^Vhc, Rrc, Rrc, Rrc, Ch, Ch, Qxua, Qxua, Qxua, Qxua
Gg, Gg^Efm, Gs^Fms, Gs^Fds, Gs^Fms, Gs^Fms, Gs^Fds, Gs^Fms, Gs^Fds, Gs^Fds, Gs^Fds, Gs^Fds, Gs^Fds, Gg, Cv, Cv, Wwt, Wwt, Wwt, Cv, Cv, Cv, Cv, Kv, Gs^Fds, Gs^Fds, Gs^Fms, Gg^Ve, Gs^Fds, Gs^Fds, Gs^Fms, Gs^Fms, Gs^Fms, Gg, Gs^Fds, Wwt, Wwt, Xv, Xv, Xv, Xos, Ch, Rrc, Rrc, Rrc, Rrc, Rrc, Rrc, Rrc, Rrc, Rrc, Rrc, Rrc, Rrc, Rrc, Rrc, Ch, Qxua, Qxua, Qxua, Qxua
Gs^Fds, Gs^Fds, Gs^Fms, Gs^Fms, Gg^Ve, Gs^Fds, Gs^Fds, Gs^Fms, Gg^Fet, Gs^Fms, Gs^Fds, Gs^Fds, Gg, Cv, Wwt, Wwt, Wwt, Wwt, Cv, Cv, Cv, Cv, Cv, Cv, Gg^Efm, Gs^Fms, Gg, Gg, Gs^Fds, Gs^Fms, Gs^Fds, Gs^Fms, Gs^Fms, Gs^Fds, Gs^Fds, Gs^Fms, Wwt, Wwt, Xv, Xv, Xv, Xos, Rrc, Rrc, Rrc, Rr^Vhc, Rrc, Rr^Vhc, Rrc, Rrc, Rrc, Rrc, Rr^Vhc, Rrc, Rrc, Rrc, Rrc, Ch, Ch, Qxua, Qxua
Gg^Efm, Gs^Fds, Gs^Fds, Gs^Fms, Gs^Fds, Gs^Fds, Gg, Gs^Fds, Gg, Gs^Fms, Gs^Fds, Gg, Gg, Cv, Wwt, Wwt, Cv, Cv, Kv, Kv, Gg, Cv, Gg, Gs^Fds, Gs^Fds, Gs^Fms, Gs^Fds, Gs^Fds, Gs^Fds, Gs^Fds, Gs^Fms, Gs^Fds, Gs^Fds, Gg^Ve, Gg^Efm, Wwt, Wwt, Wwt, Wwt, Xv, Xv, Xos, Rrc, Rrc, Rrc, Rrc, Rrc, Rrc, Rrc, Rrc, Rrc, Rrc, Rrc, Rrc, Rrc, Rrc, Rr^Vhc, Rrc, Rrc, Ch, Ch
Gg, Gs^Fds, Gg^Efm, Gg^Efm, Gg, Gs^Fds, Gg^Fet, Gs^Fds, Gs^Fms, Gs^Fds, Gg, Gs^Fds, Gg, Kv, Wwt, Cv, Cv, Gg, Cv, Kv, Cv, Cv, Gg, Gg^Efm, Gg, Gs^Fms, Gs^Fms, Gs^Fds, Gs^Fds, Gs^Fms, Gg^Fet, Gs^Fds, Gs^Fds, Gg^Efm, Gs^Fds, Gs^Fds, Wwt, Wwt, Xv, Xv, Xv, Xos, Rrc, Rrc, Rrc, Rrc, Rrc, Rrc, Rrc, Rrc, Rr^Vhc, Rrc, Rrc, Rrc, Rrc, Rrc, Rrc, Rrc, Rrc, Rrc, Rrc
Gg, Gg^Efm, Gs^Fds, Gs^Fds, Gs^Fms, Gs^Fds, Gs^Fms, Gs^Fds, Gg, Gg, Gg, Gg, Gg, Gg, Wwt, Gg, Cv, Gg, Gg, Cv, Gs^Fms, Gs^Fms, Gs^Fms, Gg^Efm, Gg, Gs^Fms, Gs^Fms, Gs^Fds, Gs^Fds, Gs^Fds, Gs^Fds, Gs^Fds, Gs^Fds, Gg^Efm, Gs^Fds, Gs^Fds, Wwt, Wwt, Xv, Xv, Xv, Xos, Xos, Rrc, Rrc, Rrc, Rr^Vhc, Rrc, Rrc, Rrc, Rrc, Rrc, Rrc, Rrc, Rrc, Rrc, Rrc, Rrc, Rrc, Rrc, Rrc
Gs^Fds, Gs^Fds, Gg^Fet, Gs^Fds, Gs^Fds, Gs^Fds, Gg^Ve, Gs^Fds, Gg, Gg, Gg, Gg, Gg, Gg, Wwt, Gg, Gg, Gg, Gs^Fms, Gs^Fms, Gg, Gg^Efm, Gg, Gs^Fms, Gs^Fms, Gs^Fms, Gs^Fms, Gs^Fds, Gg, Gs^Fds, Gs^Fds, Gs^Fds, Gs^Fms, Gs^Fds, Gs^Fms, Gs^Fds, Wwt, Wwt, Wwt, Xv, Xv, Xv, Xos, Rrc, Rrc, Rrc, Rrc, Rrc, Rrc, Rrc, Rrc, Rrc, Rr^Vhc, Rrc, Rrc, Rrc, Rrc, Rr^Vhc, Rrc, Rrc, Rrc
Gs^Fms, Gs^Fds, Gs^Fds, Gs^Fds, Gg, Gg, Gg, Gg, Gg, Gg, Gg^Efm, Gg, Gs^Fds, Gg, Gg, Wwt, Gs^Fms, Gs^Fms, Gs^Fms, Gs^Fms, Gs^Fds, Gg, Gs^Fds, Gs^Fds, Gs^Fms, Gg, Gs^Fds, Gg^Ve, Gs^Fds, Gs^Fds, Gg, Gs^Fms, Gs^Fms, Gs^Fds, Gg^Efm, Gs^Fms, Gs^Fms, Wwt, Wwt, Xv, Xv, Xv, Xv, Xos, Rrc, Rrc, Rrc, Rrc, Rrc, Rrc, Rrc, Rrc, Rrc, Rrc, Rrc, Rrc, Rrc, Rrc, Rrc, Rrc, Rrc
Gs^Fds, Gs^Fds, Gg, Gg, Gg^Efm, Gg^Efm, Gg^Efm, Gg^Efm, Gg^Efm, Gg^Efm, Gg, Gs^Fds, Gs^Fds, Gs^Fds, Gs^Fds, Wwt, Gs^Fms, Gs^Fms, Gs^Fds, Gg^Fet, Gs^Fds, Gs^Fds, Gg^Fet, Gs^Fds, Gs^Fms, Gs^Fds, Gs^Fds, Gs^Fds, Gg^Efm, Gs^Efm, Gs^Fms, Gs^Fms, Gg, Gs^Fms, Gs^Fms, Gg, Gg, Wwt, Wwt, Wwt, Xv, Xv, Xv, Xos, Rrc, Rrc, Rrc, Rrc, Rrc, Rrc, Rrc, Rrc, Ch, Rrc, Ch, Rrc, Ch, Ch, Ch, Rrc, Rrc
Gs^Fds, Gs^Fms, Gg, Gg^Efm, Gg^Efm, Gg^Efm, Gg^Efm, Gg^Efm, Gg^Efm, Gg, Gg, Gg, Gs^Fds, Gg^Fet, Gs^Fds, Wwt, Gg, Gs^Fms, Gs^Fms, Gs^Fds, Gs^Fds, Gs^Fds, Gs^Fds, Gs^Fms, Gs^Fds, Gs^Fds, Gs^Fms, Gs^Fds, Gs^Fds, Gs^Fds, Gs^Fds, Gs^Fms, Gs^Fds, Gg^Efm, Gs^Fms, Gs^Fms, Gs^Fms, Gs^Fms, Wwt, Wwt, Wwt, Xv, Xv, Xos, Rrc, Rrc, Rrc, Rr^Vhc, Rrc, Rrc, Rrc, Rrc, Ch, Ch, Ch, Ch, Ch, Ch, Kh, Ch, Ch
Gs^Fds, Gs^Fds, Gg, Gg^Efm, Gg^Efm, 1 Gg^Efm, Gg^Efm, Gg^Efm, Gg^Efm, Gg^Efm, Gg, Gg, Gs^Fds, Gs^Fds, Gs^Fds, Wwt, Wwt, Gs^Fms, Gs^Fms, Gs^Fms, Gg, Gs^Fms, Gs^Fds, Gs^Fms, Gs^Fds, Gs^Fds, Gs^Fds, Gs^Fds, Gs^Fds, Gg, Gs^Fds, Gs^Fds, Gs^Fds, Gg, Gs^Fms, Gs^Fms, Gs^Fms, Gg^Fet, Gs^Fms, Wwt, Wwt, Xv, Xv, Xos, Xos, Rrc, Rrc, Rrc, Rrc, Rrc, Ch, Ch, Ch, Ch, Ch, Kh, Kh, Kh, Kh, Kh, Kh
Gs^Fds, Gg, Gg, Gg^Efm, Gg^Efm, Gg^Efm, Gg^Efm, Gg^Efm, Gg, Gg, Gs^Fds, Gs^Fds, Gg^Ve, Gs^Fds, Gs^Fds, Gs^Fds, Wwt, Gg, Gs^Fms, Gg^Efm, Gs^Fms, Gs^Fms, Gs^Fms, Gg^Fet, Gs^Fds, Gs^Fms, Gg, Gs^Fms, Gg, Gs^Fds, Gs^Fds, Gs^Fds, Gg^Ve, Gs^Fds, Gs^Fms, Cv, Cv, Gs^Fms, Gs^Fms, Wwt, Wwt, Xv, Xv, Xv, Xos, Rrc, Rrc, Rrc, Rrc, Rrc, Ch, Ch, Ch, Ch, Kh, Kh, Kh, Kh, Kh, Kh, Kh
Gs^Fds, Gg, Gg, Gg, Gg, Gg, Gg, Gg, Gs^Fds, Gs^Fds, Gs^Fds, Gs^Fms, Gs^Fds, Gs^Fds, Gg^Fet, Gs^Fds, Gs^Fds, Wwt, Wwt, Gg, Gs^Fms, Gs^Fms, Gg^Ve, Gs^Fds, Gs^Fds, Gs^Fds, Gs^Fds, Gs^Fds, Gs^Fds, Gs^Fds, Gs^Fms, Gs^Fds, Gg, Gg, Cv, Cv, Kv, Cv, Gg, Wwt, Wwt, Xv, Xv, Xv, Xos, Rrc, Rrc, Rr^Vhc, Rrc, Rrc, Rrc, Ch, Ch, Ch, Kh, Kh, Kh, Kh, Kh, Kh, Kh
Gs^Fds, Gs^Fds, Gs^Fds, Gs^Fds, Gs^Fds, Gs^Fds, Gs^Fds, Gs^Fms, Gs^Fds, Gg^Fet, Gs^Fds, Gs^Fds, Gs^Fds, Gs^Fds, Gs^Fds, Gs^Fds, Gs^Fds, Gs^Fds, Wwt, Gs^Fms, Gg, Gs^Fms, Gg, Gs^Fms, Gs^Fms, Gg, Gs^Fms, Gs^Fms, Gg, Gs^Fms, Gs^Fms, Gg, Gg, Gg, Gs^Fms, Cv, Cv, Cv, Gs^Fms, Wwt, Wwt, Xv, Xv, Xv, Xos, Rrc, Rrc, Rrc, Rrc, Rrc, Rrc, Ch, Ch, Kh, Kh, Kh, Kh, Kh, Kh, Kh, Kh
