border_size=1
usage=map

Xu, Xu, Xu, Xu, Xu, Xu, Xu, Xu, Xu, Xu, Xu, Xu, Xu, Xu, Xu, Xu, Xu, Xu, Xu, Xu, Xu, Xu, Xu, Xu, Xu, Xu, Xu, Xu, Xu, Xu, Xu, Xu, Xu, Xu, Xu, Xu, Xu, Xu, Xu, Xu, Xu, Xu, Xu, Xu, Xu, Xu, Xu, Xu, Xu, Xu, Xu, Xu
Xu, Xu, Xu, Xu, Uu^Uf, Xu, Xu, Xu, Xu, Xu, Xu, Xu, Xu, Xu, Xu, Xu, Cud, Xu, Xu, Xu, Xu, Xu, Xu, Xu, Uu^Uf, Xu, Uu^Uf, Xu, Xu, Xu, Xu, Xu, Xu, Xu, Xu, Xu, Xu, Xu, Xu, Xu, Xu, Xu, Xu, Xu, Xu, Xu, Xu, Xu, Xu, Xu, Xu, Xu
Xu, Xu, Uh, Uu^Uf, Uu^Uf, Uu^Uf, Uu, Uu, Uu, Uu, Uu, Xu, Xu, Xu, Xu, Cud, Cud, 2 Kud, Cud, Cud, Xu, Xu, Uh, Uh, Uh, Uu^Uf, Xu, Xu, Xu, Xu, Xu, Xu, Uu^Uf, Xu, Uu^Uf, Xu, Xu, Uu^Uf, Uh, Xu, Uu, Xu, Xu, Xu, Xu, Xu, Xu, Xu, Xu, Xu, Xu, Xu
Xu, Xu, Xu, Uh, Uu^Uf, Xu, Uu^Uf, Ur, Ur^Vzps, Xu, Uu, Uu, Uu, Uu, Xu, Cud, Uu, Cud, Cud, Uh, Uh^Zdcm, Uh^Zdcm, Uh^Zdcm, Uu^Uf, Uu^Uf, Uh, Xu, Xu, Xu, Xu, Xu, Uu^Uf, Uh, Uu^Uf, Uh, Xu, Xu, Uu^Uf, Xu, Uu^Uf, Ur, Xu, Xu, Xu, Xu, Xu, Xu, Xu, Xu, Xu, Xu, Xu
Xu, Xu, Uu^Uf, Uu^Uf, Xu, Uu^Uf, Ur, Ur, Xu, Xu, Xu, Xu, Xu, Xu, Xu, Xu, Uu, Uu, Uu, Uu^Zdcm, Uu^Zdcm, Xu, Ur^Zdcm, Xu, Uu, Uu, Uu, Xu, Xu, Xu, Uu, Uu, Uh, Uh, Uh, Uu, Uu, Xu, Uu, Uh, Uh, Uh, Uu, Xu, Uu^Uf, Uu^Uf, Xu, Xu, Xu, Xu, Xu, Xu
Xu, Xu, Xu, Xu, Ur, Xu, Uh, Xu, Xu, Xu, Xu, Xu, Xu, Xu, Xu, Xu, Ur, Ur, Ur, Ur^Zdcm, Ur^Zdcm, Ur^Zdcm, Uh, Ur, Ur, Ur, Ur, Ur^Vzps, Ur, Uu, Ur, Uh, Xu, Uh, Xu, Uh, Xu, Ur, Ur, Ur, Xu, Ur, Ur^Vzps, Ur, Xu, Xu, Xu, Xu, Xu, Xu, Xu, Xu
Xu, Xu, Xu, Uu, Ur, Xu, Uh, Xu, Xu, Uu, Uu, Xu, Ur, Xu, Ur, Ur, Uu^Uf, Uu^Uf, Uu^Uf, Uu^Uf, Uu^Uf, Uu^Uf, Xu, Uh, Uh, Ur, Xu, Uh, Xu, Xu, Xu, Xu, Xu, Xu, Xu, Xu, Xu, Ur, Ur, Uu^Uf, Ur, Ur, Ur, Xu, Xu, Xu, Xu, Xu, Xu, Xu, Xu, Xu
Xu, Xu, Xu, Uu, Ur, Uh, Uh, Xu, Xu, Uu, Ur, Ur, Xu, Ur, Ur, Uu^Uf, Xu, Uu^Uf, Xu, Xu, Xu, Xu, Uu, Uh, Uu, Uu, Uu, Xu, Xu, Xu, Xu, Xu, Xu, Xu, Xu, Xu, Uu, Uh, Uu^Uf, Uu^Uf, Ur, Ur, Uu^Uf, Uu^Uf, Uh, Xu, Xu, Xu, Xu, Xu, Xu, Xu
Xu, Xu, Cud, Uu^Uf, Ur, Xu, Xu, Xu, Ur, Ur, Xu, Xu, Xu, Xu, Xu, Xu, 4 Kud, Xu, Cud, Cud, Xu, Xu, Xu, Uu, Xu, Uu, Xu, Xu, Uu, Xu, Ur, Xu, Uu, Xu, Xu, Xu, Xu, Xu, Uu^Uf, Uu^Uf, Uu, Xu, Uh, Uh, Uh, Xu, Xu, Xu, Xu, Xu, Xu, Xu
Xu, Xu, 3 Kud, Cud, Ur, Xu, Xu, Ur, Ur, Uu, Xu, Xu, Uh, Uh, Cud, Cud, Cud, Cud, Xu, Xu, Xu, Xu, Xu, Xu, Xu, Xu, Xu, Xu, Uu, Ur, Ur^Vzps, Ur, Ur, Xu, Uu, Xu, Xu, Uu, Ur, Ur, Xu, Xu, Uu^Uf, Uh, Xu, Uh, Xu, Xu, Xu, Xu, Xu, Xu
Xu, Xu, Cud, Cud, Ur, Ur, Ur, Ur, Uu^Vzps, Uu, Xu, Xu, Ur, Ur, Xu, Cud, Xu, Cud, Xu, Xu, Xu, Xu, Xu, Xu, Xu, Xu, Xu, Xu, Xu, Xu, Ur, Ur, Ur, Ur, Ur, Uu, Uu, Ur, Ur, Uh, Xu, Xu, Xu, Xu, Uu^Uf, Xu, Xu, Xu, Xu, Xu, Xu, Xu
Xu, Xu, Xu, Uu, Xu, Uu^Uf, Uu^Uf, Ur, Xu, Xu, Xu, Ur, Xu, Xu, Xu, Xu, Xu, Ur, Ur, Xu, Xu, Xu, Xu, Uu^Uf, Uu^Uf, Xu, Xu, Xu, Ur, Ur, Xu, Ur, Ur, Ur, Xu, Ur, Xu, Ur, Ur^Vzps, Uh, Ur, Xu, Xu, Uh, Uh, Xu, Xu, Xu, Xu, Xu, Xu, Xu
Xu, Xu, Xu, Xu, Xu, Xu, Xu, Ur, Xu, Xu, Ur, Ur, Uu, Xu, Xu, Xu, Xu, Uu^Uf, Ur, Xu, Xu, Xu, Xu, Uh, Uu, Ur, Ur^Zdcm, Ur, Xu, Xu, Xu, Xu, Ur, Ur, Ur, Xu, Ur, Ur, Xu, Xu, Ur, Uu^Uf, Uu^Uf, Uu^Uf, Uh, Xu, Xu, Xu, Xu, Xu, Xu, Xu
Xu, Xu, Xu, Xu, Xu, Uu^Zdcm, Uu^Zdcm, Ur^Zdcm, Ur^Zdcm, Ur, Uu, Uu, Xu, Xu, Xu, Xu, Xu, Uu^Uf, Ur, Uh, Xu, Xu, Xu, Uh, Uu^Uf, Ur^Zdcm, Ur^Zdcm, Ur^Zdcm, Uu, Xu, Xu, Ur, Xu, Xu, Xu, Ur, Ur, Ur, Xu, Uh, Xu, Ur, Uh, Uu^Uf, Uh, Xu, Xu, Xu, Xu, Xu, Xu, Xu
Xu, Xu, Xu, Uh, Uu^Uf, Uu^Zdcm, Uh^Zdcm, Ur^Zdcm, Ur^Zdcm, Ur^Zdcm, Xu, Uu, Xu, Xu, Xu, Xu, Xu, Uu^Uf, Ur, Uh, Xu, Xu, Xu, Uu^Uf, Ur^Vzps, Ur, Ur^Zdcm, Ur^Zdcm, Ur, Uu^Uf, Uu, Xu, Xu, Xu, Uu^Uf, Uu^Uf, Ur, Xu, Uh, Xu, Ur, Ur, Uu, Uh, Xu, Xu, Xu, Xu, Xu, Xu, Xu, Xu
Xu, Xu, Xu, Uh, Uh, Uu^Uf, Uu^Uf, Uu^Uf, Ur^Zdcm, Ur, Ur, Xu, Xu, Xu, Xu, Uu, Uu, Xu, Ur, Ur, Uu, Xu, Xu, Xu, Uu, Ur, Xu, Ur^Zdcm, Xu, Uh, Xu, Xu, Xu, Xu, Ur, Ur, Xu, Xu, Xu, Uh, Ur^Vzps, Uu, Uh, Uh, Xu, Xu, Xu, Xu, Xu, Xu, Xu, Xu
Xu, Xu, Xu, Uu^Uf, Uu^Uf, Uu^Uf, Uh, Uu^Uf, Ur, Xu, Xu, Ur, Ur, Xu, Uh, Xu, Uu, Ur, Xu, Ur, Ur, Uu, Ur, Ur, Ur, Xu, Ur, Ur, Xu, Xu, Uh, Uh, Uu, Uu^Uf, Uu^Uf, Ur, Uh, Xu, Xu, Xu, Xu, Ur, Uu^Uf, Uh, Xu, Xu, Xu, Xu, Xu, Xu, Xu, Xu
Xu, Xu, Xu, Uu^Uf, Uu^Uf, Uu^Uf, Uu^Uf, Uu^Uf, Ur, Uu, Uu, Xu, Uu, Ur, Ur, Uu, Uu, Uu^Uf, Uu^Uf, Xu, Ur, Ur, Xu, Ur, Xu, Ur, Ur, Xu, Ur, Uh, Ur, Ur, Ur, Uu^Uf, Ur, Ur, Uh^Zdcm, Uh, Xu, Xu, Ur, Ur, Uu^Uf, Xu, Xu, Xu, Xu, Xu, Xu, Xu, Xu, Xu
Xu, Xu, Xu, Xu, Xu, Uu^Uf, Uu^Uf, Ur, Xu, Xu, Xu, Uh, Uu, Ur, Ur, Xu, Ur, Uh, Xu, Uh, Ur, Ur, Uh, Xu, Uu, Ur, Xu, Ur, Ur, Ur, Xu, Ur^Vzps, Xu, Ur, Ur, Ur^Zdcm, Ur^Zdcm, Uh^Zdcm, Uh^Zdcm, Uh^Zdcm, Xu, Uu^Uf, Uu^Uf, Xu, Xu, Xu, Xu, Xu, Xu, Xu, Xu, Xu
Xu, Xu, Xu, Xu, Xu, Xu, Xu, Ur^Vzps, Ur, Xu, Xu, Uh, Ur, Ur, Ur, Ur, Ur, Uu^Uf, Ur, Ur^Vzps, Ur, Uu^Uf, Uu^Uf, Uu, Xu, Xu, Xu, Uu, Uu, Xu, Xu, Xu, Uu^Uf, Uu^Uf, Ur, Ur^Zdcm, Ur^Zdcm, Uh^Zdcm, Xu, Xu, Xu, Ur, Xu, Xu, Xu, Xu, Xu, Xu, Xu, Xu, Xu, Xu
Xu, Xu, Xu, Xu, Xu, Xu, Xu, Ur, Ur, Xu, Xu, Uu, Xu, Ur, Xu, Xu, Xu, Uu, Xu, Ur, Ur, Xu, Xu, Xu, Xu, Xu, Xu, Xu, Xu, Ur, Ur, Uu^Uf, Uu, Uu, Uu, Ur, Ur, Xu, Uh, Ur, Ur, Ur, Ur, Xu, Uh, Xu, Xu, Xu, Xu, Xu, Xu, Xu
Xu, Xu, Xu, Xu, Xu, Xu, Xu, Uu, Ur, Uu, Xu, Xu, Uu, Uu, Xu, Xu, Uh, Uh, Uh, Ur, Ur, Xu, Xu, Xu, Xu, Xu, Xu, Xu, Ur, Xu, Ur, Ur, Uu, Uu, Xu, Xu, Ur, Xu, Uh, Uu^Uf, Ur, Xu, Ur, Uu^Vzps, Uu, Uh, Xu, Xu, Xu, Xu, Xu, Xu
Xu, Xu, Xu, Xu, Uu^Uf, Xu, Xu, Uu, Ur, Ur, Ur, Ur, Xu, Xu, Xu, Xu, Xu, Uh, Xu, Xu, Xu, Ur, Uu, Xu, Xu, Xu, Uu, Ur, Uu, Ur, Xu, Ur, Xu, Xu, Xu, Xu, Ur^Vzps, Ur, Uu, Uu, Xu, Xu, Xu, Ur, Uu, Uu^Uf, Xu, Xu, Xu, Xu, Xu, Xu
Xu, Xu, Uh, Uh, Uu^Uf, Xu, Xu, Xu, Xu, Ur, Xu, Ur, Ur^Vzps, Xu, Xu, Xu, Xu, Xu, Xu, Xu, Uu^Uf, Uu, Xu, Xu, Uu, Ur, Xu, Xu, Xu, Xu, Ur, Ur, Ur, Ur, Ur, Xu, Xu, Ur, Xu, Xu, Uu^Uf, Xu, Xu, Ur, Xu, Uu^Uf, Xu, Xu, Xu, Xu, Xu, Xu
Xu, Xu, Uh, Uu^Uf, Uu, Uu, Ur, Ur, Ur, Uu, Ur, Ur, Uu, Xu, Ur, Uh, Uh, Uh, Xu, Xu, Xu, Uh, Xu, Xu, Ur, Xu, Xu, Xu, Xu, Xu, Ur^Vzps, Ur, Xu, Xu, Ur, Xu, Xu, Ur, Xu, Xu, Xu, Ur, Ur, Ur, Xu, Xu, Xu, Xu, Xu, Xu, Xu, Xu
Xu, Xu, Uh, Uu^Uf, Uu^Uf, Ur, Xu, Xu, Ur, Ur, Ur, Xu, Ur, Xu, Ur, Uh, Uh, Uh, Uu, Xu, Xu, Xu, Ur, Ur, Ur^Vzps, Ur, Uu, Xu, Xu, Xu, Xu, Xu, Xu, Xu, Ur, Ur, Xu, Xu, Xu, Xu, Uu^Uf, Ur, Xu, Ur, Uu, Uu, Xu, Xu, Xu, Xu, Xu, Xu
Xu, Xu, Xu, Xu, Xu, Uu, Ur, Xu, Ur, Xu, Ur, Uu, Xu, Ur, Xu, Ur, Ur, Ur, Ur, Xu, Ur, Ur, Xu, Xu, Xu, Ur, Uu, Uu, Xu, Xu, Xu, Uu, Uu, Xu, Xu, Xu, Xu, Xu, Xu, Xu, Uu^Uf, Uu^Uf, Xu, Ur^Vzps, Ur, Xu, Xu, Xu, Xu, Xu, Xu, Xu
Xu, Xu, Xu, Xu, Xu, Xu, Uu^Vzps, Xu, Uu^Uf, Ur, Uu, Uu, Xu, Xu, Uu^Uf, Ur, Ur, Uu, Uu, Ur, Xu, Xu, Xu, Uu, Xu, Xu, Ur, Uu^Zdcm, Uu^Zdcm, Xu, Xu, Ur, Xu, Xu, Ur, Uu, Ur, Uu, Uu, Xu, Xu, Xu, Uu^Uf, Xu, Ur, Xu, Xu, Xu, Xu, Xu, Xu, Xu
Xu, Xu, Xu, Xu, Xu, Xu, Uu, Uh, Uh, Ur, Ur, Uu, Xu, Uh, Ur, Ur, Ur^Vzps, Xu, Ur, Ur, Ur, Xu, Ur, Uu, Ur, Xu, Uu, Uu^Zdcm, Uu^Zdcm, Uu^Zdcm, Ur, Ur, Ur, Xu, Ur, Xu, Xu, Uu, Xu, Ur, Xu, Xu, Uu^Uf, Ur, Uu^Uf, Xu, Xu, Xu, Xu, Xu, Xu, Xu
Xu, Xu, Uh, Xu, Uu, Uu, Uu, Uh, Uu, Xu, Ur, Xu, Xu, Uu, Xu, Xu, Xu, Ur, Ur, Ur, Uh, Ur, Ur, Ur, Ur, Ur, Ur, Uu, Ur, Uu, Ur, Ur, Xu, Ur, Ur, Ur, Ur, Ur, Ur, Ur, Uu, Xu, Xu, Ur, Ur, Xu, Xu, Xu, Xu, Xu, Xu, Xu
Xu, Xu, Uh, Uu^Uf, Uu, Uu, Ur, Xu, Uu, Ur, Ur, Uu^Uf, Uu, Xu, Ur, Xu, Ur, Xu, Ur, Xu, Xu, Xu, Xu, Ur, Xu, Xu, Xu, Ur, Xu, Xu, Xu, Ur^Vzps, Xu, Xu, Xu, Xu, Xu, Uu^Uf, Uu^Uf, Ur, Uu^Uf, Xu, Xu, Xu, Ur, Xu, Xu, Xu, Xu, Xu, Xu, Xu
Xu, Xu, Uh, Uu^Uf, Uu, Ur, Xu, Xu, Xu, Xu, Ur^Vzps, Ur, Ur, Ur, Xu, Ur, Ur, Ur, Xu, Uu, Xu, Xu, Uu, Ur, Ur, Xu, Xu, Xu, Ur, Xu, Xu, Xu, Xu, Xu, Xu, Xu, Xu, Xu, Xu, Ur, Uu^Uf, Uu^Uf, Uu^Uf, Xu, Ur, Xu, Xu, Xu, Xu, Xu, Xu, Xu
Xu, Xu, Uh, Uh, Uu, Ur, Xu, Xu, Ur, Ur, Xu, Uu, Xu, Xu, Xu, Xu, Ur, Xu, Xu, Xu, Uu, Uu, Uu, Xu, Ur, Xu, Uu, Xu, Ur, Xu, Ur, Ur, Ur, Ur, Ur, Xu, Xu, Xu, Ur, Ur, Xu, Uu^Uf, Ur^Vzps, Xu, Ur, Uu^Uf, Xu, Xu, Xu, Xu, Xu, Xu
Xu, Xu, Xu, Uh, Xu, Uu, Ur, Ur, Ur, Xu, Xu, Xu, Xu, Xu, Xu, Ur, Xu, Xu, Ur, Uu, Ur, Xu, Ur, Ur, Uu, Ur, Uu, Xu, Xu, Ur, Ur, Xu, Xu, Uu, Uu^Uf, Ur, Ur, Ur, Xu, Xu, Xu, Xu, Xu, Ur, Ur, Uu^Uf, Uu^Uf, Xu, Uu^Uf, Xu, Xu, Xu
Xu, Xu, Xu, Xu, Uu, Ur, Ur, Xu, Xu, Xu, Xu, Xu, Xu, Xu, Ur, Uu, Xu, Uu, Ur, Ur, Ur, Ur, Uu, Uu, Xu, Uu^Vzps, Uu, Xu, Xu, Xu, Ur, Xu, Xu, Xu, Xu, Uu^Uf, Xu, Xu, Xu, Xu, Uu^Uf, Uu^Uf, Ur, Ur, Ur, Uu^Uf, Uu^Uf, Uu^Uf, Xu, Xu, Xu, Xu
Xu, Xu, Xu, Xu, Uu^Vzps, Xu, Ur, Xu, Xu, Xu, Uu, Uu, Uu, Ur, Xu, Ur, Ur, Ur, Xu, Ur, Xu, Xu, Xu, Xu, Xu, Xu, Xu, Uu, Uu, Ur, Ur, Ur, Xu, Xu, Xu, Xu, Ur, Uh, Ur, Ur, Ur, Ur, Xu, Ur, Xu, Xu, Xu, Xu, Xu, Xu, Xu, Xu
Xu, Xu, Xu, Xu, Uh, Uh, Uh, Ur, Ur, Ur, Ur, Ur, Uh, Ur, Uh, Ur, Ur, Ur, Uh^Vzps, Xu, Xu, Xu, Uu, Uu, Uu, Xu, Xu, Xu, Ur, Ur, Ur, Xu, Ur, Uh, Uh, Ur^Vzps, Ur, Ur, Xu, Xu, Xu, Xu, Xu, Uu, Xu, Xu, Uu, Xu, Uu, Xu, Xu, Xu
Xu, Xu, Xu, Uh, Uh, Uh, Uu, Uu, Xu, Ur, Xu, Ur, Xu, Xu, Xu, Uh, Xu, Ur, Ur, Ur, Ur, Uu, Ur, Uu, Ur, Uu, Uu, Ur, Xu, Xu, Uu^Zdcm, Ur, Ur, Ur, Ur, Ur, Ur, Xu, Uu, Xu, Ur, Xu, Xu, Xu, Uu^Uf, Uu, Xu, Xu, Uu, Xu, Xu, Xu
Xu, Xu, Xu, Uh, Uu^Uf, Xu, Xu, Xu, Ur, Ur, Ur, Ur, Ur, Xu, Uu, Xu, Ur, Ur, Ur, Xu, Xu, Ur, Xu, Ur, Xu, Ur, Ur^Zdcm, Xu, Uu^Zdcm, Uu^Zdcm, Ur^Zdcm, Ur, Uu, Uu, Uu, Xu, Xu, Ur, Ur, Uu, Xu, Ur, Xu, Uu^Vzps, Ur, Uu^Uf, Uu, Xu, Uu, Xu, Xu, Xu
Xu, Xu, Xu, Uu^Uf, Xu, Xu, Xu, Uu, Xu, Xu, Xu, Xu, Ur, Xu, Xu, Uu, Ur, Ur, Ur, Ur, Uu, Xu, Uu, Xu, Ur, Ur, Uu, Ur^Zdcm, Ur^Zdcm, Ur^Zdcm, Ur, Uu, Xu, Uu, Xu, Uh, Uh, Uu^Uf, Ur, Ur, Ur, Ur, Ur, Ur, Ur, Ur, Ur, Ur, Xu, Xu, Xu, Xu
Xu, Xu, Xu, Xu, Xu, Xu, Uh, Uu, Xu, Xu, Xu, Xu, Ur, Xu, Xu, Uu, Uu^Vzps, Ur, Ur, Ur, Ur, Uu, Uu, Uu, Uu, Ur, Ur, Uu, Ur, Ur, Ur^Vzps, Uu, Uu, Xu, Xu, Xu, Xu, Uh, Xu, Ur, Ur, Xu, Uu, Ur, Xu, Ur, Ur, Uu, Xu, Xu, Xu, Xu
Xu, Xu, Xu, Xu, Xu, Xu, Xu, Uu^Uf, Uu^Uf, Uh, Uu^Uf, Uu, Xu, Xu, Xu, Xu, Xu, Xu, Ur, Xu, Uu^Uf, Uu^Uf, Uu^Uf, Uu^Uf, Uu^Uf, Ur, Uu, Ur, Uu, Ur, Uu, Ur, Ur, Xu, Ur, Xu, Xu, Xu, Xu, Uu, Xu, Ur, Xu, Uu, Xu, Ur, Ur, Uu^Uf, Uu, Xu, Xu, Xu
Xu, Xu, Xu, Xu, Uu^Uf, Uu^Uf, Uh, Uu^Uf, Uh, Uh, Uh, Uu^Uf, Xu, Xu, Xu, Xu, Uu, Uu, Uu, Xu, Xu, Uu^Uf, Uh, Xu, Uu^Uf, Xu, Xu, Xu, Uu, Uu, Uu, Uu, Ur, Xu, Ur, Ur, Ur, Xu, Xu, Uu, Uu, Xu, Uu, Xu, Ur, Ur, 1 Ur, Ur, Ur, Xu, Xu, Xu
Xu, Xu, Xu, Uu^Uf, Uu^Uf, Uh, Uu^Uf, Uu^Uf, Uh, Uh^Vzps, Xu, Xu, Xu, Xu, Xu, Xu, Xu, Xu, Xu, Xu, Xu, Uh, Uh, Uh, Uh, Uh, Xu, Xu, Xu, Xu, Xu, Xu, Xu, Ur, Xu, Xu, Xu, Xu, Xu, Xu, Xu, Xu, Uu, Uu, Xu, Ur, Ur, Ur, Ur, Xu, Xu, Xu
Xu, Xu, Xu, Xu, Xu, Xu, Xu, Xu, Xu, Xu, Xu, Xu, Xu, Xu, Xu, Xu, Xu, Xu, Xu, Xu, Xu, Uh, Xu, Uh, Xu, Xu, Xu, Xu, Xu, Xu, Xu, Xu, Xu, Ur, Xu, Xu, Xu, Xu, Xu, Xu, Xu, Xu, Xu, Xu, Xu, Xu, Xu, Ur, Ur, Ur, Ur, Xu
Xu, Xu, Xu, Xu, Xu, Xu, Xu, Xu, Xu, Xu, Xu, Xu, Xu, Xu, Xu, Xu, Xu, Xu, Xu, Xu, Xu, Xu, Xu, Xu, Xu, Xu, Xu, Xu, Xu, Xu, Xu, Xu, Xu, Xu, Xu, Xu, Xu, Xu, Xu, Xu, Xu, Xu, Xu, Xu, Xu, Xu, Xu, Xu, Xu, Ur, Ur, Ur
