border_size=1
usage=map

Xos         , Xos         , Xos         , Xos         , Xos         , Xos         , Xos         , Xos         , Xos         , Xos         , Xos         , Xos         , Xos         , Xos         , Xos         , Xos         , Xos         , Xos         , Xos         , Xos         , Xos         , Xos         , Urb         , Urb         , Urb         , Urb         , Xos         , Xos         , Xu          , Xu          , Xu          , Xu          , Xu          , Xu          , Xu          , Xu          , Xu          , Xu          , Xu          , Xu          , Xos         , Xos         , Xos         , Xos         , Xos         , Xos         , Xos         , Xos         , Xos         , Xos         , Xos         , Xos         , Xos         , Xos         , Xos         
Xos         , Xos         , Xos         , Xos         , Urb         , Urb         , Urb         , Xos         , Xos         , Xos         , Xos         , Xos         , Xos         , Xos         , Xos         , Xos         , Xos         , Xos         , Urb         , Xos         , Urb         , Urb         , Urb         , Urb         , Urb         , Urb         , Urb         , Xos         , Xos         , Xu          , Xu          , Xu          , Qxu         , Xu          , Qxu         , Xu          , Xu          , Xu          , Xu          , Xos         , Xos         , Xos         , Uu^Vu       , Xos         , Xos         , Xos         , Xos         , Xos         , Xos         , Xos         , Xos         , Urb         , Urb         , Xos         , Xos         
Xos         , Xos         , Xos         , Xos         , Urb         , Urb         , Urb         , Xos         , Urb         , Xos         , Urb         , Xos         , Urb         , Urb         , Urb         , Urb         , Urb         , Urb         , Urb         , Xos         , Urb         , Urb         , Urb         , Urb         , Urb         , Urb         , Urb         , Urb         , Xos         , Xos         , Uh^Dr       , Qxu         , Uu          , Qxu         , Qxu         , Qxu         , Uu          , Xu          , Xos         , Xos         , Urb         , Urb         , Urb         , Urb         , Urb         , Xos         , Xos         , Xos         , Urb         , Urb         , Urb         , Urb         , Urb         , Xos         , Xos         
Xos         , Xos         , Xos         , Urb         , Urb         , Urb         , Urb         , Urb         , Urb         , Urb         , Urb         , Urb         , Urb         , Urb         , Urb         , Urb         , Urb         , Urb         , Urb         , Xos         , Urb         , Urb         , Urb         , Uu^Vu       , Urb         , Urb         , Urb         , Xos         , Uu          , Uh          , Ur          , Qxu^Bs/     , Qxu         , Qxu^Bs\     , Ur          , Uu          , Uu          , Xos         , Xos         , Urb         , Urb         , Urb         , Urb         , Urb         , Urb         , Urb         , Urb         , Urb         , Urb         , Urb         , Urb         , Urb         , Urb         , Xos         , Xos         
Xos         , Xos         , Urb         , Urb         , Urb         , Urb         , Urb         , Urb         , Urb         , Uu^Vu       , Urb         , Urb         , Xos         , Urb         , Urb         , Urb         , Xos         , Urb         , Urb         , Xos         , Xos         , Urb         , Urb         , Urb         , Urb         , Urb         , Xos         , Xos         , Ur          , Ur          , Uu          , Qxu         , Ql          , Qxu         , Qxu         , Ur          , Ur          , Xos         , Urb         , Xos         , Xos         , Xos         , Urb         , Urb         , Urb         , Urb         , Urb         , Urb         , Urb         , Urb         , Urb         , Urb         , Urb         , Urb         , Xos         
Xos         , Xos         , Urb         , Urb         , Urb         , Xos         , Urb         , Urb         , Urb         , Urb         , Xos         , Xos         , Xos         , Xos         , Xos         , Xos         , Urb         , Urb         , Urb         , Urb         , Urb         , Xos         , Xos         , Urb         , Urb         , Urb         , Urb         , Urb         , Uu          , Uu          , Ql          , Ql          , Ql          , Ql          , Ql          , Uu^Dr       , Uu          , Urb         , Urb         , Urb         , Urb         , Urb         , Urb         , Urb         , Xos         , Urb         , Urb         , Urb         , Urb         , Urb         , Xos         , Xos         , Xos         , Urb         , Xos         
Xos         , Xos         , Urb         , Urb         , Urb         , Urb         , Urb         , Urb         , Xos         , Xos         , Urb         , Urb         , Urb         , Xos         , Urb         , Urb         , Urb         , Urb         , Xos         , Urb         , Urb         , Urb         , Urb         , Urb         , Urb         , Urb         , Xos         , Xos         , Uh^Dr       , Xu          , Ql          , Ql          , Ql          , Ql          , Xu          , Uu          , Uu          , Urb         , Urb         , Urb         , Urb         , Urb         , Urb         , Xos         , Urb         , Urb         , Urb         , Xos         , Xos         , Xos         , Urb         , Urb         , Urb         , Xos         , Xos         
Xos         , Xos         , Urb         , Urb         , Urb         , Urb         , Urb         , Xos         , Urb         , Urb         , Urb         , Urb         , Urb         , Urb         , Urb         , Urb         , Urb         , Urb         , Xos         , Xos         , Urb         , Urb         , Uu^Vu       , Urb         , Urb         , Urb         , Xos         , Uu          , Ur          , Ql          , Ql          , Ql          , Ql          , Ql          , Uu          , Uu          , Uu          , Urb         , Urb         , Urb         , Urb         , Xos         , Xos         , Xos         , Urb         , Urb         , Urb         , Xos         , Urb         , Urb         , Urb         , Urb         , Urb         , Urb         , Urb         
Xos         , Urb         , Urb         , Urb         , Urb         , Urb         , Uu^Vu       , Urb         , Urb         , Urb         , Urb         , Urb         , Urb         , Urb         , Urb         , Xos         , Xos         , Xos         , Xos         , Xos         , Urb         , Urb         , Urb         , Urb         , Urb         , Urb         , Ur          , Ur          , Uu^Dr       , Ur          , Ql^Bw\r     , Ql          , Ql          , Ql          , Uu          , Uu          , Xu          , Xos         , Urb         , Urb         , Urb         , Xos         , Urb         , Xos         , Urb         , Urb         , Urb         , Urb         , Urb         , Urb         , Urb         , Urb         , Urb         , Urb         , Urb         
Xos         , Xos         , Xos         , Xos         , Urb         , Urb         , Urb         , Urb         , Urb         , Urb         , Urb         , Urb         , Urb         , Urb         , Urb         , Urb         , Urb         , Xos         , Xos         , Xos         , Urb         , Urb         , Urb         , Urb         , Urb         , Uu          , Uu          , Uu          , Ql          , Ql          , Ql          , Uu          , Ql^Bw\r     , Uu          , Uu          , Uu^Dr       , Xu          , Xos         , Urb         , Uu^Vu       , Urb         , Urb         , Urb         , Urb         , Urb         , Urb         , Urb         , Urb         , Urb         , Urb         , Urb         , Uu^Vu       , Urb         , Urb         , Xos         
Xos         , Xos         , Urb         , Xos         , Urb         , Urb         , Urb         , Urb         , Xos         , Xos         , Xos         , Xos         , Xos         , Urb         , Urb         , Urb         , Urb         , Xos         , Urb         , Xos         , Xos         , Urb         , Urb         , Urb         , Urb         , Ur          , Ur          , Ql          , Ql          , Ql          , Ql          , Ql          , Xu          , Ur          , Ur          , Ur          , Ur          , Xos         , Urb         , Urb         , Urb         , Urb         , Urb         , Urb         , Urb         , Urb         , Xos         , Urb         , Xos         , Urb         , Urb         , Urb         , Urb         , Urb         , Xos         
Xos         , Xos         , Urb         , Urb         , Urb         , Urb         , Xos         , Urb         , Xos         , Xos         , Xos         , Xos         , Xos         , Urb         , Urb         , Urb         , Urb         , Urb         , Xos         , Xos         , Urb         , Urb         , Urb         , Urb         , Urb         , Uu          , Uu          , Ur          , Ur          , Ql          , Ql          , Ql          , Ur          , Ur          , Uh          , Uu          , Xu          , Urb         , Xos         , Xos         , Xos         , Xos         , Xos         , Urb         , Urb         , Xos         , Xu          , Xos         , Xos         , Urb         , Urb         , Urb         , Urb         , Xos         , Xos         
Xos         , Xos         , Urb         , Urb         , Urb         , Urb         , Urb         , Xos         , Urb         , Xos         , Urb         , Urb         , Urb         , Urb         , Urb         , Urb         , Urb         , Xos         , Urb         , Urb         , Urb         , Urb         , Urb         , Urb         , Xos         , Xos         , Xu          , Ql          , Ql          , Ql^Bw\r     , Ur^Dr       , Ql^Bw/r     , Ql          , Uh^Dr       , Uh^Dr       , Ql          , Uh          , Xu          , Xu          , Xu          , Xos         , Xos         , Urb^Dr      , Urb         , Uu          , Xu          , Uu^Dr       , Xu          , Xu          , Xos         , Urb         , Urb         , Urb         , Xos         , Xos         
Xos         , Urb         , Urb         , Urb         , Urb         , Urb         , Urb         , Urb         , Urb         , Urb         , Urb         , Urb         , Urb         , Urb         , Urb         , Urb         , Urb         , Urb         , Urb         , Urb         , Urb         , Urb         , Urb         , Urb         , Xos         , Xu          , Xu          , Ql          , Ql          , Ql          , Ql          , Ql          , Ql          , Ql          , Ql          , Ql          , Ql          , Ql          , Ql          , Uh^Dr       , Uu          , Uh          , Uh          , Uu          , Ql          , Ql          , Uu^Dr       , Xu          , Xu          , Xos         , Urb         , Urb         , Urb         , Xos         , Xos         
Xos         , Urb         , Xos         , Xos         , Xos         , Urb         , Xos         , Urb         , Urb         , Urb         , Urb         , Uu^Vu       , Urb         , Urb         , Urb         , Urb         , Urb         , Urb         , Xos         , Xos         , Urb         , Urb         , Urb         , Urb         , Urb         , Xos         , Uu          , Uu          , Ql          , Ql          , Ql          , Ql          , Ql          , Ql          , Ql          , Ql          , Ql          , Ql          , Ql          , Ql          , Uu          , Uu          , Ql          , Ql          , Ql          , Ql          , Uu          , Xu          , Xu          , Xos         , Urb         , Urb         , Urb         , Xos         , Xos         
Xos         , Xos         , Urb         , Urb         , Urb         , Xos         , Xos         , Urb         , Urb         , Urb         , Urb         , Urb         , Urb         , Urb         , Urb         , Xos         , Xos         , Xos         , Xos         , Xos         , Xos         , Xos         , Urb         , Urb         , Urb         , Urb         , Xos         , Xu          , Xu          , Ql          , Ql          , Ql          , Uh^Dr       , Ql          , Ql          , Ql          , Ql          , Xu          , Ql          , Ql          , Ql^Bw|r     , Ql          , Ql          , Ql          , Ql          , Uu          , Uu^Dr       , Xu          , Xos         , Xos         , Urb         , Urb         , Urb         , Xos         , Xos         
Urb         , Urb         , Urb         , Urb         , Urb         , Urb         , Urb         , Urb         , Urb         , Urb         , Urb         , Urb         , Xos         , Urb         , Xos         , Xos         , Urb         , Xos         , Xos         , Xos         , Xos         , Urb         , Urb         , Uu^Vu       , Urb         , Urb         , Xos         , Xu          , Xu          , Xu          , Uh          , Ql          , Ql          , Xu          , Ql          , Uh^Dr       , Uu^Dr       , Ql          , Ql          , Ql          , Ql^Bw|r     , Ql          , Ql          , Ql          , Uh^Dr       , Uu          , Xu          , Xu          , Xos         , Urb         , Urb         , Urb         , Urb         , Xos         , Xos         
Urb         , Urb         , Urb         , 1 Urb       , Urb         , Urb         , Urb         , Urb         , Urb         , Urb         , Urb         , Xos         , Xos         , Xos         , Xos         , Xos         , Urb         , Urb         , Urb         , Urb         , Urb         , Urb         , Urb         , Urb         , Urb         , Urb         , Urb         , Xos         , Urb         , Uu          , Uu          , Ql          , Ql          , Ql          , Ql          , Xu          , Ql          , Ql          , Xu          , Ql          , Uu          , Ql          , Uh          , Uu^Dr       , Xu          , Xu          , Xos         , Xos         , Xos         , Urb         , Urb         , Urb         , Urb         , Xos         , Xos         
Urb         , Urb         , Urb         , Urb         , Urb         , Urb         , Urb         , Urb         , Urb         , Urb         , Urb         , Xos         , Urb         , Urb         , Urb         , Xos         , Xos         , Urb         , Urb         , Urb         , Urb         , Urb         , Urb         , Urb         , Urb         , Urb         , Urb         , Urb         , Xos         , Urb         , Xu          , Ql          , Ql          , Ql          , Ql          , Ql          , Ql          , Xu          , Uu^Dr       , Uu          , Uu          , Uu          , Uu^Dr       , Xu          , Xu          , Xos         , Xos         , Xos         , Urb         , Urb         , Urb         , Urb         , Xos         , Xos         , Xos         
Xos         , Urb         , Urb         , Urb         , Xos         , Xos         , Urb         , Urb         , Xos         , Urb         , Urb         , Urb         , Urb         , Urb         , Uu^Vu       , Urb         , Xos         , Urb         , Urb         , Urb         , Urb         , Urb         , Urb         , Urb         , Urb         , Urb         , Xos         , Xos         , Xu          , Xu          , Ql          , Ql          , Ql          , Xu          , Ql          , Ql          , Ql          , Uu^Dr       , Uu          , Uu          , Xu          , Xu          , Xu          , Xu          , Xos         , Xos         , Urb         , Urb         , Urb         , Urb         , Urb         , Urb         , Xos         , Xos         , Xos         
Xos         , Xos         , Xos         , Xos         , Urb         , Xos         , Urb         , Urb         , Xos         , Xos         , Urb         , Urb         , Urb         , Urb         , Urb         , Urb         , Urb         , Xos         , Urb         , Urb         , Xos         , Xos         , Xos         , Xos         , Xos         , Urb         , Xos         , Xu          , Ql          , Ql          , Ql          , Ql          , Ql          , Ql          , Ql^Bw/r     , Uu          , Uu          , Ql^Bw/r     , Uu          , Uh^Dr       , Xu          , Xu          , Xu          , Xu          , Xos         , Xos         , Xos         , Urb         , Urb         , Uu^Vu       , Urb         , Urb         , Xos         , Xos         , Xos         
Xos         , Xos         , Xos         , Urb         , Urb         , Urb         , Urb         , Urb         , Xos         , Urb         , Urb         , Urb         , Urb         , Urb         , Urb         , Urb         , Urb         , Xos         , Xos         , Xos         , Urb         , Xos         , Xos         , Xos         , Xos         , Xos         , Xos         , Xu          , Ql          , Ql          , Ql          , Ql          , Uu^Dr       , Uu          , Uh          , Ql          , Ql          , Ql          , Uu^Dr       , Uu^Dr       , Xu          , Xu          , Xos         , Xos         , Urb         , Urb         , Urb         , Xos         , Urb         , Urb         , Urb         , Urb         , Xos         , Xos         , Xos         
Xos         , Xos         , Xos         , Urb         , Urb         , Urb         , Xos         , Xos         , Urb         , Urb         , Urb         , Xos         , Xos         , Urb         , Xos         , Urb         , Urb         , Urb         , Urb         , Urb         , Xos         , Xos         , Urb         , Urb         , Urb         , Xos         , Xos         , Xu          , Ql          , Ql          , Qlf         , Qlf         , Uu^Ii       , Uu          , Qlf         , Ql          , Ql          , Ql          , Xu          , Xu          , Xu          , Xu          , Xos         , Urb         , Urb         , Urb         , Urb         , Urb         , Urb         , Urb         , Urb         , Urb         , Xos         , Xos         , Xos         
Xos         , Xos         , Xos         , Urb         , Urb         , Urb         , Urb         , Urb         , Urb         , Urb         , Urb         , Xos         , Xos         , Xos         , Xos         , Xos         , Xos         , Urb         , Urb         , Urb         , Xos         , Urb         , Urb         , Urb         , Urb         , Urb         , Xos         , Xu          , Xu          , Qlf         , Qlf^Ii      , Qlf^Ii      , Uu^Ii       , Qlf^Ii      , Qlf^Ii      , Qlf         , Qlf         , Ql          , Xu          , Xu          , Xu          , Xu          , Xos         , Urb         , Urb         , Urb         , Urb         , Urb         , Urb         , Urb         , Xos         , Xos         , Urb         , Xos         , Xos         
Xos         , Xos         , Urb         , Urb         , Urb         , Urb         , Urb         , Urb         , Uu^Vu       , Urb         , Urb         , Urb         , Urb         , Xos         , Xos         , Urb         , Xos         , Urb         , Urb         , Urb         , Urb         , Urb         , Urb         , Urb         , Urb         , Urb         , Xos         , Xu          , Xu          , Qlf         , Qlf^Ii      , Qlf^Ii      , 3 Uu^Ii     , Qlf^Ii      , Qlf^Ii      , Qlf         , Qlf         , Ql          , Xu          , Xu          , Xu          , Xu          , Xos         , Urb         , Urb         , Urb         , Xos         , Urb         , Urb         , Urb         , Urb         , Urb         , Urb         , Xos         , Xos         
Xos         , Xos         , Urb         , Urb         , Urb         , Urb         , Urb         , Urb         , Urb         , Urb         , Urb         , Urb         , Xos         , Xos         , Urb         , Urb         , Urb         , Urb         , Urb         , Urb         , Urb         , Urb         , Urb         , Urb         , Urb         , Ur          , Ur          , Xu          , Xu          , Xu          , Qlf^Ii      , Qlf^Ii      , Qlf^Ii      , Qlf^Ii      , Xu          , Qlf         , Ql          , Ql          , Xu          , Xu          , Xu          , Xos         , Xos         , Urb         , Urb         , Urb         , Xos         , Urb         , Urb         , Urb         , Uu^Vu       , Urb         , Urb         , Xos         , Xos         
Xos         , Xos         , Xos         , Urb         , Urb         , Urb         , Urb         , Urb         , Urb         , Urb         , Urb         , Urb         , Xos         , Xos         , Urb         , Urb         , Urb         , Urb         , Urb         , Urb         , Urb         , Urb         , Urb         , Urb         , Urb         , Xos         , Xu          , Ur          , Ur          , Xu          , Xu          , Qlf^Ii      , Qlf^Ii      , Qlf^Ii      , Xu          , Xu          , Xu          , Xu          , Xu          , Xu          , Xu          , Xos         , Ur          , Ur          , Xos         , Xos         , Urb         , Urb         , Urb         , Urb         , Urb         , Urb         , Urb         , Xos         , Xos         
Xos         , Xos         , Xos         , Xos         , Xos         , Urb         , Urb         , Urb         , Urb         , Urb         , Urb         , Urb         , Xos         , Urb         , Xos         , Urb         , Xos         , Xos         , Xos         , Urb         , Urb         , Urb         , Urb         , Urb         , Urb         , Xos         , Xu          , Xu          , Xu          , Ur          , Ur          , Xu          , Xu          , Xu          , Ur          , Ur          , Ur          , Xu          , Ur          , Xu          , Ur          , Ur          , Xos         , Xos         , Xos         , Urb         , Urb         , Urb         , Urb         , Urb         , Xos         , Urb         , Urb         , Xos         , Xos         
Xos         , Xos         , Xos         , Xos         , Xos         , Xos         , Xos         , Urb         , Xos         , Urb         , Xos         , Urb         , Xos         , Xos         , Xos         , Xos         , Xos         , Xos         , Xos         , Xos         , Xos         , Xos         , Xos         , Urb         , Urb         , Xos         , Xu          , Xu          , Xu          , Xu          , Xu          , Ur          , Ur          , Ur          , Xu          , Xu          , Xu          , Ur          , Xu          , Ur          , Xu          , Xu          , Xos         , Xos         , Xos         , Xos         , Xos         , Urb         , Xos         , Urb         , Xos         , Urb         , Urb         , Xos         , Xos         
Xos         , Xos         , Xos         , Xos         , Xos         , Xos         , Xos         , Xos         , Xos         , Xos         , Xos         , Xos         , Xos         , Xos         , Xos         , Xos         , Xos         , Xos         , Xos         , Xos         , Xos         , Xos         , Xos         , Xos         , Xos         , Xos         , Xu          , Xu          , Xu          , Xu          , Xu          , Xu          , Xu          , Xu          , Xu          , Xu          , Xu          , Xu          , Xu          , Xu          , Xu          , Xu          , Xos         , Xos         , Xos         , Xos         , Xos         , Xos         , Xos         , Xos         , Xos         , Xos         , Xos         , Xos         , Xos         
