border_size=1
usage=map

Rb^Gvs      , Rb^Gvs      , Rb^Gvs      , Gg          , Gg          , Gg          , Gg          , Rb^Gvs      , Rb^Gvs      , Rb^Gvs      , Rb^Gvs      , Gs^Vh       , Rrc         , Gg          , Gg          , Gg          , Rb^Gvs      , Rb^Gvs      , Rb^Gvs      , Rb^Gvs      , Rb^Gvs      , Ww          , Ww          , Gg          , Rb^Gvs      , Rb^Gvs      , Rb^Gvs      , Rb^Gvs      , Rb^Gvs      , Gg          , Gg          , Rb^Gvs      , Rb^Gvs      , Rb^Gvs      , Rb^Gvs      , Rrc         , Gg          , Gg          , Rb^Gvs      , Rb^Gvs      , Rb^Gvs      , Rb^Gvs      , Rb^Gvs      , Rb^Gvs      , Rb^Gvs      , Gg          , Gg          , Rb^Gvs      , Rb^Gvs      , Rb^Gvs      , Rb^Gvs      , Rb^Gvs      , Gs^Vh       , Gg          , Rb^Gvs      , Rb^Gvs      , Rb^Gvs      , Rb^Gvs      , Rb^Gvs      , Gg          , Gg          
Rb^Gvs      , Rb^Gvs      , Rb^Gvs      , Rb^Gvs      , Rb^Gvs      , Gg          , Gg          , Rb^Gvs      , Rb^Gvs      , Rb^Gvs      , Rb^Gvs      , Rb^Gvs      , Rb^Gvs      , Rrc         , Rrc         , Rb^Gvs      , Gg          , Rb^Gvs      , Rb^Gvs      , Rb^Gvs      , Rb^Gvs      , Gg          , Ww          , Gg          , Gg          , Rb^Gvs      , Rb^Gvs      , Rb^Gvs      , Rb^Gvs      , Gg          , Gs^Vh       , Rb^Gvs      , Rb^Gvs      , Rb^Gvs      , Rrc         , Rrc         , Rrc         , Gg          , Gg          , Rb^Gvs      , Rb^Gvs      , Rb^Gvs      , Rb^Gvs      , Rb^Gvs      , Gg          , Gg          , Rb^Gvs      , Rb^Gvs      , Rb^Gvs      , Rb^Gvs      , Rb^Gvs      , Rb^Gvs      , Gg          , Gg          , Rb^Gvs      , Rb^Gvs      , Rb^Gvs      , Rb^Gvs      , Rb^Gvs      , Gg          , Rrc         
Gg          , Rb^Gvs      , Rb^Gvs      , Rb^Gvs      , Gs^Vh       , Gg          , Gg          , Gg          , Rb^Gvs      , Rb^Gvs      , Rb^Gvs      , Rb^Gvs      , Rb^Gvs      , Gg          , Gg          , Rrc         , Rrc         , Gs^Vh       , Gg          , Rb^Gvs      , Gg          , Gg          , Gg          , Ww          , Gg          , Gg          , Gs^Vh       , Rb^Gvs      , Gg          , Gg          , Rrc         , Rrc         , Rrc         , Rrc         , Gg          , Gg          , Gs^Vh       , Rrc         , Rrc         , Gs^Vh       , Gg          , Rb^Gvs      , Gg          , Gg          , Rb^Gvs      , Rb^Gvs      , Rb^Gvs      , Gg          , Gg          , Rb^Gvs      , Gg          , Gg          , Ch          , Gg          , Gg          , Gg          , Gg          , Gs^Vh       , Rrc         , Rrc         , Rb^Gvs      
Gg          , Gg          , Gg          , Gg          , Gg          , Gg          , Gg          , Gg          , Gg          , Rb^Gvs      , Gg          , Rb^Gvs      , Gg          , Gg          , Rb^Gvs      , Rb^Gvs      , Gg          , Rrc         , Gg          , Gg          , Gg          , Gg          , Gg          , Ww          , Gg          , Gg          , Rrc         , Rrc         , Rrc         , Rrc         , Gg          , Gg          , Rrc         , Gg          , Rb^Gvs      , Rb^Gvs      , Rb^Gvs      , Rb^Gvs      , Rb^Gvs      , Rrc         , Rrc         , Gg          , Gs^Vh       , Rb^Gvs      , Rb^Gvs      , Rb^Gvs      , Rb^Gvs      , Rb^Gvs      , Gg          , Gg          , Ch          , Ch          , Rrc         , Ch          , Kh          , Gg          , Rrc         , Rrc         , Gg          , Gg          , Rb^Gvs      
Gg          , Gg          , Rb^Gvs      , Rb^Gvs      , Gg          , Gg          , Gg          , Gg          , Gg          , Rb^Gvs      , Rb^Gvs      , Rb^Gvs      , Rb^Gvs      , Rb^Gvs      , Rb^Gvs      , Rb^Gvs      , Gs^Vh       , Rrc         , Ch          , Gg          , Gg          , Gg          , Gg          , Ww          , Rrc         , Rrc         , Gs^Vh       , Rb^Gvs      , Rb^Gvs      , Gg          , Gg          , Gg          , Rrc         , Gg          , Rb^Gvs      , Rb^Gvs      , Rb^Gvs      , Rb^Gvs      , Rb^Gvs      , Rb^Gvs      , Gg          , Rrc         , Rrc         , Rb^Gvs      , Rb^Gvs      , Rb^Gvs      , Rb^Gvs      , Rb^Gvs      , Ch          , Ch          , Rrc         , Rrc         , Rr^Vhc      , Rrc         , Rrc         , Rrc         , Kh          , Gg          , Gg          , Rb^Gvs      , Rb^Gvs      
Gg          , Rb^Gvs      , Rb^Gvs      , Rb^Gvs      , Rb^Gvs      , Gg          , Gg          , Gg          , Gg          , Rb^Gvs      , Rb^Gvs      , Rb^Gvs      , Rb^Gvs      , Rb^Gvs      , Rb^Gvs      , Rb^Gvs      , Rb^Gvs      , Rrc         , Ch          , Gg          , Ch          , Gg          , Rrc         , Ww^Bsb/     , Gg          , Gg          , Rb^Gvs      , Rb^Gvs      , Rb^Gvs      , Rb^Gvs      , Gg          , Gg          , Rrc         , Gg          , Gs^Vh       , Rb^Gvs      , Rb^Gvs      , Rb^Gvs      , Rb^Gvs      , Rb^Gvs      , Rb^Gvs      , Rb^Gvs      , Gs^Vh       , Rrc         , Rrc         , Rb^Gvs      , Kh          , Ch          , Rrc         , Rrc         , Rrc         , Rrc         , Ch          , Rrc         , Rrc         , Rr^Vhc      , Rrc         , Ch          , Ch          , Gg          , Rb^Gvs      
Gg          , Rb^Gvs      , Rb^Gvs      , Rb^Gvs      , Rb^Gvs      , Rb^Gvs      , Gg          , Gg          , Gg          , Gg          , Rb^Gvs      , Rb^Gvs      , Rb^Gvs      , Rb^Gvs      , Gg          , Rb^Gvs      , Gg          , Rrc         , Rrc         , Kh          , Rrc         , Rrc         , Gg          , Ww          , Gg          , Rb^Gvs      , Rb^Gvs      , Rb^Gvs      , Rb^Gvs      , Rb^Gvs      , Rb^Gvs      , Rb^Gvs      , Rb^Gvs      , Rrc         , Gg          , Rb^Gvs      , Rb^Gvs      , Rb^Gvs      , Rb^Gvs      , Rb^Gvs      , Rb^Gvs      , Rb^Gvs      , Rb^Gvs      , Gg          , Kh          , Rrc         , Rrc         , Rrc         , Rrc         , Rr^Vhc      , Ch          , Rrc         , Ch          , Rrc         , Ch          , Rrc         , Rrc         , Rrc         , Kh          , Gg          , Rrc         
Gg          , Rb^Gvs      , Rb^Gvs      , Rb^Gvs      , Rb^Gvs      , Gs^Vh       , Gg          , Gg          , Gg          , Gs^Vh       , Gg          , Gg          , Gg          , Gg          , Gg          , Gg          , Gg          , Gg          , Rrc         , Rrc         , Gs^Vh       , Rb^Gvs      , Rb^Gvs      , Ww          , Ww          , Gg          , Gg          , Rb^Gvs      , Gg          , Rb^Gvs      , Rb^Gvs      , Rb^Gvs      , Rb^Gvs      , Rrc         , Gg          , Rb^Gvs      , Rb^Gvs      , Rb^Gvs      , Rb^Gvs      , Rb^Gvs      , Rb^Gvs      , Rb^Gvs      , Rb^Gvs      , Gg          , Ch          , Rrc         , Rrc         , Rrc         , Rr^Vhc      , Rrc         , Rrc         , Ch          , 5 Kh        , Ch          , Rrc         , Rrc         , Rrc         , Rrc         , Rrc         , Rrc         , Gg          
Gg          , Gg          , Gg          , Rb^Gvs      , Rb^Gvs      , Rb^Gvs      , Gg          , Gg          , Rb^Gvs      , Rb^Gvs      , Rb^Gvs      , Rb^Gvs      , Rb^Gvs      , Gg          , Gg          , Gg          , Rrc         , Rrc         , Gg          , Rrc         , Gg          , Rb^Gvs      , Rb^Gvs      , Rb^Gvs      , Ww          , Gg          , Gg          , Gg          , Gg          , Rb^Gvs      , Rb^Gvs      , Rb^Gvs      , Rb^Gvs      , Rrc         , Rb^Gvs      , Gs^Vh       , Rb^Gvs      , Rb^Gvs      , Rb^Gvs      , Rb^Gvs      , Rb^Gvs      , Rb^Gvs      , Rb^Gvs      , Rb^Gvs      , Ch          , Rrc         , Rrc         , Rrc         , Rrc         , Rrc         , Ch          , Ch          , Ch          , Ch          , Ch          , Rrc         , Rr^Vhc      , Rrc         , Ch          , Kh          , Gg          
Gg          , Gg          , Rb^Gvs      , Rb^Gvs      , Rb^Gvs      , Gg          , Gg          , Gg          , Rb^Gvs      , Rb^Gvs      , Rb^Gvs      , Rb^Gvs      , Gg          , Gs^Vh       , Rrc         , Rrc         , Gg          , Gg          , Gs^Vh       , Rrc         , Gg          , Rb^Gvs      , Rb^Gvs      , Rb^Gvs      , Gg          , Ww          , Ww          , Gg          , Gg          , Rb^Gvs      , Rb^Gvs      , Rb^Gvs      , Rb^Gvs      , Rrc         , Rb^Gvs      , Rb^Gvs      , Rb^Gvs      , Rb^Gvs      , Gg          , Rb^Gvs      , Rb^Gvs      , Rb^Gvs      , Rb^Gvs      , Gg          , Ch          , Rrc         , Rrc         , Rr^Vhc      , Rrc         , Rrc         , Rrc         , Rrc         , Ch          , Rrc         , Rrc         , Rrc         , Rrc         , Rrc         , Rrc         , Ch          , Gg          
Gg          , Rb^Gvs      , Rb^Gvs      , Rb^Gvs      , Rb^Gvs      , Rb^Gvs      , Gg          , Gg          , Gg          , Rb^Gvs      , Rb^Gvs      , Rb^Gvs      , Rrc         , Rrc         , Gg          , Gg          , Rb^Gvs      , Rb^Gvs      , Gg          , Rrc         , Gg          , Rb^Gvs      , Rb^Gvs      , Rb^Gvs      , Gg          , Gg          , Gg          , Ww          , Ww          , Gg          , Gg          , Rb^Gvs      , Gs^Vh       , Rrc         , Rb^Gvs      , Rb^Gvs      , Rb^Gvs      , Rb^Gvs      , Ww          , Ww          , Ww          , Ww          , Ww          , Ww          , Ww          , Ch          , Rrc         , Rrc         , Rrc         , Rrc         , Rr^Vhc      , Rrc         , Rrc         , Rrc         , Rrc         , Rrc         , Rr^Vhc      , Rrc         , Rrc         , Ch          , Rb^Gvs      
Gg          , Rb^Gvs      , Gs^Vh       , Rb^Gvs      , Rb^Gvs      , Gg          , Rb^Gvs      , Rb^Gvs      , Rb^Gvs      , Gg          , Rrc         , Rrc         , Gg          , Gg          , Gg          , Rb^Gvs      , Rb^Gvs      , Rb^Gvs      , Rb^Gvs      , Rrc         , Gg          , Gg          , Gg          , Rb^Gvs      , Rb^Gvs      , Rb^Gvs      , Gg          , Gg          , Gg          , Ww          , Ww          , Gg          , Gg          , Rrc         , Ww          , Rb^Gvs      , Ww          , Ww          , Ch          , Ch          , Ch          , Ch          , Ch          , Ch          , Ww          , Ch          , Ch          , Rrc         , Rrc         , Rrc         , Rrc         , Rrc         , Rrc         , Rrc         , Rrc         , Rrc         , Rrc         , Rrc         , Rrc         , Ch          , Rb^Gvs      
Gg          , Gg          , Gg          , Rb^Gvs      , Gg          , Rb^Gvs      , Rb^Gvs      , Rb^Gvs      , Gg          , Rrc         , Gg          , Gg          , Rb^Gvs      , Rb^Gvs      , Rb^Gvs      , Rb^Gvs      , Rb^Gvs      , Rb^Gvs      , Rb^Gvs      , Rrc         , Gg          , Gg          , Gg          , Rb^Gvs      , Rb^Gvs      , Rb^Gvs      , Rb^Gvs      , Rb^Gvs      , Rb^Gvs      , Gg          , Gg          , Ww          , Ww          , Ww^Bsb|     , Kh          , Ww          , Ch          , Ch          , Ch          , Ch          , Rrc         , Rrc         , Rrc         , Ch          , Ch          , Ww          , Ww          , 4 Kh        , Rrc         , Rrc         , Rrc         , Rrc         , Rrc         , Rrc         , Kh          , Rrc         , 3 Kh        , Rrc         , Ch          , Ch          , Rb^Gvs      
Gg          , Gg          , Gg          , Gg          , Gg          , Gg          , Rb^Gvs      , Rb^Gvs      , Gg          , Rrc         , Gg          , Gs^Vh       , Rb^Gvs      , Rb^Gvs      , Rb^Gvs      , Gg          , Gg          , Rb^Gvs      , Gg          , Rrc         , Rrc         , Gs^Vh       , Rb^Gvs      , Rb^Gvs      , Rb^Gvs      , Rb^Gvs      , Rb^Gvs      , Rb^Gvs      , Gg          , Gg          , Gg          , Gg          , Kh          , Rrc         , Rrc         , Ch          , Rrc         , Rrc         , Rrc         , Rrc         , Rrc         , Rrc         , Rrc         , Rrc         , Rrc         , Kh          , Rrc         , Ww^Bsb/     , Ww          , Kh          , Ch          , Ch          , Ch          , Ch          , Ww          , Rrc         , Ww          , Ch          , Gg          , Rb^Gvs      , Rb^Gvs      
Gg          , Rb^Gvs      , Rb^Gvs      , Rb^Gvs      , Rb^Gvs      , Gg          , Gg          , Gs^Vh       , Gg          , Rrc         , Gg          , Gg          , Rb^Gvs      , Rb^Gvs      , Gg          , Gg          , Gg          , Rb^Gvs      , Rb^Gvs      , Rb^Gvs      , Rb^Gvs      , Rrc         , Rrc         , Rb^Gvs      , Rb^Gvs      , Rb^Gvs      , Gg          , Rb^Gvs      , Gg          , Gg          , Ch          , Ch          , Rrc         , Rrc         , Rrc         , Rrc         , Rrc         , Rrc         , Rrc         , Rr^Vhc      , Rrc         , Rrc         , Rrc         , Rr^Vhc      , Rrc         , Rrc         , Rrc         , Kh          , Ch          , Ww          , Ww          , Ww          , Ww          , Ww          , Kh          , Ww^Bsb|     , Kh          , Ww          , Ww          , Rb^Gvs      , Rb^Gvs      
Gg          , Rb^Gvs      , Rb^Gvs      , Rb^Gvs      , Rb^Gvs      , Gg          , Gg          , Gg          , Gg          , Rrc         , Gg          , Rb^Gvs      , Rb^Gvs      , Rb^Gvs      , Gg          , Gg          , Rb^Gvs      , Rb^Gvs      , Rb^Gvs      , Rb^Gvs      , Rb^Gvs      , Gs^Vh       , Gg          , Rrc         , Rrc         , Gg          , Gg          , Gg          , Ch          , Ch          , Ch          , Rrc         , Rrc         , Rrc         , Rr^Vhc      , Rrc         , Rrc         , Rrc         , Rrc         , Rrc         , Rrc         , Rrc         , Rrc         , Rrc         , Rrc         , Rrc         , Rrc         , Rrc         , Rrc         , Ch          , Ch          , Ch          , Ch          , Ch          , Rrc         , Rrc         , Rrc         , Ch          , Ch          , Ww          , Ww          
Gg          , Rb^Gvs      , Rb^Gvs      , Rb^Gvs      , Gg          , Gg          , Gg          , Gg          , Rrc         , Rrc         , Gg          , Gg          , Gg          , Gg          , Gg          , Gg          , Gg          , Rb^Gvs      , Rb^Gvs      , Rb^Gvs      , Rb^Gvs      , Gg          , Gg          , Gg          , Rrc         , Gg          , Kh          , Ch          , Rrc         , Ch          , Rrc         , Ch          , Rrc         , Rrc         , Rrc         , Rrc         , Rrc         , Rrc         , Rrc         , Rrc         , Rrc         , Rrc         , Rr^Vhc      , Rrc         , Rrc         , Rrc         , Rr^Vhc      , Rrc         , Rrc         , Rrc         , Rrc         , Rrc         , Rrc         , Rrc         , Rrc         , Rr^Vhc      , Rrc         , Rrc         , Rrc         , Ch          , Ww          
Rrc         , Gg          , Gg          , Gs^Vh       , Gg          , Gg          , Rrc         , Rrc         , Gg          , Gg          , Gg          , Gg          , Gg          , Gg          , Gg          , Gg          , Rb^Gvs      , Rb^Gvs      , Rb^Gvs      , Rb^Gvs      , Rb^Gvs      , Rb^Gvs      , Gg          , Gg          , Kh          , Rrc         , Rrc         , Rrc         , Rrc         , Rrc         , Rrc         , Rrc         , Rrc         , Rrc         , Rrc         , Rrc         , Rr^Vhc      , Rrc         , Rrc         , Rrc         , Rrc         , Rrc         , Rrc         , Rrc         , Rrc         , Rrc         , Rrc         , Rrc         , Rrc         , Rrc         , Rr^Vhc      , Rrc         , Rrc         , Rrc         , Rrc         , Rrc         , Rrc         , Rrc         , Rrc         , Ch          , Ch          
Rb^Gvs      , Rrc         , Rrc         , Gg          , Rrc         , Rrc         , Gg          , Gg          , Rb^Gvs      , Rb^Gvs      , Rb^Gvs      , Gg          , Rb^Gvs      , Gg          , Rb^Gvs      , Gg          , Rb^Gvs      , Rb^Gvs      , Rb^Gvs      , Rb^Gvs      , Rb^Gvs      , Gg          , Gg          , Ch          , Ch          , Rrc         , Rrc         , Rrc         , Rrc         , Rrc         , Rr^Vhc      , Rrc         , Rrc         , Rrc         , Rrc         , Rrc         , Rrc         , Rrc         , Rrc         , Rrc         , Ch          , Ch          , Ch          , Ch          , Ch          , Rrc         , Rrc         , Rr^Vhc      , Rrc         , Rrc         , Rrc         , Rrc         , Rrc         , Rr^Vhc      , Rrc         , Rrc         , Rrc         , Rrc         , Rrc         , Rrc         , Rrc         
Rb^Gvs      , Rb^Gvs      , Gs^Vh       , Rrc         , Rrc         , Gg          , Gg          , Rb^Gvs      , Rb^Gvs      , Rb^Gvs      , Rb^Gvs      , Rb^Gvs      , Rb^Gvs      , Rb^Gvs      , Rb^Gvs      , Rb^Gvs      , Gg          , Rb^Gvs      , Gs^Vh       , Rb^Gvs      , Gg          , Gg          , Ch          , Ch          , Rrc         , Rrc         , Rrc         , Rrc         , Rrc         , Rrc         , Rrc         , Rrc         , Rrc         , Rrc         , Rrc         , Rrc         , Rrc         , Rrc         , Rrc         , 2 Kh        , Rrc         , Rrc         , Rrc         , Rrc         , Rrc         , Kh          , Rrc         , Rrc         , Rrc         , Rrc         , Rrc         , Rrc         , Rrc         , Rrc         , Rrc         , Rrc         , Rrc         , Rrc         , Rr^Vhc      , Rrc         , Rrc         
Rb^Gvs      , Rb^Gvs      , Gg          , Gg          , Gg          , Rrc         , Rrc         , Gs^Vh       , Gg          , Rb^Gvs      , Rb^Gvs      , Rb^Gvs      , Rb^Gvs      , Rb^Gvs      , Rb^Gvs      , Rb^Gvs      , Gg          , Gg          , Gg          , Gg          , Ch          , Ch          , Rrc         , Rrc         , Rrc         , Rrc         , Rr^Vhc      , Rrc         , Rrc         , Rrc         , Rrc         , Rrc         , Ch          , Rrc         , Ch          , Ch          , Ch          , Kh          , Rrc         , Rrc         , Rrc         , Rr^Vhc      , Rrc         , Rrc         , Rrc         , Rrc         , Rrc         , Kh          , Ch          , Rrc         , Rrc         , Rrc         , Rrc         , Rrc         , Rrc         , Rrc         , Rrc         , Rrc         , Rrc         , Rrc         , Rrc         
Gg          , Rb^Gvs      , Gg          , Rb^Gvs      , Rb^Gvs      , Rb^Gvs      , Gs^Vh       , Rrc         , Rrc         , Gg          , Gg          , Gg          , Gs^Vh       , Rb^Gvs      , Gg          , Rb^Gvs      , Gg          , Gg          , Gg          , Gg          , Ch          , Rrc         , Rrc         , Rrc         , Rrc         , Rrc         , Rrc         , Rrc         , Rrc         , Rrc         , Rrc         , Ch          , Rrc         , Ch          , Rrc         , Rrc         , Rrc         , Rrc         , Rr^Vhc      , Rrc         , Rrc         , Rrc         , Rrc         , Rrc         , Rr^Vhc      , Rrc         , Rrc         , Rrc         , Rrc         , Ch          , Rrc         , Rrc         , Rrc         , Rr^Vhc      , Rrc         , Rrc         , Rrc         , Rrc         , Rr^Vhc      , Rrc         , Rrc         
Gg          , Gg          , Rb^Gvs      , Rb^Gvs      , Rb^Gvs      , Rb^Gvs      , Gg          , Rrc         , Gg          , Rrc         , Rrc         , Rrc         , Rrc         , Rb^Gvs      , Gg          , Gg          , Ch          , Ch          , Ch          , Ch          , Rrc         , Rrc         , Rrc         , Rrc         , Rrc         , Rrc         , Rrc         , Rrc         , Rrc         , Rrc         , Ch          , Ch          , Rrc         , Rrc         , Rrc         , Rrc         , Rrc         , Rrc         , Rrc         , Rrc         , Rrc         , Rrc         , Rr^Vhc      , Rrc         , Rrc         , Rrc         , Rrc         , Rrc         , Rrc         , Ch          , Ch          , Rrc         , Rrc         , Rrc         , Rrc         , Rrc         , Rr^Vhc      , Rrc         , Rrc         , Rrc         , Rrc         
Gg          , Gg          , Rb^Gvs      , Rb^Gvs      , Rb^Gvs      , Rb^Gvs      , Gg          , Rrc         , Gg          , Gs^Vh       , Rb^Gvs      , Gg          , Gg          , Rrc         , Rrc         , Kh          , Ch          , Rrc         , Rrc         , Rrc         , Rr^Vhc      , Rrc         , Rrc         , Rrc         , Rrc         , Rr^Vhc      , Rrc         , Rrc         , Ch          , Ch          , Rrc         , Rrc         , Rrc         , Rrc         , Rr^Vhc      , Rrc         , Rrc         , Rrc         , Rrc         , Rrc         , Rrc         , Rrc         , Rrc         , Rrc         , Rrc         , Rrc         , Rrc         , Rrc         , Rrc         , Rrc         , Rrc         , Ch          , Kh          , Rrc         , Rrc         , Rrc         , Rrc         , Rrc         , Rrc         , Rrc         , Rrc         
Gg          , Gg          , Gg          , Rb^Gvs      , Gg          , Gg          , Gg          , Rrc         , Gg          , Rb^Gvs      , Rb^Gvs      , Rb^Gvs      , Rb^Gvs      , Gg          , Kh          , Rrc         , Rrc         , Rrc         , Rrc         , Rrc         , Rrc         , Rrc         , Rrc         , Rrc         , Rrc         , Rrc         , Rrc         , Kh          , Rrc         , Rrc         , Rrc         , Rrc         , Rrc         , Rrc         , Rrc         , Rrc         , Rrc         , Rrc         , Rr^Vhc      , Rrc         , Rrc         , Rrc         , Rrc         , Rrc         , Rrc         , Rrc         , Rrc         , Rr^Vhc      , Rrc         , Rrc         , Rrc         , Rrc         , Rrc         , Rrc         , Kh          , Rrc         , Rrc         , Rrc         , Rrc         , Rrc         , Rrc         
Gg          , Gg          , Gg          , Gg          , Rb^Gvs      , Gg          , Rb^Gvs      , Rrc         , Rrc         , Rb^Gvs      , Rb^Gvs      , Rb^Gvs      , Gg          , Gg          , Ch          , Rrc         , Rrc         , Rrc         , Rrc         , Rrc         , Rrc         , Rrc         , Rrc         , Rrc         , Rrc         , Rrc         , Kh          , Rrc         , Rrc         , Rr^Vhc      , Rrc         , Rrc         , Rrc         , Rrc         , Rrc         , Rrc         , Rr^Vhc      , Rrc         , Rrc         , Rrc         , Ch          , Ch          , Ch          , Rrc         , Rrc         , Rr^Vhc      , Rrc         , Rrc         , Rrc         , Rrc         , Rrc         , Rr^Vhc      , Rrc         , Rrc         , Ch          , Rrc         , Rrc         , Rrc         , Rr^Vhc      , Rr^Vhc      , Rrc         
Rb^Gvs      , Rb^Gvs      , Gg          , Rb^Gvs      , Rb^Gvs      , Rb^Gvs      , Rb^Gvs      , Gg          , Rrc         , Gg          , Rb^Gvs      , Rb^Gvs      , Gg          , Ch          , Ch          , Rrc         , Rrc         , Rrc         , Rrc         , Rrc         , Rr^Vhc      , Rrc         , Rrc         , Rrc         , Rr^Vhc      , Rrc         , Ch          , Rrc         , Rrc         , Rrc         , Rrc         , Rrc         , Rr^Vhc      , Rrc         , Rrc         , Rrc         , Rrc         , Rrc         , Ch          , Ch          , Gs^Fds      , Ch          , Gs^Fds      , Ch          , Ch          , Rrc         , Rrc         , Rrc         , Rrc         , Rrc         , Rrc         , Rrc         , Rrc         , Rrc         , Rrc         , Ch          , Ch          , Rrc         , Rrc         , Rrc         , Rrc         
Rb^Gvs      , Rb^Gvs      , Gg          , Rb^Gvs      , Rb^Gvs      , Rb^Gvs      , Gs^Vh       , Gg          , Rrc         , Gg          , Gg          , Gg          , Gg          , Ch          , Rrc         , Rrc         , Rrc         , Rrc         , Rr^Vhc      , Rrc         , Rrc         , Rrc         , Rrc         , Rrc         , Rrc         , Rrc         , Ch          , Rrc         , Rrc         , Rrc         , Rrc         , Rrc         , Rrc         , Rrc         , Rrc         , Rrc         , Ch          , Ch          , Gg^Fet      , Gs^Fds      , Gg^Efm      , Ch          , Gg^Efm      , Gs^Fds      , Ww^Ewl      , Ch          , Ch          , Rrc         , Rrc         , Rr^Vhc      , Rrc         , Rrc         , Rrc         , Rr^Vhc      , Rrc         , Rrc         , Ch          , Rrc         , Rrc         , Rrc         , Rrc         
Rb^Gvs      , Rb^Gvs      , Gg          , Gg          , Gg          , Gg          , Rrc         , Rrc         , Gg          , Rrc         , Rrc         , Gg          , Gg          , Ch          , Rrc         , Rrc         , Rrc         , Rrc         , Rrc         , Rrc         , Rrc         , Rrc         , Rrc         , Rrc         , Rrc         , Rrc         , Ch          , Rrc         , Rrc         , Rr^Vhc      , Rrc         , Rrc         , Rrc         , Rrc         , Ch          , Ch          , Ww          , Gg^Efm      , Gg^Efm      , Gg^Efm      , Gg^Efm      , Ch          , Gg^Efm      , Gg          , Gg          , Ww          , Ww          , Ch          , Ch          , Rrc         , Rrc         , Rrc         , Rrc         , Rrc         , Rrc         , Rrc         , Ch          , Rrc         , Rrc         , Rrc         , Rrc         
Rb^Gvs      , Rb^Gvs      , Gg          , Gg          , Rrc         , Rrc         , Gg          , Gg          , Rb^Gvs      , Gg          , Gs^Vh       , Rrc         , Rrc         , Kh          , Rrc         , Rrc         , Rrc         , Rrc         , Rrc         , Rrc         , Rrc         , Rr^Vhc      , Rrc         , Rrc         , Rrc         , Ch          , Rrc         , Rrc         , Rrc         , Rrc         , Rrc         , Rrc         , Rrc         , Rrc         , Ch          , Ch          , Ch          , Ww          , Gg^Efm      , Gg^Efm      , Ch          , Ch          , Ch          , Gg^Fet      , Gg^Efm      , Ww^Ewf      , Ch          , Ch          , Ch          , Rrc         , Rrc         , Rrc         , Rr^Vhc      , Rrc         , Rrc         , Rrc         , Ch          , Rrc         , Rr^Vhc      , Rrc         , Rrc         
Gg          , Gs^Vh       , Rrc         , Rrc         , Gs^Vh       , Gg          , Gg          , Rb^Gvs      , Rb^Gvs      , Rb^Gvs      , Rb^Gvs      , Gg          , Gg          , Rrc         , Rrc         , Rr^Vhc      , Rrc         , Rrc         , Rrc         , Rrc         , Rrc         , Rrc         , Rrc         , Rrc         , Rrc         , Ch          , Rrc         , Rrc         , Rr^Vhc      , Rrc         , Rrc         , Rrc         , Rr^Vhc      , Rrc         , Ch          , Ww          , Ww^Ewl      , Ch          , Ch          , Ch          , Ch          , Ch          , Ch          , Ch          , Ch          , Ch          , Gg          , Gg          , Ch          , Rrc         , Rrc         , Rrc         , Rrc         , Rrc         , Rrc         , Rrc         , Ch          , Rrc         , Rrc         , Rrc         , Rrc         
Rrc         , Rrc         , Rb^Gvs      , Rb^Gvs      , Rb^Gvs      , Gg          , Gg          , Rb^Gvs      , Rb^Gvs      , Rb^Gvs      , Rb^Gvs      , Gg          , Gg          , Kh          , Rrc         , Rrc         , Rrc         , Rrc         , Rrc         , Rrc         , Rr^Vhc      , Rrc         , Rrc         , Rrc         , Rrc         , Ch          , Rrc         , Rrc         , Rrc         , Rrc         , Rrc         , Rrc         , Rrc         , Rrc         , Ch          , Ww          , Gg          , Gg          , Ch          , Ch          , Kh          , Kh          , Kh          , Ch          , Ch          , Ww          , Gg^Efm      , Gg^Fet      , Ch          , Rrc         , Rrc         , Rrc         , Rrc         , Rrc         , Rrc         , Rrc         , Ch          , Rrc         , Rrc         , Rr^Vhc      , Rrc         
Gg          , Gg          , Rb^Gvs      , Rb^Gvs      , Rb^Gvs      , Rb^Gvs      , Gg          , Gg          , Gg          , Rb^Gvs      , Gg          , Gg          , Gg          , Ch          , Rrc         , Rrc         , Rrc         , Rrc         , Rrc         , Rrc         , Rrc         , Rrc         , Rrc         , Rrc         , Rrc         , Ch          , Rrc         , Rrc         , Rr^Vhc      , Rrc         , Rrc         , Rrc         , Rrc         , Rrc         , Ch          , Ww          , Gg^Fet      , Gg^Efm      , Ch          , Ch          , Kh          , 1 Kh        , Kh          , Ch          , Ch          , Ww^Ewf      , Gg^Efm      , Gg          , Ch          , Rrc         , Rrc         , Rrc         , Rrc         , Rrc         , Rrc         , Rrc         , Ch          , Rrc         , Rrc         , Rrc         , Rrc         
Gg          , Gg          , Rb^Gvs      , Rb^Gvs      , Rb^Gvs      , Rb^Gvs      , Gg          , Gg          , Gg          , Gg          , Gg          , Gg          , Gg          , Ch          , Rrc         , Rrc         , Rr^Vhc      , Rrc         , Rrc         , Rrc         , Rrc         , Rrc         , Rr^Vhc      , Rrc         , Rrc         , Ch          , Rrc         , Rrc         , Rrc         , Rrc         , Rrc         , Rrc         , Rrc         , Rrc         , Ch          , Gs^Fds      , Gg^Efm      , Gg^Efm      , Ch          , Ch          , Ch          , Kh          , Ch          , Ch          , Ch          , Gg          , Gs^Fds      , Gg^Fet      , Ch          , Rrc         , Rrc         , Rr^Vhc      , Rrc         , Rrc         , Rrc         , Rrc         , Rrc         , Ch          , Ch          , Rrc         , Rrc         
Gg          , Gg          , Gg          , Rb^Gvs      , Rb^Gvs      , Gg          , Gg          , Gg          , Gg          , Gg          , Gg          , Gg          , Gg          , Ch          , Rrc         , Rrc         , Rrc         , Rrc         , Rrc         , Rrc         , Rrc         , Rrc         , Rrc         , Rrc         , Rrc         , Ch          , Rrc         , Rrc         , Rrc         , Rrc         , Rrc         , Rr^Vhc      , Rrc         , Rrc         , Ch          , Gs^Fds      , Ch          , Ch          , Gg^Fet      , Ch          , Ch          , Ch          , Ch          , Ch          , Gg          , Ch          , Ch          , Gs^Fds      , Ch          , Rrc         , Rrc         , Rrc         , Rrc         , Rrc         , Rrc         , Rr^Vhc      , Rrc         , Rrc         , Ch          , Rr^Vhc      , Rrc         
