border_size=1
usage=map

Xos         , Xos         , Xos         , Xos         , Xos         , Xos         , Xos         , Xos         , Xos         , Xos         , Xos         , Xos         , Xos         , Xos         , Xos         , Xos         , Xos         , Xos         , Xos         , Xos         , Xos         , Xos         , Xos         , Xos         , Xos         , Xos         , Xos         , Xos         , Xos         , Xos         , Xos         , Xos         , Xos         , Xos         , Xos         , Xos         , Xos         , Xos         , Xos         , Xos         , Xos         , Xos         , Xos         , Xos         , Xos         , Xos         , Xos         , Xos         , Xos         , Xos         , Xos         
Xos         , Xos         , Xos         , Xos         , Xos         , Xos         , Xos         , Xos         , Xos         , Xos         , Xos         , Xos         , Xos         , Xos         , Xos         , Xos         , Xos         , Xos         , Xos         , Xos         , Xos         , Xos         , Uu^Vu       , Xos         , Urb         , Urb         , Cud         , Urb         , Urb         , Xos         , Urb         , Xos         , Urb         , Xos         , Xos         , Xos         , Xos         , Xos         , Xos         , Xos         , Xos         , Xos         , Xos         , Xos         , Xos         , Xos         , Xos         , Xos         , Xos         , Xos         , Xos         
Xos         , Xos         , Xos         , Xos         , Xos         , Xos         , Xos         , Xos         , Xos         , Xos         , Xos         , Xos         , Urb         , Urb         , Urb         , Urb         , Uu^Vu       , Xos         , Urb         , Urb         , Urb         , Urb         , Urb         , Urb         , Urb         , Urb         , Cud         , Cud         , Urb         , Urb         , Urb         , Urb         , Urb         , Urb         , Urb         , Xos         , Uu^Vu       , Xos         , Xos         , Xos         , Xos         , Xos         , Xos         , Xos         , Xos         , Xos         , Xos         , Xos         , Xos         , Xos         , Xos         
Xos         , Xos         , Xos         , Xos         , Xos         , Xos         , Xos         , Xos         , Xos         , Xos         , Urb         , Urb         , Urb         , Urb         , Urb         , Urb         , Urb         , Urb         , Urb         , Urb         , Urb         , Urb         , Urb         , Urb         , Urb         , Cud         , 4 Kud       , Cud         , Urb         , Urb         , Urb         , Urb         , Urb         , Urb         , Urb         , Urb         , Urb         , Urb         , Uu^Vu       , Xos         , Xos         , Xos         , Xos         , Xos         , Xos         , Xos         , Xos         , Xos         , Xos         , Xos         , Xos         
Xos         , Xos         , Xos         , Xos         , Xos         , Xos         , Urb         , Urb         , Urb         , Uu^Vu       , Urb         , Urb         , Urb         , Urb         , Urb         , Urb         , Urb         , Urb         , Urb         , Urb         , Urb         , Urb         , Urb         , Urb         , Urb         , Cud         , Cud         , Cud         , Urb         , Urb         , Urb         , Urb         , Urb         , Urb         , Urb         , Urb         , Xos         , Xos         , Xos         , Xos         , Xos         , Xos         , Xos         , Xos         , Xos         , Xos         , Xos         , Xos         , Xos         , Xos         , Xos         
Xos         , Xos         , Urb         , Urb         , Urb         , Xos         , Urb         , Urb         , Urb         , Urb         , Urb         , Urb         , Urb         , Urb         , Urb         , Urb         , Urb         , Urb         , Urb         , Urb         , Urb         , Urb         , Urb         , Urb         , Urb         , Urb         , Urb         , Urb         , Urb         , Urb         , Urb         , Urb         , Urb         , Urb         , Xos         , Xos         , Urb         , Urb         , Urb         , Uu^Vu       , Xos         , Xos         , Xos         , Xos         , Xos         , Xos         , Xos         , Xos         , Xos         , Xos         , Xos         
Urb         , Urb         , Urb         , Urb         , Urb         , Urb         , Urb         , Urb         , Urb         , Urb         , Urb         , Urb         , Urb         , Urb         , Urb         , Urb         , Urb         , Urb         , Urb         , Urb         , Urb         , Uu^Vu       , Urb         , Urb         , Urb         , Urb         , Urb         , Urb         , Urb         , Urb         , Urb         , Urb         , Urb         , Urb         , Xos         , Urb         , Urb         , Urb         , Urb         , Urb         , Urb         , Xos         , Xos         , Xos         , Urb         , Urb         , Urb         , Xos         , Xos         , Xos         , Xos         
Urb         , Urb         , Urb         , Urb         , Urb         , Urb         , Urb         , Urb         , Urb         , Urb         , Urb         , Xos         , Xos         , Urb         , Urb         , Urb         , Urb         , Urb         , Urb         , Urb         , Urb         , Urb         , Urb         , Urb         , Urb         , Urb         , Cud         , Cud         , Urb         , Urb         , Urb         , Urb         , Urb         , Uu^Vu       , Xos         , Xos         , Urb         , Urb         , Urb         , Urb         , Urb         , Urb         , Urb         , Urb         , Urb         , Urb         , Cud         , Urb         , Urb         , Urb         , Urb         
Urb         , Urb         , Cud         , Cud         , Cud         , Urb         , Urb         , Urb         , Urb         , Urb         , Urb         , Xos         , Xos         , Xos         , Urb         , Urb         , Urb         , Urb         , Urb         , Urb         , Urb         , Urb         , Urb         , Urb         , Urb         , Cud         , 3 Kud       , Cud         , Urb         , Urb         , Urb         , Urb         , Xos         , Xos         , Xos         , Xos         , Urb         , Urb         , Urb         , Urb         , Urb         , Urb         , Urb         , Urb         , Urb         , Urb         , Cud         , Cud         , Cud         , Urb         , Urb         
Urb         , Urb         , Cud         , Kud         , Cud         , Urb         , Urb         , Urb         , Urb         , Urb         , Xos         , Xos         , Xos         , Xos         , Urb         , Urb         , Urb         , Urb         , Urb         , Urb         , Urb         , Urb         , Urb         , Urb         , Urb         , Cud         , Cud         , Cud         , Urb         , Urb         , Urb         , Urb         , Xos         , Xos         , Xos         , Uu^Vu       , Urb         , Urb         , Urb         , Urb         , Urb         , Urb         , Urb         , Urb         , Urb         , Cud         , Cud         , 1 Kud       , Cud         , Urb         , Urb         
Urb         , Urb         , Cud         , Cud         , Cud         , Urb         , Urb         , Urb         , Urb         , Urb         , Xos         , Xos         , Xos         , Xos         , Urb         , Urb         , Urb         , Urb         , Urb         , Urb         , Urb         , Urb         , Urb         , Urb         , Urb         , Urb         , Urb         , Urb         , Uu^Vu       , Urb         , Urb         , Urb         , Xos         , Xos         , Urb         , Urb         , Urb         , Urb         , Urb         , Urb         , Urb         , Xos         , Urb         , Urb         , Urb         , Urb         , Cud         , Cud         , Urb         , Urb         , Urb         
Urb         , Urb         , Urb         , Cud         , Urb         , Urb         , Urb         , Urb         , Urb         , Uu^Vu       , Xos         , Xos         , Xos         , Xos         , Xos         , Urb         , Urb         , Urb         , Urb         , Urb         , Urb         , Urb         , Urb         , Urb         , Urb         , Urb         , Urb         , Urb         , Urb         , Urb         , Urb         , Urb         , Xos         , Xos         , Urb         , Urb         , Urb         , Urb         , Urb         , Urb         , Xos         , Xos         , Xos         , Urb         , Urb         , Urb         , Urb         , Urb         , Urb         , Urb         , Xos         
Xos         , Urb         , Urb         , Urb         , Urb         , Urb         , Urb         , Urb         , Xos         , Xos         , Xos         , Xos         , Xos         , Xos         , Xos         , Uu^Vu       , Urb         , Urb         , Urb         , Urb         , Urb         , Urb         , Urb         , Urb         , Cud         , Urb         , Cud         , Urb         , Urb         , Urb         , Urb         , Urb         , Xos         , Xos         , Urb         , Urb         , Urb         , Urb         , Urb         , Urb         , Xos         , Xos         , Xos         , Xos         , Xos         , Urb         , Urb         , Urb         , Xos         , Xos         , Xos         
Xos         , Urb         , Urb         , Urb         , Xos         , Urb         , Xos         , Xos         , Xos         , Xos         , Xos         , Xos         , Xos         , Xos         , Xos         , Xos         , Urb         , Urb         , Urb         , Urb         , Urb         , Urb         , Urb         , Urb         , Cud         , Cud         , 2 Kud       , Cud         , Urb         , Urb         , Urb         , Urb         , Urb         , Xos         , Urb         , Urb         , Urb         , Urb         , Urb         , Urb         , Urb         , Xos         , Xos         , Xos         , Xos         , Xos         , Xos         , Xos         , Xos         , Xos         , Xos         
Xos         , Xos         , Xos         , Xos         , Xos         , Xos         , Xos         , Xos         , Xos         , Xos         , Xos         , Xos         , Xos         , Xos         , Xos         , Xos         , Xos         , Urb         , Urb         , Urb         , Urb         , Urb         , Urb         , Urb         , Urb         , Cud         , Cud         , Cud         , Urb         , Urb         , Urb         , Urb         , Urb         , Urb         , Urb         , Urb         , Urb         , Urb         , Urb         , Urb         , Uu^Vu       , Xos         , Xos         , Xos         , Xos         , Xos         , Xos         , Xos         , Xos         , Xos         , Xos         
Xos         , Xos         , Xos         , Xos         , Xos         , Xos         , Xos         , Xos         , Xos         , Xos         , Xos         , Xos         , Xos         , Xos         , Xos         , Xos         , Xos         , Urb         , Urb         , Urb         , Uu^Vu       , Urb         , Urb         , Urb         , Urb         , Urb         , Urb         , Urb         , Urb         , Urb         , Urb         , Urb         , Urb         , Urb         , Urb         , Urb         , Urb         , Urb         , Urb         , Urb         , Urb         , Xos         , Xos         , Xos         , Xos         , Xos         , Xos         , Xos         , Xos         , Xos         , Xos         
Xos         , Xos         , Xos         , Xos         , Xos         , Xos         , Xos         , Xos         , Xos         , Xos         , Xos         , Xos         , Xos         , Xos         , Xos         , Xos         , Xos         , Xos         , Xos         , Urb         , Xos         , Urb         , Xos         , Urb         , Urb         , Urb         , Urb         , Urb         , Urb         , Urb         , Urb         , Urb         , Urb         , Uu^Vu       , Urb         , Urb         , Urb         , Urb         , Urb         , Urb         , Urb         , Xos         , Xos         , Xos         , Xos         , Xos         , Xos         , Xos         , Xos         , Xos         , Xos         
Xos         , Xos         , Xos         , Xos         , Xos         , Xos         , Xos         , Xos         , Xos         , Xos         , Xos         , Xos         , Xos         , Xos         , Xos         , Xos         , Xos         , Xos         , Xos         , Xos         , Xos         , Xos         , Xos         , Xos         , Xos         , Urb         , Urb         , Urb         , Urb         , Urb         , Urb         , Urb         , Urb         , Urb         , Urb         , Urb         , Urb         , Urb         , Urb         , Urb         , Xos         , Xos         , Xos         , Xos         , Xos         , Xos         , Xos         , Xos         , Xos         , Xos         , Xos         
Xos         , Xos         , Xos         , Xos         , Xos         , Xos         , Xos         , Xos         , Xos         , Xos         , Xos         , Xos         , Xos         , Xos         , Xos         , Xos         , Xos         , Xos         , Xos         , Xos         , Xos         , Xos         , Xos         , Xos         , Xos         , Xos         , Xos         , Xos         , Xos         , Urb         , Xos         , Xos         , Xos         , Xos         , Xos         , Xos         , Xos         , Xos         , Xos         , Xos         , Xos         , Xos         , Xos         , Xos         , Xos         , Xos         , Xos         , Xos         , Xos         , Xos         , Xos         
Xos         , Xos         , Xos         , Xos         , Xos         , Xos         , Xos         , Xos         , Xos         , Xos         , Xos         , Xos         , Xos         , Xos         , Xos         , Xos         , Xos         , Xos         , Xos         , Xos         , Xos         , Xos         , Xos         , Xos         , Xos         , Xos         , Xos         , Xos         , Xos         , Xos         , Xos         , Xos         , Xos         , Xos         , Xos         , Xos         , Xos         , Xos         , Xos         , Xos         , Xos         , Xos         , Xos         , Xos         , Xos         , Xos         , Xos         , Xos         , Xos         , Xos         , Xos         
