border_size=1
usage=map

Md^Xm, Md^Xm, Md^Xm, Md^Xm, Md^Xm, Md^Xm, Md^Xm, Md^Xm, Md^Xm, Md^Xm, Md^Xm, Md^Xm, Md^Xm, Md^Xm, Md^Xm, Md^Xm, Md^Xm, Md^Xm, Md^Xm, Md^Xm, Md^Xm, Md^Xm, Md^Xm, Md^Xm, Md^Xm, Md^Xm, Md^Xm, Md^Xm, Md^Xm, Md^Xm, Md^Xm, Md^Xm, Md^Xm, Md^Xm, Md^Xm, Md^Xm, Md^Xm, Md^Xm, Md^Xm, Md^Xm, Md^Xm, Md^Xm, Md^Xm, Md^Xm, Md^Xm, Md^Xm, Md^Xm, Md^Xm, Md^Xm, Md^Xm, Md^Xm, Md^Xm, Md^Xm, Md^Xm, Md^Xm, Md^Xm, Md^Xm, Md^Xm, Md^Xm, Md^Xm, Md^Xm
Md^Xm, Md^Xm, Md^Xm, Md^Xm, Md^Xm, Md^Xm, Md^Xm, Md^Xm, Md^Xm, Md^Xm, Md^Xm, Md^Xm, Md^Xm, Md^Xm, Md^Xm, Md^Xm, Md^Xm, Md^Xm, Md^Xm, Md^Xm, Md^Xm, Md^Xm, Md^Xm, Md, Mv, Md^Xm, Md, Md, Md, Md^Xm, Md, Md^Xm, Md, Md^Xm, Md^Xm, Md^Xm, Md^Xm, Md^Xm, Md^Xm, Md^Xm, Md^Xm, Md^Xm, Md^Xm, Md^Xm, Md^Xm, Md^Xm, Md^Xm, Md^Xm, Md^Xm, Md^Xm, Md^Xm, Md^Xm, Md^Xm, Md^Xm, Md, Md, Md, Md^Xm, Md^Xm, Md^Xm, Md^Xm
Md^Xm, Md^Xm, Md^Xm, Md^Xm, Md^Xm, Md^Xm, Md^Xm, Md^Xm, Md^Xm, Md^Xm, Md^Xm, Md^Xm, Md^Xm, Md^Xm, Md, Md^Xm, Md, Md^Xm, Md, Md^Xm, Md, Md^Xm, Md, Md, Md, Md, Uh, Md, Md, Md, Uh, Md, Uh, Md, Md, Md^Xm, Md^Xm, Md^Xm, Mv, Md^Xm, Md^Xm, Md^Xm, Md^Xm, Md^Xm, Md^Xm, Md^Xm, Md^Xm, Md^Xm, Md^Xm, Md^Xm, Md, Md, Uh, Md, Uh, Md, Md, Md^Xm, Md^Xm, Md^Xm, Md^Xm
Md^Xm, Md^Xm, Md^Xm, Md^Xm, Md^Xm, Md^Xm, Md^Xm, Md^Xm, Md^Xm, Md^Xm, Md^Xm, Md^Xm, Md^Xm, Md^Xm, Md, Md, Md, Md, Md, Md, Md, Md, Uh, Uh, Uh, Uh, Uh, Md, Uh, Uh^Zewt, Zwsl, Uh, Uh, Uh, Uh, Md, Md, Md, Md, Md, Md, Md^Xm, Md^Xm, Md^Xm, Md^Xm, Md^Xm, Md^Xm, Md^Xm, Md^Xm, Md, Md, Uh, Cud, Uh, Cud, Uh, Md, Md, Md^Xm, Md^Xm, Md^Xm
Md^Xm, Md^Xm, Md^Xm, Md^Xm, Md^Xm, Md^Xm, Md^Xm, Md^Xm, Md^Xm, Md^Xm, Md^Xm, Md^Xm, Md, Md, Md, Md, Uh, Md, Md, Md, Uh, Uh, Cud, 4 Kud, Cud, Uh, Uu^Zewt, Uu, Uu, Zwsl, Zwsl^Zews, Uu, Uu, Uh, Uh, Uh, Uh^Zewt, Uh, Uh, Md, Md, Md^Xm, Md^Xm, Md^Xm, Md^Xm, Md^Xm, Md, Md^Xm, Uh, Md, Uh, Uh, Cud, 3 Kud, Cud, Uh, Md, Md, Md^Xm, Md^Xm, Md^Xm
Md^Xm, Md^Xm, Md^Xm, Md^Xm, Md^Xm, Md^Xm, Md, Md^Xm, Md, Md^Xm, Uh, Mv, Md, Md, Md, Uu, Uu, Uu, Uh, Uu, Uh^Zewt, Uu, Uh, Cud, Uh, Uh, Uh, Uh, Uh, Zwsl, Uh, Zwsl, Zwsl^Zewe, Uu^Zewt, Uu, Uh, Uh^Zewt, Uh, Uh, Uh, Md, Md, Md, Md^Xm, Md, Md^Xm, Md, Md^Xm, Zwsl, Uh^Zewt, Zgwl, Zwsl, Zwsl, Cud, Uh, Uh, Md, Md, Md^Xm, Md^Xm, Md^Xm
Md^Xm, Md^Xm, Md^Xm, Md^Xm, Md^Xm, Md^Xm, Md^Xm, Md, Md, Md, Uh, Qlf, Uh, Md, Uh, Uu, Md, Uh, Md, Uh, Md, Uh, Md, Uh, Md, Md, Md, Md, Md, Uh, Uh, Zwsl, Uu, Zwsl, Zwsl, Zwsl, Zwsl, Uu, Uu, Uh, Uh, Uh, Uh, Md, Md, Md, Uh, Zwsl, Zwsl, Zwsl, Zwsl, Zwsl, Md, Uh, Uh, Md, Md, Md, Md^Xm, Md^Xm, Md^Xm
Md^Xm, Md^Xm, Md^Xm, Md^Xm, Md^Xm, Md^Xm, Md, Md, Uh, Uh, Zvw^Zewe, Qlf, Uu, Uh, Zwsl, Uu, Md, Md, Md, Md, Md, Md, Md^Xm, Md^Xm, Md^Xm, Md, Md^Xm, Md, Md, Md, Uh, Uh, Uu, Uu, Zwsl, Zwsl, Zvw, Zwsl, Zwsl, Uh, Uu, Uh, Uh^Zewt, Uu, Uu^Zewt, Uu, Zwsl^Zewe, Zwsl, Uh, Uh, Md, Md, Md, Md, Md, Md, Md^Xm, Md, Md^Xm, Md^Xm, Md^Xm
Md^Xm, Md^Xm, Md^Xm, Md^Xm, Md, Md, Md, Uh, Uh, Uh, Qlf, Qlf, Zvw, Uu, Zvw, Uh, Md, Md, Md^Xm, Md^Xm, Md^Xm, Md^Xm, Md^Xm, Md^Xm, Md^Xm, Md^Xm, Md^Xm, Md^Xm, Md^Xm, Md, Md, Uh, Uh^Zewt, Uu, Zwsl, Zvw^Zewe, Zwsl, Zwsl, Zwsl, Uu, Zwsl, Uh, Zwsl, Zwsl, Zwsl, Zwsl, Md, Md, Md, Md, Md^Xm, Md^Xm, Md, Md^Xm, Md^Xm, Md^Xm, Md^Xm, Md^Xm, Md^Xm, Md^Xm, Md^Xm
Md^Xm, Md^Xm, Md^Xm, Md^Xm, Md, Md, Uh, Uh, Uu, Uu, Qlf, Zvw, Zvw^Zewc, Zgwl, Uh, Uh, Md, Md, Md^Xm, Xu, Xu, Xu, Xu, Xu, Xu, Xu, Xu, Xu, Md^Xm, Md^Xm, Md, Md, Uh, Uu^Zewt, Zwsl, Zwsl, Zwsl, Zvw, Zwsl, Zwsl, Zwsl, Zwsl, Zwsl, Zwsl, Uu, Uh, Uh, Md, Md, Md, Md, Md^Xm, Md^Xm, Md^Xm, Md^Xm, Md^Xm, Md^Xm, Md^Xm, Md^Xm, Md^Xm, Md^Xm
Md^Xm, Md^Xm, Md, Md, Md, Uh, Uh, Uu, Zvw, Qlf^Bs\, Zvw, Zvw, Uh, Uh^Zewt, Uh, Md, Md, Md, Md^Xm, Xu, Ur, Ur, Ur, Xu, Ur, Ur, Ur, Xu, Md^Xm, Md^Xm, Md, Md, Uh, Uu, Zwsl, Zwsl, Zwsl, Zwsl, Zwsl, Zwsl^Zewt, Zwsl, Zwsl, Zwsl, Uh, Uh, Uu, Qlf, Mv, Md, Md, Md, Md, Md^Xm, Md^Xm, Md^Xm, Md^Xm, Md^Xm, Md^Xm, Md^Xm, Md^Xm, Md^Xm
Md^Xm, Md^Xm, Md, Md, Md, Uh, Zgwl, Zvw, Qlf, Qlf, Uu, Uu, Uh, Uh^Zewt, Md, Md, Md, Md, Md^Xm, Xu, Ur, Xu, Ur, Xu, Ur, Xu, Ur, Xu, Md^Xm, Md^Xm, Md, Uh, Zwsl, Zwsl, Zwsl, Zwsl, Zvw, Zwsl^Zewc, Zwsl, Zwsl, Zwsl, Zvw, Zwsl, Zwsl^Zewe, Zwsl, Uh, Qlf, Uh, Uh, Md, Md, Md, Md, Md^Xm, Md^Xm, Md^Xm, Md^Xm, Md^Xm, Md^Xm, Md^Xm, Md^Xm
Md^Xm, Md^Xm, Md, Md, Uh, Uh, Qlf, Qlf, Uu, Uu, Uu, Uh, Uh, Uh, Md, Md, Md, Md^Xm, Md^Xm, Xu, Ur, Xu, Zgwl, Ur, Ur^Zewe, Xu, Ur, Xu, Md^Xm, Md^Xm, Md, Uh, Zwsl, Zwsl^Zews, Zvw, Zvw, Zwsl, Zvw, Zvw, Zwsl, Zwsl, Zwsl^Zewt, Zwsl, Zwsl, Zwsl^Zewt, Zvw, Qlf, Uu, Uu, Md, Md, Md, Md, Md, Md^Xm, Md^Xm, Md^Xm, Md^Xm, Md^Xm, Md^Xm, Md^Xm
Md^Xm, Md^Xm, Md, Mv, Qlf, Uu, Qlf, Zvw, Uu, Uu, Uh, Uh^Zewt, Md, Md, Md, Md, Md, Md^Xm, Md^Xm, Xu, Ur, Xu, Xu, Xu, Xu, Xu, Ur, Xu, Zwsl, Md, Zwsl, Zwsl, Zwsl, Zwsl, Zwsl, Zwsl, Zwsl, Zwsl, Zwsl, Zwsl, Zvw, Zwsl, Zwsl, Zwsl, Zvw, Zvw, Qlf, Uu, Uu, Uh, Uh, Md, Uh, Md, Md, Md^Xm, Md^Xm, Md^Xm, Md^Xm, Md^Xm, Md^Xm
Md^Xm, Md^Xm, Md, Md, Uh, Qlf, Zvw, Zvw, Uu^Zewc, Uu, Uh, Md, Md, Md, Md, Md, Md, Md^Xm, Md^Xm, Xu, Xu, Ur, Ur, Xu, Xu, Xu, Xu, Zwsl, Md^Xm, Zwsl, Md, Uh, Uh, Uu, Uu, Zwsl, Zwsl, Zwsl^Zewt, Zwsl, Zwsl, Zwsl, Zvw, Zwsl, Zwsl, Zvw, Zvw, Qlf, Zvw, Zwsl, Uu, Uh, Uh^Zewt, Uh, Uh, Uh, Md^Xm, Md, Md^Xm, Md^Xm, Md^Xm, Md^Xm
Md^Xm, Md^Xm, Md, Md, Uh, Qlf, Qlf, Zvw, Uu, Uu, Uh, Md, Uh, Uh, Uh, Md, Uh, Md, Md^Xm, Xu, Xu, Xu, Xu, Zwsl, Zwsl, Xu, Xu, Xu, Md^Xm, Md, Md, Uh, Uh, Uh, Uu^Zewt, Uu, Zwsl, Zwsl, Zwsl, Zwsl, Zvw^Zewe, Zvw, Zwsl, Zvw, Zvw, Qlf, Zvw, Zvw, Zwsl, Uu, Uu, Uh, Uu^Zewc, Uh, Uh, Md, Md, Md^Xm, Md^Xm, Md^Xm, Md^Xm
Md^Xm, Md^Xm, Md, Md, Uh, Uh, Qlf^Bs/, Zgwl, Uu, Uu^Zewt, Uu, Uh, Uh, Uh, Uh, Uh, Uh, Md, Md, Md^Xm, Md^Xm, Md^Xm, Md^Xm, Md^Xm, Zwsl, Md^Xm, Md^Xm, Md^Xm, Md^Xm, Md^Xm, Md^Xm, Md, Md, Uh, Uh, Uh, Uu, Zwsl, Zwsl, Zvw, Zwsl, Zvw, Zvw, Zvw, Qlf^Bs\, Qlf, Zvw, Zvw, Zwsl^Zewe, Uu, Zwsl, Uu, Uu, Uu, Uu, Md, Md, Md, Md^Xm, Md^Xm, Md^Xm
Md^Xm, Md^Xm, Md, Md, Md, Uh, Zvw, Qlf, Zvw, Uu, Uu, Uu, Uu, Uu^Zewt, Uu, Uh, Uh^Zewc, Md, Md, Md^Xm, Md^Xm, Md^Xm, Md, Md, Md, Zwsl, Md, Md^Xm, Md, Md^Xm, Md^Xm, Md, Md, Md, Uh, Uh, Uu, Zwsl, Zwsl, Zwsl, Zwsl, Zvw, Zvw, Zwsl, Qlf, Zwsl, Zvw, Zwsl, Zwsl, Zwsl, Zwsl^Zews, Zwsl, Uu, Uu, Uh, Md, Md, Md, Md, Md^Xm, Md^Xm
Md^Xm, Md^Xm, Md, Md, Md, Uh^Zewc, Zvw, Qlf, Qlf, Zvw, Zgwl, Uu, Zvw, Uu, Uu, Uh, Uh, Uh, Md, Md, Md, Md, Uh, Md, Uh, Zwsl, Zwsl, Md, Md, Md, Mv, Md^Xm, Md, Md, Md, Uh, Uh, Zwsl, Zgwl, Zwsl, Zwsl, Zvw, Zvw, Qlf, Zwsl^Zewt, Zwsl, Zvw, Zwsl, Zwsl, Zwsl, Zwsl, Zwsl, Zwsl, Uu^Zewt, Uu, Uh, Uh, Md, Md, Md^Xm, Md^Xm
Md^Xm, Md^Xm, Md, Md, Md, Uu, Uu, Zvw, Qlf, Zvw, Zvw, Zvw, Zvw, Uu, Uu^Zewt, Uu, Uh, Uh, Uh, Md, Uh, Uh, Uh^Zewt, Uh, Zwsl, Zwsl, Zwsl, Uh^Zewc, Uh, Md, Md, Md, Uh, Md, Md, Md, Uh, Uu, Zwsl, Zwsl, Zvw, Zvw, Qlf, Qlf, Zvw, Zvw, Zvw, Zwsl, Zwsl^Zewe, Zwsl^Zewt, Zwsl, Zwsl, Zwsl, Zwsl, Uu, Uh, Uh, Uh, Md, Md, Md^Xm
Md^Xm, Md^Xm, Mv, Md, Md, Md, Uh, Uu, Uu, Qlf, Qlf, Zvw, Zvw, Uu, Zvw, Zvw, Zvw, Uh, Uh, Uh, Uh, Uh, Uh, Uu, Zwsl, Zwsl, Zwsl, Zwsl, Zwsl, Uh^Zewt, Uh, Uh, Uh, Uh, Uh, Uh, Uh, Uu, Zvw, Zvw, Zvw, Qlf, Zvw, Zwsl, Zvw, Zvw, Zvw, Zwsl, Zwsl, Zwsl, Zwsl, Zgwl, Zwsl, Zwsl, Zwsl, Uu, Uu, Uh, Uh, Md, Md
Md^Xm, Md^Xm, Md^Xm, Md, Md, Md, Uh, Uh, Uu, Uu, Zvw^Zewt, Qlf, Qlf, Qlf, Qlf, Zvw, Zvw, Zvw, Zvw, Uu, Zwsl, Uh, Zwsl, Zwsl, Zwsl, Zwsl^Zews, Zwsl, Zwsl, Zwsl, Zwsl, Zwsl, Zwsl, Zwsl, Uh, Zwsl^Zews, Uh^Zewc, Zwsl, Uu, Zvw, Zvw, Qlf, Qlf, Zvw, Zvw, Zvw, Zvw, Zvw, Zvw, Zwsl, Zwsl, Zwsl^Zewt, Zwsl^Zewt, Zwsl, Zwsl, Zwsl, Zwsl, Zwsl, Uu, Uh, Md, Md
Md^Xm, Md^Xm, Md^Xm, Md, Md, Md, Uh, Uh, Uh, Uu, Uu, Zvw, Zvw, Zvw, Zvw, Qlf^Bs/, Qlf, Zvw, Zvw, Zvw, Zvw, Zwsl, Zwsl, Zwsl, Zwsl, Zwsl, Zwsl, Zwsl^Zewe, Zwsl, Zwsl, Zwsl^Zewt, Zwsl, Zwsl, Zwsl, Zwsl, Zwsl, Zvw, Zvw, Zvw, Qlf, Zwsl, Zvw, Zvw, Zvw, Zvw, Zwsl, Zwsl, Zwsl, Zwsl, Zwsl, Zwsl, Zwsl, Zvw, Zwsl, Zwsl, Zwsl^Zewt, Zwsl, Uu, Uu, Uh, Uh
Md^Xm, Md^Xm, Md^Xm, Md, Md, Md, Md, Md, Uh, Uh, Zwsl^Zewe, Uu^Zewt, Zvw, Zvw, Zvw, Zvw, Zvw, Qlf, Qlf, Zvw, Zvw, Zvw, Zgwl, Zwsl, Zvw, Zwsl, Zwsl, Zwsl, Zwsl, Zwsl, Zwsl, Zwsl, Zwsl, Zwsl, Zvw, Zvw, Zvw, Zvw, Qlf^Bs\, Qlf, Zwsl, Zvw, Zvw, Zvw, Zwsl^Zewt, Zwsl, Zwsl, Zgwl, Zvw, Zvw, Zwsl, Zwsl, Zwsl, Zvw, Zvw, Zwsl^Zewt, Zwsl, Zwsl, Uu, Uu, Uh
Md^Xm, Md^Xm, Md^Xm, Md^Xm, Md, Md, Md, Md, Md, Uh, Uh, Zwsl, Zwsl, Zwsl, Zwsl, Zwsl, Zwsl, Zvw^Zewc, Zvw, Qlf, Qlf, Zvw, Zvw, Zvw, Zvw, Zvw, Zvw, Zwsl, Zvw, Zwsl, Zwsl, Zwsl, Zvw, Zvw, Zvw, Zvw, Qlf, Qlf, Zvw, Zvw, Zvw, Zvw, Zwsl, Zvw, Zvw, Zwsl, Zvw, Zvw, Zvw, Zwsl, Zwsl^Zewc, Zvw, Zwsl, Zwsl, Zwsl, Zvw, 1 Zvw, Zwsl, Zwsl, Uu, Uu
Md^Xm, Md^Xm, Md^Xm, Md, Md, Md, Md, Md, Uh, Uh, Uu^Zewt, Zwsl, Zwsl, Zwsl, Zgwl, Zwsl, Zwsl^Zewt, Zvw, Zvw, Zvw, Qlf, Zvw, Zvw, Zvw, Zvw, Zvw, Zvw, Zvw, Zvw, Zvw, Zwsl, Zvw, Zvw, Zvw, Qlf, Qlf, Qlf, Qlf, Qlf, Zvw, Zwsl, Zvw^Zewc, Zvw, Zvw, Zvw, Zvw, Zvw, Zvw, Zvw, Zvw, Zvw, Zvw, Zwsl, Zwsl^Zewe, Zvw, Zvw, Zvw, Zwsl, Zwsl, Zwsl, Zwsl
Md^Xm, Md^Xm, Md^Xm, Md, Md, Md, Uh, Md, Uh, Uh, Uh, Uu, Zvw, Zvw, Zvw, Zwsl, Zvw, Zwsl, Zvw, Zwsl, Zwsl, Qlf, Qlf, Qlf, Qlf^Bs/, Zvw, Qlf, Zvw, Zvw, Zvw, Zvw, Zvw, Zvw, Qlf, Qlf, Qlf, Qlf, Qlf, Qlf, Qlf, Qlf, Zvw, Zwsl, Zvw, Zwsl, Zvw, Zwsl, Zwsl, Zvw, Zvw, Zwsl, Zvw, Zwsl, Zwsl, Zwsl, Zvw, Zwsl, Zwsl, Zwsl, Zwsl, Uh
Md^Xm, Md^Xm, Md^Xm, Md, Md, Md, Uh, Uu, Uu, Uh, Uu^Zewt, Uu, Zwsl, Zwsl, Zwsl, Zvw, Zwsl, Zvw, Zvw, Zvw, Zvw, Zvw, Zvw, Zvw, Zvw, Qlf, Zvw, Qlf, Qlf, Zvw, Zvw, Zwsl, Qlf, Qlf, Qlf, Qlf, Zvw, Qlf, Qlf, Qlf, Qlf, Zvw, Zvw, Zwsl, Zwsl, Zvw, Zwsl, Zvw, Zwsl, Zwsl, Zwsl, Zvw, Zwsl^Zewt, Zwsl, Zwsl, Zwsl, Zwsl^Zewc, Zwsl, Uh, Zwsl, Uh
Md^Xm, Md^Xm, Md^Xm, Md, Md, Uh, Uh, Uu, Uu, Uu, Zwsl, Zwsl, Zwsl, Zwsl, Zwsl^Zews, Zvw, Zvw, Zwsl^Zewe, Zwsl, Zvw, Zvw, Zvw, Zvw, Zvw, Zvw, Zvw, Zvw, Zvw, Zwsl, Qlf, Qlf, Qlf, Zvw, Qlf, Qlf, Qlf, Qlf, Qlf, Qlf, Qlf, Qlf, Zwsl, Zvw, Zwsl, Zwsl, Zvw, Zvw, Zvw, Zwsl, Zgwl, Zwsl, Zvw, Zvw, Zwsl, Zwsl, Zwsl^Zews, Zwsl, Uh, Uh, Uh, Md
Md^Xm, Md^Xm, Md, Md, Md, Uh, Uh, Uu, Uu, Zwsl, Zwsl, Zgwl, Zwsl, Zwsl, Zwsl, Zwsl, Zvw, Zvw, Zvw, Zvw, Zwsl, Zvw, Zvw, Zwsl, Zvw, Zvw, Zwsl, Zvw, Zvw, Zwsl, Zvw, Zvw, Zvw, Qlf, Qlf, Qlf, Qlf, Qlf, Qlf, Qlf, Qlf, Zvw, Zvw, Zvw, Zvw, Zwsl^Zewt, Zvw, Zvw, Zvw, Zwsl, Zwsl, Zvw, Zvw, Zvw, Zwsl, Zwsl, Uh, Uh, Md, Md, Md
Md^Xm, Md, Md, Md, Md, Uh, Uh, Uu, Uu, Uu^Zewc, Zvw, Zvw, Zvw, Zvw, Zvw^Zewt, Zwsl, Zvw, Zwsl, Zwsl^Zewe, Zvw, Zvw, Zwsl, Zwsl, Zvw, Zvw, Zwsl, Zwsl, Zwsl, Zwsl^Zewt, Zvw, Zwsl, Zvw, Zvw, Zwsl, Zvw, Qlf, Qlf, Qlf, Zvw, Zvw, Zwsl^Zewt, Qlf, Qlf^Bs/, Zvw, Zwsl, Zvw, Zvw, Zvw, Zvw, Zwsl, Zwsl, Zvw, Zwsl, Zwsl, Uu, Uu, Uh, Md, Md, Md, Md
Md^Xm, Md^Xm, Md^Xm, Md, Md, Md, Uh, Uh, Uu, Uu, Zwsl, Zwsl, Zwsl, Zwsl, Zwsl, Zvw, Zvw, Zwsl, Zwsl, Zwsl, Zvw, Zwsl, Zwsl, Zwsl, Zwsl, Zwsl, Zgwl, Zwsl, Zwsl, Zwsl, Zwsl, Zvw, Zvw, Zvw, Zvw, Zvw, Zwsl, Zwsl, Zvw, Zvw, Zvw, Zwsl, Zwsl, Qlf, Qlf, Zvw, Zvw^Zewt, Zwsl, Zgwl, Zwsl, Zvw, Zvw, Zwsl^Zewe, Zwsl, Uu^Zewt, Uh, Uh, Md, Md, Md, Md^Xm
Md^Xm, Md^Xm, Md^Xm, Md, Md, Md, Uh, Uh, Uu^Zewc, Uu, Zvw, Zwsl, Zvw, Zvw, Zvw, Zvw, Zwsl, Zwsl, Zvw, Zvw, Zvw, Zvw, Zvw, Zvw, Zvw, Zvw, Zwsl, Zwsl, Zwsl, Zwsl^Zews, Zwsl, Zvw, Zvw, Zwsl, Zvw, Zvw, Zvw, Zvw^Zews, Zvw, Zvw, Zwsl, Zvw, Zvw, Zwsl, Qlf, Zvw, Zvw, Zwsl, Zwsl, Zwsl, Zwsl^Zewt, Zwsl, Zwsl, Zwsl, Uu, Uh, Uh, Md, Md^Xm, Md^Xm, Md^Xm
Md^Xm, Md^Xm, Md^Xm, Md, Md, Md, Md, Uu, Uu, Zvw, Zwsl, Zvw, Zgwl, Zwsl, Zvw^Zewt, Zwsl, Zvw, Zwsl, Zwsl^Zewt, Zwsl, Zwsl, Zwsl, Zwsl, Zvw, Zwsl, Zwsl, Zvw, Zvw, Zvw, Zvw, Zvw, Zvw, Zvw, Zvw, Zvw, Zvw, Zwsl, Zwsl, Zwsl, Zvw, Zvw, Zwsl, Zwsl, Zvw, Qlf, Zvw, Zvw, Zwsl, Uu, Zwsl, Uh, Zwsl, Uh, Uh, Uh, Md, Md, Md, Md^Xm, Md^Xm, Md^Xm
Md^Xm, Md^Xm, Md^Xm, Md^Xm, Md^Xm, Md, Md, Uh, Uu, Uu, Zwsl, Zwsl, Zwsl, Zwsl, Zvw, Zvw, Zwsl, Zwsl, Zwsl, Zwsl, Zwsl, Zwsl, Zwsl, Zwsl^Zewt, Zwsl, Zwsl, Zgwl, Zwsl, Zwsl, Zwsl, Zwsl, Zwsl, Zvw, Zwsl, Zvw, Zwsl, Zwsl, Zvw, Zvw, Zvw, Zwsl, Zvw, Zvw, Qlf, Uu, Uu, Uu^Zewc, Uu, Uh, Uh, Uh, Uh, Uh, Uh, Md, Md, Md, Md, Md^Xm, Md^Xm, Md^Xm
Md^Xm, Md^Xm, Md^Xm, Md^Xm, Md^Xm, Md, Md, Uh, Uu, Uu, Zwsl, Zwsl, Zwsl, Zwsl, Zwsl, Zvw, Zvw, Zwsl, Zwsl, Zwsl, Zwsl, Zvw, Zvw, Zvw, Zvw, Zwsl, Zwsl, Zvw, Zvw, Zwsl, Zwsl, Zwsl, Zwsl, Zwsl, Zvw, Zwsl, Zwsl^Zewc, Zwsl, Zwsl^Zewt, Zgwl, Zwsl, Zwsl, Qlf^Bs\, Qlf, Uu, Uu, Uh, Uh^Zewt, Uh, Uh, Md, Md, Md, Md, Md, Md, Md^Xm, Md^Xm, Md^Xm, Md^Xm, Md^Xm
Md^Xm, Md^Xm, Md^Xm, Md^Xm, Md, Md, Md, Uh, Uu, Uu, Zwsl^Zewt, Zwsl, Zwsl, Zwsl, Zwsl, Zwsl, Zvw, Zvw, Zvw, Zvw, Zwsl, Zwsl, Zwsl, Zwsl, Zwsl, Zwsl, Zwsl, Zwsl, Zwsl, Zwsl, Zwsl, Zwsl^Zewc, Zwsl, Zwsl, Zwsl, Zwsl, Zwsl, Zvw, Zvw, Zwsl, Zwsl, Zvw, Qlf, Zwsl, Uh, Uh, Uh, Uh, Md, Md, Md, Md, Mv, Md^Xm, Md^Xm, Md^Xm, Md^Xm, Md^Xm, Md^Xm, Md^Xm, Md^Xm
Md^Xm, Md^Xm, Md^Xm, Md^Xm, Md^Xm, Md, Md, Uh, Uh, Uu, Uu, Uu, Zwsl, Zwsl, Zwsl, Zvw^Zewc, Zwsl, Zwsl, Zwsl, Zwsl, Zwsl, Zwsl, Zwsl^Zewc, Zwsl, Zwsl, Zvw, Zwsl, Zwsl, Uu, Zwsl, Uu, Zwsl, Zwsl, Zwsl, Uu, Zwsl, Zwsl, Zwsl, Uu, Uu, Uu, Zvw, Qlf, Uh, Uh, Uh, Md, Md, Md, Md, Md, Md^Xm, Md^Xm, Md^Xm, Md^Xm, Md^Xm, Md^Xm, Md^Xm, Md^Xm, Md^Xm, Md^Xm
Md^Xm, Md^Xm, Md^Xm, Md^Xm, Md^Xm, Md, Md, Md, Md, Uh, Uh, Uu, Uu, Zwsl^Zewe, Zwsl, Zwsl, Zwsl, Zwsl, Zwsl, Zwsl^Zews, Zwsl, Zwsl, Zwsl, Zwsl, Zwsl, Zwsl, Zwsl, Uu, Uu, Uu, Uu, Uh, Uh, Uu, Uh, Uu, Uu, Uu, Uu, Uu, Uh, Zvw, Uh, Qlf, Mv, Md, Md, Md^Xm, Md^Xm, Md^Xm, Md^Xm, Md^Xm, Md^Xm, Md^Xm, Md^Xm, Md^Xm, Md^Xm, Md^Xm, Md^Xm, Md^Xm, Xu
Md^Xm, Md^Xm, Md^Xm, Md^Xm, Md^Xm, Md^Xm, Md^Xm, Mv, Md, Md, Md, Uh, Uh, Uu, Zwsl, Zwsl, Zgwl, Zwsl, Zwsl, Zvw, Zvw, Zwsl, Zwsl, Zwsl, Zwsl, Zwsl, Zwsl, Uu, Uh, Uh, Uh, Uh, Uh, Uh, Uh, Uh, Uh, Uh, Uh, Uh, Md, Zvw, Uh, Md, Md, Md, Md^Xm, Md^Xm, Md^Xm, Md^Xm, Md^Xm, Md^Xm, Xu, Xu, Xu, Xu, Xu, Xu, Xu, Xu, Xu
Md^Xm, Md^Xm, Md^Xm, Md^Xm, Md^Xm, Md^Xm, Md^Xm, Md^Xm, Md^Xm, Md, Md^Xm, Md, Md, Uh, Zwsl, Zwsl, Zwsl, Zwsl, Zwsl, Zwsl, Zwsl^Zewt, Zwsl, Zwsl, Zwsl, Uu, Uu, Uh, Uu, Md, Uh, Md, Md, Md, Md, Md, Uh, Md, Md, Md, Md, Md^Xm, Zvw, Zvw, Md^Xm, Md^Xm, Md^Xm, Md^Xm, Md^Xm, Md^Xm, Md^Xm, Xu, Xu, Xu, Uh, Ur, Ur^Zewt, Xu, Ur, Ur, Xu, Xu
Xu, Xu, Xu, Xu, Xu, Xu, Xu, Xu, Xu, Xu, Xu, Md^Xm, Md, Uh, Zwsl^Zewt, Zvw, Zwsl, Zwsl, Zwsl, Zwsl, Zwsl, Zwsl, Uu, Uu, Uh, Uh^Zewt, Uh, Uh, Md, Md, Mv, Md, Md, Md, Md, Md, Md, Md, Md, Md, Md^Xm, Xu, Uu, Xu, Xu, Xu, Xu, Xu, Xu, Xu, Uh, Ur, Ur, Ur, Ur^Zewe, Uu, Ur, Ur, Ur, Uh, Xu
Xu, Xu, Xu, Ql, Zvw, Zvw, Ur, Xu, Xu, Xu, Xu, Md^Xm, Zwsl, Zwsl, Uh, Uh, Uh, Zwsl, Uh, Uu, Uu, Uu, Uh, Uh, Uh, Uh, Md, Md, Md, Md, Md^Xm, Md^Xm, Md^Xm, Md, Md, Md, Md^Xm, Md, Md^Xm, Md^Xm, Md^Xm, Xu, Uu, Xu, Ur, Xu, Ur, Xu, Ur, Ur, Uu, Xu, Uu, Ur, Uu^Uf, Uu, Uu, Xu, Uu, Xu, Xu
Xu, Xu, Ql, Ql, Xu, Uu^Uf, Uu, Xu, Ur, Xu, Uu, Zwsl, Md^Xm, Md, Md^Xm, Md, Md, Md, Md, Uh, Uh, Uh, Md, Uh, Md, Md, Md^Xm, Md^Xm, Md^Xm, Md^Xm, Md^Xm, Md^Xm, Md^Xm, Md^Xm, Md^Xm, Md^Xm, Md^Xm, Md^Xm, Md^Xm, Md^Xm, Md^Xm, Xu, Xu, Uu, Xu, Uu, Uu, Uu, Uu, Uu, Ur, Xu, Uu^Zewc, Uh, Xu, Uu, Ur, Uu^Uf, Xu, Xu, Xu
Xu, Xu, Zvw, Zvw, Xu, Ur, Uu, Uu, Xu, Uu, Xu, Md^Xm, Md^Xm, Md^Xm, Md^Xm, Md, Md, Md, Md, Md, Md, Md, Md, Md, Md^Xm, Md, Md^Xm, Xu, Xu, Xu, Xu, Xu, Xu, Xu, Xu, Xu, Xu, Xu, Xu, Xu, Xu, Xu, Xu, Uh, Xu, Xu, Xu, Xu, Xu, Xu, Xu, Ur^Zews, Xu, Xu, Xu, Xu, Ur, Xu, Xu, Xu, Xu
Xu, Xu, Ur, Uu^Uf, Xu, Ur, Ur, Xu, Ql, Xu, Xu, Md^Xm, Md^Xm, Md^Xm, Md^Xm, Md^Xm, Md^Xm, Md, Md, Md, Md, Md, Md^Xm, Md^Xm, Md^Xm, Md^Xm, Md^Xm, Xu, Cud, Cud, Xu, Xu, Uh, Xu, Uu, Uu^Zewc, Uu, Xu, Uu^Uf, Xu, Xu, Uu^Zewt, Xu, Xu, Xu, Uu^Uf, Uh, Uh, Ur, Uu^Uf, Ur, Uu, Xu, Xu, Ur, Uu, Xu, Uu, Xu, Xu, Xu
Xu, Xu, Ur, Uu, Ur, Uu^Zewt, Uu, Ur^Zewe, Ur, Xu, Xu, Md^Xm, Md^Xm, Md^Xm, Md^Xm, Md^Xm, Md^Xm, Md^Xm, Md^Xm, Md, Md^Xm, Md^Xm, Md^Xm, Md^Xm, Md^Xm, Md^Xm, Md^Xm, Xu, 2 Kud, Cud, Cud, Ur, Ur, Ur, Ur, Ur, Ur, Ur, Ur, Uu, Uu, Uu, Uu, Uu, Ur^Zewe, Uu, Xu, Ur, Uu, Ur, Uu^Zewc, Uu, Ur, Uu, Ur, Uu, Uu^Uf, Uu, Xu, Xu, Xu
Xu, Xu, Ur^Zewc, Xu, Xu, Xu, Xu, Uu, Ur, Ur, Xu, Md^Xm, Md^Xm, Md^Xm, Md^Xm, Md^Xm, Md^Xm, Md^Xm, Md^Xm, Md^Xm, Md^Xm, Md^Xm, Md^Xm, Md^Xm, Md^Xm, Md^Xm, Md^Xm, Xu, Xu, Cud, Xu, Uu, Xu, Ur, Xu, Xu, Xu, Xu, Xu, Uh, Uu, Xu, Uu^Uf, Uu, Xu, Uu, Uu^Uf, Uu, Uu^Uf, Uh, Uh, Uu, Uu, Uh, Xu, Xu, Xu, Uh, Xu, Xu, Xu
Xu, Xu, Xu, Xu, Xu, Xu, Xu, Xu, Xu, Xu, Xu, Md^Xm, Md^Xm, Md^Xm, Md^Xm, Md^Xm, Md^Xm, Md^Xm, Md^Xm, Md^Xm, Md^Xm, Md^Xm, Md^Xm, Md^Xm, Md^Xm, Md^Xm, Md^Xm, Xu, Xu, Xu, Xu, Xu, Xu, Xu, Xu, Xu, Xu, Xu, Xu, Xu, Xu, Xu, Xu, Xu, Xu, Xu, Xu, Xu, Xu, Xu, Xu, Xu, Xu, Xu, Xu, Xu, Xu, Xu, Xu, Xu, Xu
