border_size=1
usage=map

Md^Xm       , Zwsl        , Md^Xm       , Zwsl        , Md^Xm       , Zwsl        , Md^Xm       , Zwsl        , Md^Xm       , Zwsl        , Md^Xm       , Zwsl        , Md^Xm       , Md^Xm       , Md^Xm       , Md^Xm       , Md          , Md          , Uh          , Uh          , Zwsl        , Zwsl        , Zwsl        , Zwsl        , Zwsl        , Zwsl        , Zwsl        , Zwsl        , Zwsl        , Zwsl        , Zvw         , Zwsl        , Zwsl        , Zwsl        , Zwsl        , Qxua        , Qxua        , Qxua        , Qxua        , Qxua        , Qxua        , Qxua        , Qxua        , Qxua        , Qxua        , Qxua        , Qxua        
Md^Xm       , Md^Xm       , Md^Xm       , Md^Xm       , Md^Xm       , Md^Xm       , Md^Xm       , Md^Xm       , Md^Xm       , Md^Xm       , Md^Xm       , Md^Xm       , Md          , Md^Xm       , Md          , Md          , Uh          , Uh          , Zwsl        , Uh          , Zwsl        , Zwsl        , Zwsl        , Zwsl        , Zvw         , Zvw         , Zvw         , Zvw         , Zvw         , Zvw         , Zvw         , Zvw         , Zwsl        , Zwsl        , Zwsl        , Qxua        , Qxua        , Qxua        , Qxua        , Qxua        , Qxua        , Qxua        , Qxua        , Qxua        , Qxua        , Qxua        , Qxua        
Md^Xm       , Md^Xm       , Md^Xm       , Md^Xm       , Md^Xm       , Md^Xm       , Md          , Md          , Md          , Md          , Uh          , Md          , Uh          , Md          , Uh          , Uh          , Zwsl        , Zwsl        , Zvw         , Zwsl        , Zwsl        , Zwsl        , Zwsl        , Zvw         , Zvw         , Zvw         , Zvw         , Zvw         , Zwsl        , Zwsl        , Zwsl        , Zvw         , Zvw         , Zwsl        , Zwsl        , Zwsl        , Qxua        , Qxua        , Qxua        , Qxua        , Qxua        , Qxua        , Qxua        , Qxua        , Qxua        , Qxua        , Qxua        
Md^Xm       , Md^Xm       , Md^Xm       , Md^Xm       , Md^Xm       , Md^Xm       , Md          , Md          , Uh          , Uh          , Uh          , Uh          , Zwsl        , Uh          , Zwsl        , Zwsl        , Zvw         , Zvw         , Zwsl        , Zvw         , Zvw         , Zvw         , Zvw         , Zvw         , Zvw         , Zvw^Vzps    , Zvw         , Zwsl        , Zwsl        , Zwsl        , Zvw         , Zvw         , Zvw^Vzps    , Zwsl        , Zwsl        , Zwsl        , Qxua        , Qxua        , Qxua        , Qxua        , Qxua        , Qxua        , Qxua        , Qxua        , Qxua        , Qxua        , Qxua        
Md^Xm       , Md^Xm       , Md^Xm       , Md^Xm       , Md          , Md          , Uh          , Uh          , Uh          , Uh          , Zwsl        , Zwsl        , Zwsl        , Zwsl        , Zwsl        , Zwsl        , Zwsl        , Zwsl        , Zvw         , Zvw         , Zvw         , Zvw         , Zwsl        , Zvw         , Zwsl        , Zvw         , Zwsl        , Zwsl        , Zwsl        , Zwsl        , Zvw         , Zwsl        , Zvw         , Zwsl        , Zwsl        , Zwsl        , Chr         , Qxua        , Qxua        , Qxua        , Qxua        , Qxua        , Qxua        , Qxua        , Qxua        , Qxua        , Qxua        
Md^Xm       , Md^Xm       , Md^Xm       , Md^Xm       , Md          , Md          , Uh          , Uh          , Uh          , Uh          , Zwsl        , Zwsl        , Zvw         , Zvw         , Zvw         , Zwsl        , Zvw^Vzps    , Zvw         , Zwsl        , Zvw         , Zvw         , Zvw         , Zwsl        , Zwsl        , Zwsl        , Zwsl        , Zwsl        , Zwsl        , Zvw         , Zvw         , Zwsl        , Zwsl        , Zwsl        , Zvw         , Zwsl        , Zwsl        , Chr         , Qxua        , Qxua        , Qxua        , Qxua        , Qxua        , Qxua        , Qxua        , Qxua        , Qxua        , Qxua        
Md^Xm       , Md^Xm       , Md^Xm       , Md          , Md          , Md          , Uh          , Uh          , Zwsl        , Zwsl        , Zwsl        , Zvw         , Zvw         , Zvw         , Zwsl        , Zvw         , Zvw         , Zvw         , Zvw         , Zvw         , Zvw         , Zwsl        , Zwsl        , Zwsl        , Zwsl^Ziff   , Zwsl        , Zwsl        , Zvw         , Zvw         , Zvw         , Zvw         , Zvw         , Zvw         , Zwsl        , Zwsl        , Zwsl        , Chr         , Chr         , Qxua        , Qxua        , Qxua        , Qxua        , Qxua        , Qxua        , Qxua        , Qxua        , Qxua        
Md^Xm       , Md^Xm       , Md^Xm       , Md          , Md          , Md          , Uh          , Zwsl        , Zwsl        , Zwsl        , Zvw^Vzps    , Zvw         , Zwsl        , Zwsl        , Zwsl        , Zwsl        , Zvw         , Zwsl        , Zwsl        , Zvw         , Zwsl        , Zwsl        , Zwsl        , Zwsl        , Zwsl^Ziff   , Zwsl^Ziff   , Zwsl        , Zwsl        , Zwsl        , Zwsl        , Zwsl        , Zvw         , Zwsl        , Zvw         , Zwsl        , Zwsl        , Khr         , Chr         , Chr         , Qxua        , Qxua        , Qxua        , Qxua        , Qxua        , Qxua        , Qxua        , Qxua        
Md^Xm       , Md^Xm       , Md^Xm       , Md          , Md          , Md          , Md          , Zwsl        , Zwsl        , Zwsl        , Zvw         , Zwsl        , Zwsl^Ziff   , Zwsl^Ziff   , Zwsl^Ziff   , Zwsl        , Zwsl        , Zvw         , Zwsl        , Zwsl        , Zvw         , Zwsl        , Zwsl        , Zwsl^Ziff   , Zwsl^Ziff   , Zwsl^Ziff   , Zwsl        , Zwsl        , Zwsl        , Zvw         , Zvw         , Zwsl        , Zvw         , Zvw         , Zwsl        , Zwsl        , Zwsl        , Chr         , Chr         , Qxua        , Qxua        , Qxua        , Qxua        , Qxua        , Qxua        , Qxua        , Qxua        
Md^Xm       , Md^Xm       , Md^Xm       , Md^Xm       , Md^Xm       , Md          , Md          , Md          , Zwsl        , Zwsl        , Zvw         , Zwsl        , Zwsl^Ziff   , Zwsl^Ziff   , Zwsl^Ziff   , Zwsl        , Zvw         , Zvw         , Zvw         , Zvw         , Zvw         , Zvw         , Zvw         , Zwsl        , Zwsl        , Zwsl^Ziff   , Zwsl        , Zwsl        , Zvw         , Zvw         , Zwsl        , Zvw^Vzps    , Zvw         , Zvw         , Zvw         , Zwsl        , Zwsl        , Zwsl        , Zwsl        , Qxua        , Qxua        , Qxua        , Qxua        , Qxua        , Qxua        , Qxua        , Qxua        
Md^Xm       , Md^Xm       , Md^Xm       , Md^Xm       , Md^Xm       , Md^Xm       , Md^Xm       , Md          , Chr         , Zwsl        , Zvw         , Zwsl        , Zwsl        , Zwsl^Ziff   , Zwsl        , Zwsl        , Zvw         , Zwsl        , Zvw^Vzps    , Zwsl        , Zvw         , Zvw         , Zvw         , Zvw         , Zwsl        , Zwsl        , Zwsl        , Zwsl        , Zvw         , Zvw         , Zwsl        , Zwsl        , Zwsl        , Zvw         , Zvw         , Zvw         , Zvw         , Zwsl        , Zwsl        , Zwsl        , Qxua        , Qxua        , Qxua        , Qxua        , Qxua        , Qxua        , Qxua        
Md^Xm       , Md^Xm       , Md^Xm       , Md^Xm       , Md^Xm       , Md^Xm       , 3 Khr       , Chr         , Chr         , Zwsl        , Zwsl        , Zvw         , Zwsl        , Zwsl        , Zwsl        , Zvw         , Zvw         , Zvw         , Zwsl        , Zwsl        , Zwsl        , Zwsl        , Zwsl        , Zvw^Vzps    , Zvw         , Zwsl        , Zvw         , Zvw         , Zvw         , Zwsl        , Zwsl        , Zwsl        , Zwsl        , Zwsl        , Zvw         , Zvw         , Zvw         , Zvw         , Zwsl        , Zwsl        , Zwsl        , Qxua        , Qxua        , Qxua        , Qxua        , Qxua        , Qxua        
Xol         , Xol         , Xol         , Xol         , Xol         , Xol         , Chr         , Chr         , Chr         , Zwsl        , Zwsl        , Zvw^Vzps    , Zvw         , Zwsl        , Zvw^Vzps    , Zvw         , Zwsl        , Zwsl        , Zwsl^Ziff   , Zwsl        , Zwsl^Ziff   , Zwsl        , Zwsl        , Zvw         , Zvw         , Zvw         , Zvw         , Zvw         , Zwsl        , Zwsl        , Zwsl        , Zwsl        , Zwsl^Ziff   , Zwsl        , Zwsl        , Zwsl        , Zvw         , Zvw^Vzps    , Zwsl        , Zwsl        , Zwsl        , Qxua        , Qxua        , Qxua        , Qxua        , Qxua        , Qxua        
Urb         , Urb         , Urb         , Urb         , Urb         , Urb         , Urb         , Chr         , Zwsl        , Zwsl        , Zwsl        , Zwsl        , Zvw         , Zvw         , Zvw         , Zwsl        , Zwsl        , Zwsl^Ziff   , Zwsl^Ziff   , Zwsl^Ziff   , Zwsl        , Zwsl        , Zwsl        , Zwsl        , Zvw         , Zvw         , Zvw         , Zwsl        , Zwsl        , Zwsl^Ziff   , Zwsl^Ziff   , Zwsl^Ziff   , Zwsl^Ziff   , Zwsl^Ziff   , Zwsl        , Zwsl        , Zwsl        , Zvw         , Zwsl        , Zwsl        , Zwsl        , Zwsl        , Qxua        , Qxua        , Qxua        , Qxua        , Qxua        
Urb         , Urb         , Urb         , Urb         , Urb         , Urb         , Urb         , Zwsl        , Zwsl        , Zwsl        , Zwsl        , Zwsl        , Zwsl        , Zvw         , Zwsl^Vzps   , Zwsl        , Zwsl        , Zwsl^Ziff   , Zwsl^Ziff   , Zwsl^Ziff   , Zwsl        , Zwsl        , Zwsl        , Zwsl^Vzps   , Zvw         , Zvw         , Zvw         , Zwsl        , Zwsl        , Zwsl        , Zwsl        , Zwsl^Ziff   , Zwsl^Ziff   , Zwsl^Ziff   , Zwsl^Ziff   , Zwsl        , Zwsl        , Zvw         , Zwsl        , Zwsl        , Chr         , Chr         , Qxua        , Qxua        , Qxua        , Qxua        , Qxua        
Urb         , Urb         , Urb         , Urb         , Urb         , Urb         , 2 Khr       , Chr         , Chr         , Zwsl        , Zwsl        , Zwsl        , Zvw         , Zvw         , Zvw         , Zwsl        , Zwsl        , Zwsl^Ziff   , Zwsl^Ziff   , Zwsl^Ziff   , Zwsl        , Zwsl        , Zvw         , Zvw         , Zvw         , Zvw         , Zvw         , Zvw         , Zvw         , Zwsl        , Zwsl^Vzps   , Zwsl        , Zwsl        , Zwsl^Ziff   , Zwsl        , Zwsl        , Zvw         , Zvw         , Zwsl        , Zwsl        , Chr         , Chr         , Chr         , Qxua        , Qxua        , Qxua        , Qxua        
Xol         , Xol         , Xol         , Xol         , Xol         , Xol         , Chr         , Chr         , Chr         , Zwsl        , Zwsl        , Zvw         , Zvw         , Zwsl        , Zvw         , Zwsl        , Zwsl        , Zwsl        , Zwsl^Ziff   , Zwsl        , Zwsl        , Zwsl        , Zvw         , Zvw         , Qlf         , Qlf         , Qlf         , Zvw         , Zwsl        , Zvw         , Zvw         , Zwsl        , Zvw         , Zwsl        , Zvw         , Zwsl        , Zvw         , Zvw         , Zwsl        , Zwsl        , Chr         , Khr         , Chr         , Qxua        , Qxua        , Qxua        , Qxua        
Md^Xm       , Md^Xm       , Md^Xm       , Md^Xm       , Md^Xm       , Md^Xm       , Md          , Chr         , Chr         , Zwsl        , Zwsl        , Zwsl        , Zwsl        , Zvw         , Zvw         , Zvw         , Zwsl        , Zwsl        , Zwsl        , Zwsl        , Zwsl        , Zwsl        , Zvw         , Qlf         , Qlf         , Qlf         , Zvw         , Zvw         , Zwsl        , Zwsl        , Zwsl        , Zvw         , Zwsl        , Zvw         , Zvw         , Zvw         , Zvw         , Zvw         , Zwsl        , Zwsl        , Zwsl        , Chr         , Chr         , Qxua        , Qxua        , Qxua        , Qxua        
Md^Xm       , Md^Xm       , Md^Xm       , Md^Xm       , Md^Xm       , Md          , Md          , Chr         , Zwsl        , Zwsl        , Zwsl        , Zwsl^Vzps   , Zwsl        , Zvw         , Zwsl^Vzps   , Zvw         , Zvw         , Zvw         , Zwsl        , Zwsl        , Zwsl        , Zvw^Vzps    , Zvw         , Zvw         , Zvw         , Zvw         , Zwsl        , Zwsl        , Zwsl        , Zwsl        , Zwsl^Ziff   , Zwsl        , Zwsl        , Zwsl        , Zwsl        , Zvw         , Zvw^Vzps    , Zvw         , Zwsl        , Zwsl        , Zwsl        , Zwsl        , Zwsl        , Qxua        , Qxua        , Qxua        , Qxua        
Md^Xm       , Md^Xm       , Md^Xm       , Md^Xm       , Md^Xm       , Md          , Md          , Uh          , Zwsl        , Zwsl        , Zwsl        , Zwsl        , Zvw         , Zvw         , Zwsl        , Zvw         , Zvw         , Zwsl        , Zvw         , Zwsl        , Zwsl        , Zvw         , Zvw         , Zvw         , Zwsl        , Zvw         , Zwsl        , Zwsl        , Zwsl^Ziff   , Zwsl^Ziff   , Zwsl^Ziff   , Zwsl^Ziff   , Zwsl^Ziff   , Zwsl        , Zwsl        , Zwsl        , Zvw         , Zvw         , Zvw         , Zwsl        , Zwsl        , Zwsl        , Zwsl        , Qxua        , Qxua        , Qxua        , Qxua        
Md^Xm       , Md^Xm       , Md^Xm       , Md^Xm       , Md^Xm       , Md          , Md          , Uh          , Uh          , Zwsl        , Zwsl        , Zwsl        , Zvw         , Zvw         , Zwsl        , Zwsl        , Zwsl        , Zvw         , Zvw         , Zvw         , Zwsl        , Zwsl        , Zvw^Vzps    , Zvw         , Zvw         , Zwsl        , Zwsl        , Zwsl        , Zwsl^Ziff   , Zwsl^Ziff   , Zwsl^Ziff   , Zwsl^Ziff   , Zwsl        , Zwsl        , Zwsl        , Zwsl        , Zvw         , Zvw         , Zvw         , Zvw         , Zwsl        , Zwsl        , Zwsl        , Qxua        , Qxua        , Qxua        , Qxua        
Md^Xm       , Md^Xm       , Md^Xm       , Md^Xm       , Md^Xm       , Md          , Md          , Md          , Uh          , Zwsl        , Zwsl        , Zvw         , Zvw         , Zvw         , Zwsl        , Zwsl        , Zwsl        , Zwsl        , Zwsl        , Zwsl        , Zwsl        , Zwsl        , Zwsl        , Zwsl        , Zwsl        , Zwsl        , Zwsl        , Zwsl        , Zwsl        , Zwsl^Ziff   , Zwsl        , Zwsl        , Zvw         , Zwsl        , Zvw         , Zwsl        , Zwsl        , Zwsl        , Zvw         , Zvw         , Zvw         , Zwsl        , Zwsl        , Qxua        , Qxua        , Qxua        , Qxua        
Md^Xm       , Md^Xm       , Md^Xm       , Md^Xm       , Md^Xm       , Md          , Md          , Uh          , Uh          , Zwsl        , Zwsl        , Zvw^Vzps    , Zvw         , Zwsl        , Zwsl        , Zwsl        , Zwsl^Ziff   , Zwsl^Ziff   , Zwsl^Ziff   , Zwsl^Ziff   , Zwsl        , Zwsl        , Zvw         , Zwsl        , Zwsl        , Zwsl        , Zwsl        , Zwsl        , Zwsl        , Zwsl        , Zwsl^Vzps   , Zvw         , Zvw         , Zvw         , Zwsl        , Zwsl        , Zwsl^Ziff   , Zwsl        , Zvw         , Zwsl        , Zwsl        , Zvw         , Zwsl        , Qxua        , Qxua        , Qxua        , Qxua        
Md^Xm       , Md^Xm       , Md^Xm       , Md^Xm       , Md          , Md          , Md          , Uh          , Zwsl        , Zwsl        , Zvw         , Zvw         , Zwsl        , Zwsl        , Zwsl        , Zwsl^Ziff   , Zwsl^Ziff   , Zwsl^Ziff   , Zwsl        , Zwsl        , Zwsl        , Zwsl        , Zvw         , Zwsl        , Zwsl        , Zwsl        , Zwsl        , Zwsl        , Zwsl        , Zwsl        , Zvw         , Zvw         , Zwsl        , Zwsl        , Zwsl        , Zwsl        , Zwsl^Ziff   , Zwsl        , Zwsl        , Zvw         , Zvw         , Zvw         , Zwsl        , Zwsl        , Qxua        , Qxua        , Qxua        
Md^Xm       , Md^Xm       , Md^Xm       , Md          , Md          , Md          , Uh          , Uh          , Zwsl        , Zvw         , Zvw         , Zvw         , Zwsl^Ziff   , Zwsl^Ziff   , Zwsl^Ziff   , Zwsl^Ziff   , Zwsl^Ziff   , Zwsl^Ziff   , Zwsl        , Zvw         , Zwsl        , Zwsl        , Zvw         , Zvw         , Zvw         , Zvw         , Zvw         , Zwsl        , Zwsl        , Zwsl        , Zwsl        , Zwsl        , Zwsl        , Zwsl        , Zwsl^Ziff   , Zwsl^Ziff   , Zwsl        , Zwsl        , Zwsl        , Zwsl        , Zvw         , Zvw         , Zvw         , Zwsl        , Qxua        , Qxua        , Qxua        
Md^Xm       , Md^Xm       , Md          , Md          , Md          , Md          , Uh          , Zwsl        , Zwsl        , Zvw         , Zwsl        , Zwsl        , Zwsl        , Zwsl^Ziff   , Zwsl        , Zwsl^Ziff   , Zwsl        , Zwsl        , Zvw         , Zvw^Vzps    , Zwsl        , Zvw         , Zvw         , Qlf         , Qlf         , Qlf         , Zvw         , Zvw         , Zvw         , Zwsl        , Zwsl        , Zwsl        , Zwsl        , Zwsl        , Zwsl^Ziff   , Zwsl^Ziff   , Zwsl^Ziff   , Zwsl        , Zwsl        , Zvw         , Zvw         , Zwsl        , Zwsl        , Zwsl        , Qxua        , Qxua        , Qxua        
Md^Xm       , Md^Xm       , Md          , Md          , Md          , Uh          , Zwsl        , Zwsl        , Zwsl        , Zvw         , Zvw         , Zwsl        , Zvw         , Zwsl        , Zwsl        , Zwsl        , Zwsl        , Zwsl        , Zvw         , Zvw         , Zwsl        , Zvw         , Qlf         , Qlf         , Qlf         , Qlf         , Qlf         , Zvw         , Zvw         , Zvw         , Zwsl        , Zwsl        , Zwsl        , Zwsl^Ziff   , Zwsl^Ziff   , Zwsl^Ziff   , Zwsl        , Zwsl        , Zwsl        , Zwsl        , Zwsl        , Zwsl        , Zwsl        , Zwsl        , Qxua        , Qxua        , Qxua        
Md^Xm       , Md^Xm       , Md^Xm       , Md          , Md          , Uh          , Zwsl        , Zwsl        , Zwsl        , Zvw^Vzps    , Zvw         , Zvw         , Zvw         , Zvw         , Zvw         , Zvw         , Zvw         , Zwsl        , Zwsl        , Zwsl        , Zwsl        , Zvw         , Qlf         , Qlf         , Qlf         , Qlf         , Zvw         , Zvw         , Zwsl        , Zvw         , Zwsl^Vzps   , Zwsl        , Zvw         , Zwsl        , Zwsl        , Zwsl^Ziff   , Zwsl        , Zwsl        , Zwsl        , Zwsl        , Zwsl        , Zwsl^Vzps   , Zwsl        , Zwsl        , Qxua        , Qxua        , Qxua        
Md^Xm       , Md^Xm       , Md^Xm       , Md          , Md          , Uh          , Zwsl        , Zwsl        , Zvw         , Zvw         , Zvw         , Zvw         , Qlf         , Qlf         , Qlf         , Zvw         , Zvw         , Zwsl        , Zvw         , Zvw         , Zwsl        , Zvw         , Zvw         , Zvw         , Zvw         , Zvw         , Zwsl        , Zvw         , Zwsl        , Zwsl        , Zwsl        , Zwsl        , Zwsl        , Zvw         , Zvw         , Zwsl        , Zwsl        , Zvw         , Zvw         , Zwsl        , Zwsl        , Zwsl        , Zwsl        , Zwsl        , Qxua        , Qxua        , Qxua        
Md^Xm       , Md^Xm       , Md^Xm       , Md          , Md          , Uh          , Uh          , Zwsl        , Zvw         , Zvw         , Zvw         , Qlf         , Qlf         , Qlf         , Zvw         , Zvw         , Zvw         , Zvw         , Zvw         , Zvw         , Zwsl        , Zwsl        , Zwsl        , Zwsl        , Zwsl        , Zwsl        , Zwsl        , Zwsl        , Zwsl        , Zvw         , Zwsl        , Zwsl        , Zwsl        , Zwsl        , Zwsl        , Zwsl        , Zwsl        , Zvw         , Zwsl        , Zwsl        , Zwsl        , Zwsl        , Chr         , Zwsl        , Chr         , Qxua        , Qxua        
Md^Xm       , Md^Xm       , Md^Xm       , Md          , Md          , Uh          , Uh          , Zvw         , Zvw         , Zvw         , Qlf         , Qlf         , Qlf         , Qlf         , Zvw         , Zvw         , Zvw         , Zwsl        , Zvw         , Zwsl        , Zwsl        , Zwsl        , Zwsl^Ziff   , Zwsl^Ziff   , Zwsl^Ziff   , Zwsl^Ziff   , Zwsl        , Zwsl        , Zwsl        , Zwsl        , Zvw         , Zvw         , Zvw         , Zwsl        , Zvw         , Zwsl        , Zwsl        , Zvw         , Zwsl        , Zwsl        , Zwsl        , Zwsl        , Khr         , Chr         , Chr         , Qxua        , Qxua        
Md^Xm       , Md^Xm       , Md^Xm       , Md          , Md          , Md          , Uh          , Zvw         , Zvw         , Zwsl        , Zvw         , Qlf         , Zvw         , Zvw         , Zvw         , Zvw         , Zvw         , Zvw         , Zvw         , Zwsl        , Zwsl        , Zwsl^Vzps   , Zwsl        , Zwsl^Ziff   , Zwsl^Ziff   , Zwsl^Ziff   , Zwsl        , Zwsl        , Zwsl        , Zwsl        , Zvw         , Zvw         , Zwsl        , Zwsl        , Zvw         , Zwsl        , Zwsl        , Zwsl        , Zwsl        , Zwsl        , Zwsl        , Chr         , Chr         , Chr         , Qxua        , Qxua        , Qxua        
Md^Xm       , Md^Xm       , Md^Xm       , Md^Xm       , Md          , Uh          , Uh          , Zwsl        , Zvw         , Zvw         , Zvw         , Zvw         , Zvw         , Zvw         , Zvw         , Zvw         , Zwsl        , Zwsl        , Zwsl        , Zvw         , Zvw         , Zwsl        , Zwsl        , Zwsl        , Zwsl        , Zwsl^Ziff   , Zwsl        , Zwsl        , Zwsl        , Zwsl        , Zvw         , Zwsl        , Zvw         , Zwsl        , Zwsl        , Zvw         , Zvw         , Zwsl        , Zwsl        , Zwsl        , Zwsl        , Zwsl        , Chr         , Chr         , Qxua        , Qxua        , Qxua        
Md^Xm       , Md^Xm       , Md^Xm       , Md^Xm       , Md          , Uh          , Uh          , Uh          , Uh          , Zvw         , Zwsl        , Zvw         , Uh          , Uh          , Uh          , Uh          , Zwsl        , Zwsl        , Zwsl        , Zwsl        , Zwsl        , Zwsl        , Zwsl        , Zwsl        , Zwsl        , Zwsl        , Zwsl        , Zwsl        , Zwsl        , Zwsl        , Zwsl        , Zwsl        , Zvw         , Zvw         , Zvw         , Zwsl        , Zvw         , Zwsl        , Zwsl        , Zwsl        , Zwsl        , Zwsl        , Chr         , Qxua        , Qxua        , Qxua        , Qxua        
Md^Xm       , Md^Xm       , Md^Xm       , Md^Xm       , Md          , Md          , Md          , Uh          , Uh          , Uh          , Uh          , Uh          , Md          , Uh          , Md          , Uh          , Zwsl        , Zwsl        , Zvw         , Zwsl        , Zwsl        , Zwsl        , Zvw         , Zwsl        , Zwsl        , Zwsl        , Zvw         , Zwsl        , Zvw         , Zwsl        , Zvw         , Zvw         , Zvw         , Zwsl        , Qlf         , Zvw         , Zvw         , Zwsl        , Zwsl        , Zwsl        , Zwsl        , Zwsl        , Qxua        , Qxua        , Qxua        , Qxua        , Qxua        
Md^Xm       , Md^Xm       , Md^Xm       , Md^Xm       , Md          , Md          , Md          , Md          , Md          , Md          , Md          , Md          , Md^Xm       , Md^Xm       , Md          , Uh          , Zwsl^Vzps   , Zwsl        , Zwsl        , Zwsl        , Zwsl        , Zvw         , Zwsl        , Zwsl        , Zwsl        , Zwsl        , Zvw         , Zvw         , Zwsl        , Zwsl        , Zvw         , Zvw         , Qlf         , Qlf         , Qlf         , Zwsl        , Zvw         , Zvw         , Zwsl        , Zwsl        , Zwsl        , Zwsl        , Qxua        , Qxua        , Qxua        , Qxua        , Qxua        
Md^Xm       , Md^Xm       , Md^Xm       , Md^Xm       , Md^Xm       , Md          , Md          , Md^Xm       , Md^Xm       , Md          , Md^Xm       , Md^Xm       , Md^Xm       , Md^Xm       , Md          , Zwsl        , Zwsl        , Zwsl        , Zwsl        , Zwsl        , Zwsl        , Zvw         , Zwsl        , Zvw         , Zwsl        , Zwsl        , Zvw         , Zvw         , Zwsl        , Zwsl        , Zvw         , Zwsl        , Qlf         , Qlf         , Qlf         , Zwsl        , Zvw         , Zvw         , Zwsl        , Zwsl        , Zwsl        , Zwsl        , Qxua        , Qxua        , Qxua        , Qxua        , Qxua        
Md^Xm       , Md^Xm       , Md^Xm       , Md^Xm       , Md^Xm       , Md^Xm       , Md^Xm       , Md^Xm       , Md^Xm       , Md^Xm       , Md^Xm       , Md^Xm       , Md          , Md          , Zwsl        , Zwsl        , Uh          , Zwsl        , Zwsl        , Zwsl        , Zvw         , Zvw         , Zwsl        , Zwsl        , Zvw         , Zwsl        , Zwsl        , Zwsl        , Zwsl        , Zvw         , Zvw         , Qlf         , Qlf         , Qlf         , Zvw         , Zvw         , Zvw^Vzps    , Zwsl        , Zwsl        , Zwsl        , Zwsl        , Zwsl        , Qxua        , Qxua        , Qxua        , Qxua        , Qxua        
Md^Xm       , Md^Xm       , Md^Xm       , Md^Xm       , Md^Xm       , Md^Xm       , Md          , Md^Xm       , Md          , Md^Xm       , Md          , Md          , Zwsl        , Zwsl        , Uh          , Uh          , Md          , Uh          , Zwsl        , Zwsl        , Zwsl        , Zvw         , Zvw         , Zvw         , Zvw         , Zwsl        , Zwsl^Vzps   , Zwsl        , Zwsl        , Zwsl        , Zvw         , Zvw         , Zwsl        , Zvw         , Zwsl        , Zwsl        , Zwsl        , Zwsl        , Zwsl        , Zwsl        , Qxua        , Qxua        , Qxua        , Qxua        , Qxua        , Qxua        , Qxua        
Md^Xm       , Md^Xm       , Md^Xm       , Md^Xm       , Md          , Md          , Uh          , Uh          , Uh          , Md          , Zwsl        , Zwsl        , Uh          , Uh          , Md          , Md          , Md          , Uh          , Zwsl        , Zwsl        , Zwsl        , Zwsl        , Zwsl        , Zvw         , Zvw         , Zvw         , Zwsl        , Zwsl        , Zwsl        , Zwsl        , Zwsl        , Zwsl        , Zwsl        , Zwsl        , Zwsl        , Zwsl        , Zwsl        , Zwsl        , Zwsl        , Zwsl        , Qxua        , Qxua        , Qxua        , Qxua        , Qxua        , Qxua        , Qxua        
Md^Xm       , Md^Xm       , Md^Xm       , Md          , Md          , Md          , Uh          , Uh          , Zwsl        , Zwsl        , Uh          , Uh          , Md          , Md          , Md^Xm       , Md^Xm       , Md          , Uh          , Uh          , Zwsl        , Zwsl        , Zwsl        , Zwsl        , Zvw         , Zwsl        , Zwsl        , Zwsl        , Zwsl        , Zwsl        , Zwsl        , Zwsl        , Zwsl        , Zwsl        , Zvw         , Zwsl        , Zwsl        , Zwsl        , Zwsl        , Qxua        , Qxua        , Qxua        , Qxua        , Qxua        , Qxua        , Qxua        , Qxua        , Qxua        
Md^Xm       , Md^Xm       , Md^Xm       , Md          , Md          , Uh          , Uh          , Uh          , Uh          , Uh          , Uh          , Uh          , Md^Xm       , Md^Xm       , Md          , Md          , Uh          , Uh          , Uh          , Zwsl        , Zwsl        , Zwsl        , Zwsl        , Zwsl        , Zwsl        , Zwsl        , Zwsl        , Zwsl        , Zwsl        , Zvw         , Zvw         , Zwsl        , Zwsl        , Zwsl        , Zwsl        , Zwsl        , Zwsl        , Zwsl        , Qxua        , Qxua        , Qxua        , Qxua        , Qxua        , Qxua        , Qxua        , Qxua        , Qxua        
Md^Xm       , Md^Xm       , Md^Xm       , Md          , Md          , Md          , Md          , Md          , Md          , Md          , Md^Xm       , Md^Xm       , Md^Xm       , Md^Xm       , Md          , Md          , Md          , Uh          , Uh          , Uh          , Uh          , Zwsl        , Zwsl        , Zwsl        , Zwsl        , Zwsl        , Zwsl        , 1 Zwsl      , Zwsl        , Zwsl        , Zwsl        , Zwsl        , Zwsl        , Zvw         , Zwsl        , Zwsl        , Qxua        , Qxua        , Qxua        , Qxua        , Qxua        , Qxua        , Qxua        , Qxua        , Qxua        , Qxua        , Qxua        
Md^Xm       , Md^Xm       , Md^Xm       , Md^Xm       , Md^Xm       , Md          , Md          , Md          , Md          , Md          , Md^Xm       , Md^Xm       , Md^Xm       , Md          , Md          , Md          , Md          , Md          , Md          , Uh          , Uh          , Zwsl        , Zwsl        , Zwsl        , Zwsl        , Zwsl        , Zwsl        , Zwsl        , Zwsl        , Zwsl        , Zwsl        , Zwsl        , Zwsl        , Zwsl        , Qxua        , Qxua        , Qxua        , Qxua        , Qxua        , Qxua        , Qxua        , Qxua        , Qxua        , Qxua        , Qxua        , Qxua        , Qxua        
Zwsl        , Md^Xm       , Md^Xm       , Md^Xm       , Md^Xm       , Md^Xm       , Md^Xm       , Md^Xm       , Md^Xm       , Md^Xm       , Md^Xm       , Md^Xm       , Md^Xm       , Md^Xm       , Md^Xm       , Md^Xm       , Md^Xm       , Md^Xm       , Md^Xm       , Md          , Md          , Uh          , Uh          , Zwsl        , Zwsl        , Zwsl        , Zwsl        , Zwsl        , Zwsl        , Zwsl        , Zwsl        , Zwsl        , Zwsl        , Zwsl        , Qxua        , Qxua        , Qxua        , Qxua        , Qxua        , Qxua        , Qxua        , Qxua        , Qxua        , Qxua        , Qxua        , Qxua        , Qxua        
