border_size=1
usage=map

Qxua, Qxua, Qxua, Qxua, Qxua, Qxua, Qxua, Qxua, Qxua, Qxua, Qxua, Qxua, Qxua, Qxua, Qxua, Qxua, Qxua, Qxua, Qxua, Qxua, Qxua, Qxua, Qxua, Qxua, Qxua, Qxua, Qxua, Qxua, Qxua, Qxua, Qxua, Qxua, Qxua, Qxua, Qxua, Qxua, Qxua, Qxua, Qxua, Qxua, Qxua, Qxua, Qxua, Qxua, Qxua, Qxua, Qxua, Qxua, Qxua, Qxua, Qxua, Qxua, Qxua, Qxua, Qxua
Qxua, Qxua, Qxua, Qxua, Qxua, Qxua, Qxua, Qxua, Qxua, Qxua, Qxua, Qxua, Qxua, Qxua, Qxua, Qxua, Qxua, Qxua, Zwsl^Zdcm, Qxua, Qxua, Qxua, Qxua, Qxua, Qxua, Qxua, Qxua, Qxua, Qxua, Qxua, Qxua, Qxua, Qxua, Qxua, Qxua, Qxua, Qxua, Qxua, Qxua, Qxua, Qxua, Qxua, Qxua, Qxua, Qxua, Qxua, Qxua, Qxua, Qxua, Qxua, Qxua, Qxua, Qxua, Qxua, Qxua
Qxua, Qxua, Qxua, Qxua, Qxua, Qxua, Qxua, Qxua, Qxua, Qxua, Qxua, Qxua, Qxua, Qxua, Qxua, Qxua, Zwsl, Zwsl, Zwsl^Zdcm, Zwsl^Zdcm, Zwsl^Zdcm, Qxua, Qxua, Qxua, Qxua, Qxua, Qxua, Qxua, Qxua, Qxua, Qxua, Qxua, Qxua, Qxua, Qxua, Qxua, Qxua, Qxua, Qxua, Qxua, Qxua, Qxua, Qxua, Qxua, Qxua, Qxua, Qxua, Qxua, Qxua, Qxua, Qxua, Qxua, Qxua, Qxua, Qxua
Qxua, Qxua, Qxua, Qxua, Qxua, Qxua, Qxua, Qxua, Qxua, Qxua, Qxua, Qxua, Zwsl, Zwsl, Zvw, Zwsl, Zwsl, Zwsl^Vzps, Zwsl, Zvw^Zdcm, Zvw^Zdcm, Zwsl^Zdcm, Zvw, Zwsl, Zwsl, Zwsl, Zwsl, Qxua, Qxua, Qxua, Qxua, Qxua, Qxua, Qxua, Qxua, Qxua, Qxua, Qxua, Qxua, Qxua, Qxua, Qxua, Qxua, Qxua, Qxua, Qxua, Qxua, Qxua, Qxua, Qxua, Qxua, Qxua, Qxua, Qxua, Qxua
Qxua, Qxua, Qxua, Qxua, Qxua, Qxua, Uu, Uu, Zwsl, Zwsl, Zwsl, Zwsl, Zvw, Zvw, Zwsl, Zwsl, Uh, Zwsl, Uu, Zwsl^Zdcm, Zwsl^Zdcm, Zvw^Zdcm, Zwsl, Zwsl, Zwsl, Uu, Uh, Zvw, Zwsl, Zwsl, Zwsl, Qxua, Zwsl, Qxua, Qxua, Qxua, Qxua, Qxua, Qxua, Qxua, Qxua, Qxua, Qxua, Qxua, Qxua, Qxua, Qxua, Qxua, Qxua, Qxua, Qxua, Qxua, Qxua, Qxua, Qxua
Qxua, Qxua, Qxua, Qxua, Qxua, Uu, Uu, Uu, Zvw, Zwsl, Zwsl, Zwsl, Zwsl^Ziff, Zwsl, Zwsl, Uu, Uh, Uh, Uu, Zwsl, Zwsl, Zwsl, Uh, Uu, Uh, Uh, Uh, Uh, Uh, Uh, Uh, Zvw, Uh, Zvw, Zwsl, Qxua, Zwsl^Vzps, Qxua, Qxua, Qxua, Qxua, Qxua, Qxua, Qxua, Qxua, Qxua, Qxua, Qxua, Qxua, Qxua, Qxua, Qxua, Qxua, Qxua, Qxua
Qxua, Qxua, Qxua, Qxua, Uu, Uu, Uu, Uu, Zwsl, Zwsl, Zwsl^Ziff, Zwsl^Ziff, Zwsl^Ziff, Zwsl, Zwsl, Uu, Uu, Uh, Uh, Uu, Zwsl, Zwsl^Vzps, Uh, Uh, Uh, Md, Md, Md, Md, Uh, Md, Uh, Uh, Uu, Uh, Zwsl, Zwsl, Zwsl, Zvw, Zwsl, Zwsl, Qxua, Chr, 2 Khr, Chr, Qxua, Qxua, Qxua, Qxua, Qxua, Qxua, Qxua, Qxua, Qxua, Qxua
Qxua, Qxua, Uh, Uh, Uh, Uu, Uu, Uu, Zwsl^Vzps, Zwsl, Zwsl, Zwsl^Ziff, Zwsl^Ziff, Zwsl, Zwsl, Zvw, Zvw, Uu, Uu, Uh, Uh, Zwsl, Zwsl^Zdcm, Uh, Uu, Uh, Uh, Md, Md, Md, Md, Md, Md, Md, Md, Uh, Md, Uh, Uh, Zvw, Zvw, Zwsl, Zwsl, Chr, Chr, Qxua, Qxua, Qxua, Qxua, Qxua, Qxua, Qxua, Qxua, Qxua, Qxua
Qxua, Md, Md, Uh, Uh, Uh, Uu, Uu, Zwsl, Zwsl, Zwsl, Zwsl^Ziff, Zwsl^Ziff, Zwsl^Ziff, Zwsl, Zwsl, Zvw, Zvw, Zwsl, Uh, Zwsl, Zwsl^Zdcm, Zwsl^Zdcm, Zvw^Zdcm, Zvw, Uu, Uu, Uh, Uh, Uh, Uh, Md, Md, Md^Xm, Md^Xm, Md, Md, Uh, Md, Uh, Uh, Uh, Uh, Zwsl, Zwsl, Qxua, Qxua, Qxua, Qxua, Qxua, Qxua, Qxua, Qxua, Qxua, Qxua
Md^Xm, Md^Xm, Md, Md, Uh, Uh, Uh, Uu, Uu, Zwsl, Zwsl, Zwsl^Ziff, Zwsl^Ziff, Zwsl, Zwsl, Zwsl, Uh, Uu, Uu, Zwsl, Zwsl, Zwsl, Uu, Zvw^Zdcm, Zvw, Zvw, Zwsl, Uu, Uu, Uh, Uh, Md, Md, Md, Md^Xm, Md^Xm, Md^Xm, Md, Md, Md, Md, Md, Md, Uh, Uh, Zwsl, Zwsl^Vzps, Qxua, Qxua, Qxua, Qxua, Qxua, Qxua, Qxua, Qxua
Md^Xm, Md^Xm, Md^Xm, Md, Md, Uh, Uh, Uh, Zwsl, Zwsl, Zwsl, Zwsl^Ziff, Zwsl^Ziff, Zwsl, Zvw, Uu, Uh, Uh, Uh, Uu, Zwsl, Zvw, Zvw, Uu, Uu, Zvw, Zvw, Zwsl, Uu, Uh, Uh, Md, Md, Md, Md^Xm, Md^Xm, Md^Xm, Md^Xm, Md^Xm, Md^Xm, Md^Xm, Md, Md, Md, Uh, Zwsl, Zwsl, Qxua, Qxua, Qxua, Qxua, Qxua, Qxua, Qxua, Qxua
Md^Xm, Md^Xm, Md^Xm, Md, Md, Uh, Uh, Uh, Zwsl, Zwsl, Zwsl, Zwsl^Ziff, Zwsl^Ziff, Zwsl, Zvw, Uu, Uh, Md, Uh, Uu, Uu, Zwsl, Zwsl, Zvw, Zvw, Uu, Zwsl, Zwsl, Zwsl, Uu, Uh, Md, Md, Md, Md^Xm, Md^Xm, Xol, Xol, Xol, Xol, Xol, Md^Xm, Md^Xm, Md, Uh, Zvw, Zvw, Zwsl, Qxua, Qxua, Qxua, Qxua, Qxua, Qxua, Qxua
Md^Xm, Md^Xm, Md^Xm, Md^Xm, Md, Md, Uh, Uh, Uh, Zvw, Zwsl, Zwsl^Ziff, Zwsl^Ziff, Zwsl, Zwsl, Uu, Uh, Md, Md, Uh, Uh, Zwsl, Uu, Zwsl, Zwsl, Zwsl, Zwsl, Zwsl, Uu, Uu, Uh, Uh, Md, Md, Md^Xm, Md^Xm, Xol, Urb, Urb, Urb, Xol, Md^Xm, Md^Xm, Md, Md, Uh, Zvw, Zvw, Qxua, Qxua, Qxua, Qxua, Qxua, Qxua, Qxua
Md^Xm, Md^Xm, Md^Xm, Md, Md, Uh, Uh, Uh, Uu, Zwsl, Zwsl, Zwsl^Ziff, Zwsl^Ziff, Zwsl, Zwsl, Uu, Uu, Uh, Md, Uh, Uh, Uu, Uu, Zwsl, Zwsl, Zwsl, Zwsl, Uu, Uh, Uh, Md, Md, Md, Md^Xm, Md^Xm, Md^Xm, Xol, Urb, Xol, Urb, Xol, Md^Xm, Md^Xm, Md, Md, Uh, Uh, Zvw, Zvw^Zdcm, Qxua, Qxua, Qxua, Qxua, Qxua, Qxua
Md^Xm, Md^Xm, Md, Md, Md, Uh, Uh, Uu, Zwsl, Zwsl, Zvw, Zwsl, Zwsl, Zwsl, Zwsl, Zwsl^Vzps, Uu, Uh, Uh, Md, Md, Uh, Uu, Uu, Zwsl, Zwsl, Zwsl, Uu, Uh, Uh, Md, Md, Md, Md^Xm, Md^Xm, Md^Xm, Xol, Urb, Xol, Urb, Xol, Md^Xm, Md^Xm, Md, Md, Uh, Uh, Zvw, Zvw, Qxua, Qxua, Qxua, Qxua, Qxua, Qxua
Md^Xm, Md^Xm, Md, Md, Md, Uh, Uh, Uu, Uu, Zwsl^Zdcm, Zvw^Zdcm, Zwsl^Zdcm, Zwsl^Zdcm, Zwsl, Zwsl, Zwsl, Zwsl, Uu, Uh, Md, Uh, Uh, Uu, Uu, Zwsl, Zvw, Zwsl, Uu, Uu, Uh, Uh, Md, Md, Md^Xm, Md^Xm, Md^Xm, Xol, Urb, Xol, Urb, Xol, Md^Xm, Md^Xm, Md, Md, Md, Uh, Zwsl^Zdcm, Zwsl, Zwsl^Zdcm, Qxua, Qxua, Qxua, Qxua, Qxua
Md^Xm, Md^Xm, Md, Md, Md, Uh, Uh, Uh, Uu, Zwsl^Zdcm, Zvw^Zdcm, Zvw^Zdcm, Zvw^Zdcm, Zwsl, Uu, Zwsl, Zvw, Uu, Uu, Uh, Uh, Uh, Uu, Uu^Vzps, Zwsl, Zvw, Zwsl, Zwsl, Uu, Uh, Uh, Md, Md, Md, Md^Xm, Md^Xm, Xu, Ur, Xu, Xol, Xu, Md^Xm, Md^Xm, Md^Xm, Md, Md, Uh, Uh, Zvw, Zwsl, Qxua, Qxua, Qxua, Qxua, Qxua
Md^Xm, Md^Xm, Md^Xm, Md, Md, Md, Md, Uh, Uh, Uu, Zwsl, Zvw^Zdcm, Zwsl, Zwsl, Uu, Uu, Uu, Zvw, Zvw, Uu, Uh, Uh, Uu, Uu, Zwsl^Zdcm, Zvw, Zvw, Zwsl, Zwsl, Uu, Uh, Uh, Md, Md, Md, Md^Xm, Xu, Uu, Xu, Xu, Md^Xm, Md^Xm, Md^Xm, Md^Xm, Md, Md, Uh^Vzps, Uh, Zvw, Zvw, Zwsl, Qxua, Qxua, Qxua, Qxua
Md^Xm, Md^Xm, Md^Xm, Md, Md, Md, Md, Uh, Uh, Uh, Zwsl, Zvw, Zwsl, Uh, Uh, Uu, Uh, Uu, Uu, Zwsl, Zwsl, Zwsl^Zdcm, Zwsl^Zdcm, Zwsl^Zdcm, Zwsl^Zdcm, Zwsl^Zdcm, Zwsl, Zwsl, Zwsl, Uu, Uu, Uh, Uh, Md, Md, Md^Xm, Md^Xm, Zwsl, Md^Xm, Md^Xm, Md^Xm, Md^Xm, Md^Xm, Md^Xm, Md^Xm, Md, Uh, Uh, Zvw, Zvw, Zwsl, Zwsl, Qxua, Qxua, Qxua
Md^Xm, Md^Xm, Md^Xm, Md, Md^Xm, Md, Md, Md, Uh, Uh, Zwsl, Zvw, Zvw, Uu, Uh, Md, Md, Uu, Uu, Zwsl, Uu, Zwsl^Zdcm, Uh, Uu, Uu, Zwsl^Zdcm, Uu, Uu, Zwsl, Uu, Uu, Uh, Uh, Uh, Uh, Md, Zwsl, Zwsl, Md, Md^Xm, Md^Xm, Md^Xm, Md^Xm, Md^Xm, Md^Xm, Md, Md, Uh, Uh, Zwsl, Qxua, Qxua, Qxua, Qxua, Qxua
Md^Xm, Md^Xm, Md^Xm, Md^Xm, Md^Xm, Md, Md, Md, Uh, Uh, Zwsl, Zwsl, Zvw, Uu, Uh, Md, Md, Uh, Uh, Uu, Uu, Zwsl, Uh, Uh, Uh, Uu, Uh, Uu, Uu, Zwsl^Vzps, Uu, Uu, Uu, Uh, Zwsl, Zwsl, Zvw, Zwsl, Md, Md, Md, Md^Xm, Md^Xm, Md^Xm, Md, Md, Md, Uh, Uh, Zwsl, Zwsl, Qxua, Qxua, Qxua, Qxua
Md^Xm, Md^Xm, Md^Xm, Md^Xm, Md, Md, Md, Md, Uh, Uh^Vzps, Uu, Zwsl, Zwsl, Uu, Uu, Uh, Md, Md, Md, Uh, Uu, Uu, Uu, Uh, Uh, Uh, Uh, Uh, Uh, Uu, Uu, Uu, Zwsl, Zwsl, Ch, Ch, Ch, Zwsl, Uh, Md, Md, Md, Md, Md, Md, Md, Md, Uh, Uh, Zwsl, Zwsl, Zwsl, Qxua, Qxua, Qxua
Md^Xm, Md^Xm, Md^Xm, Md^Xm, Md, Md, Md, Uh, Uh, Uh, Uu, Zwsl, Zvw, Uu, Uu, Uh, Md, Md, Md, Uh, Uu, Zwsl, Uu, Uh, Uh, Uh, Md, Uh, Uh, Uu, Uu, Uu, Zwsl, Zwsl, Ch, 7 Kh, Ch, Zwsl, Zwsl, Uh, Md, Md, Md, Md, Md, Md, Md, Uh, Zvw, Zwsl, Zwsl, Zwsl, Qxua, Qxua, Qxua
Md^Xm, Md^Xm, Md^Xm, Md^Xm, Md, Md, Md, Uh, Uh, Uh, Uu, Uu, Zvw, Uu, Uu, Uh, Md, Md, Uh, Uh, Uu, Zwsl, Zvw, Uh, Uh, Md, Md, Md, Md, Uh, Uh, Uu, Uu, Zwsl, Zwsl, Ch, Zwsl, Zwsl, Zwsl, Uh, Uh, Uh, Uh, Uh, Uh, Md, Md, Uh, Zvw, Zvw, Zwsl^Vzps, Zwsl, Zwsl, Qxua, Qxua
Md^Xm, Md^Xm, Md^Xm, Md^Xm, Md^Xm, Md, Md, Uh, Uh, Uh, Uu, Zwsl, Zvw, Zwsl, Uu, Uh, Uh, Md, Uh, Uu, Zwsl, Zwsl, Zvw, Zwsl, Zwsl, Md, Md, Md, Md, Md, Uh, Uh, Uu, Uu, Zwsl, Zvw, Zwsl, Zwsl^Vzps, Zwsl, Zwsl, Zvw, Zwsl^Zdcm, Zwsl^Zdcm, Uh, Uh, Md, Uh, Uh, Zvw, Zvw, Zwsl, Zwsl, Zwsl, Qxua, Qxua
Md^Xm, Md^Xm, Md^Xm, Md^Xm, Md^Xm, Md^Xm, Md, Md, Uh, Uh, Zwsl, Zvw, Zvw, Zwsl, Uu, Uh, Uh, Uh, Uu, Zwsl, Zvw, Zwsl, Zwsl, Zvw, Zwsl, Uh, Uh, Md, Md, Md, Md, Uh, Uh, Uu, Zwsl, Zwsl, Zwsl, Uu, Uu, Zwsl, Zwsl, Zvw^Zdcm, Zvw^Zdcm, Zwsl^Zdcm, Zwsl, Uh, Uh, Uh, Zvw, Zvw, Zwsl, Zwsl, Qxua, Qxua, Qxua
Md^Xm, Md^Xm, Md^Xm, Md^Xm, Md^Xm, Md, Md, Md, Uh, Uh, Zwsl, Zvw, Zvw, Zwsl, Uh, Uh, Uh, Uh, Uu, Zvw, Uu, Zwsl, Zwsl, Zvw, Zvw, Uu, Uu, Uh, Uh, Md, Md, Md, Uh, Uu, Uu, Zvw, Zvw, Uu, Uu, Uu, Uu, Zvw, Zvw, Zwsl, Zwsl, Zwsl, Uh, Uh, Zvw, Zwsl, Zwsl, Qxua, Qxua, Qxua, Qxua
Md^Xm, Md^Xm, Md^Xm, Md^Xm, Md, Md, Md, Md, Uh, Uh, Uu, Zvw, Zvw, Uu^Vzps, Uh, Md, Uh, Uu, Zwsl, Zvw, Uu, Zwsl, Zwsl, Zwsl, Zwsl, Zwsl, Zwsl, Uu, Uu, Uh, Uh, Md, Md, Uh, Uu, Uu, Zwsl, Zwsl, Uu, Uh, Uu, Uu, Zwsl, Zwsl, Uu, Zwsl, Zwsl, Zwsl, Zwsl, Zvw, Zwsl, Qxua, Qxua, Qxua, Qxua
Md^Xm, Md^Xm, Md^Xm, Md^Xm, Md, Md, Uh, Uh, Uh, Uu, Zwsl, Zwsl, Zvw, Uu, Uu, Md, Uh, Uu, Zwsl, Zvw, Uu, Uu, Uu, Zwsl, Uu, Zwsl^Vzps, Zwsl, Zwsl, Zvw, Uu, Uh, Uh, Md, Uh, Uu, Uu, Zwsl, Zvw, Zwsl, Uh, Uh, Uu, Zwsl, Zwsl, Uu, Zwsl, Zwsl^Vzps, Zwsl, Zwsl, Zwsl, Qxua, Qxua, Qxua, Qxua, Qxua
Md^Xm, Md^Xm, Md^Xm, Md, Md, Md, Md, Uh, Uh, Uu, Zwsl^Zdcm, Zwsl, Zvw^Zdcm, Uu, Uu, Uh, Uh, Uu, Zvw, Zvw, Uu, Uh, Uh, Uu, Uh, Uu, Uu, Zvw, Zvw, Zwsl, Zwsl, Uh, Uh, Uh, Uu, Zwsl, Zvw, Zvw, Zwsl, Uu, Uh, Uu, Zwsl, Zwsl, Zwsl, Zwsl, Zwsl, Zwsl, Zwsl, Zwsl, Qxua, Qxua, Qxua, Qxua, Qxua
Md^Xm, Md^Xm, Md^Xm, Md^Xm, Md, Md, Uh, Uh, Uh, Uu, Uu^Zdcm, Zwsl^Zdcm, Zwsl^Zdcm, Zvw^Zdcm, Zwsl, Uu, Zwsl, Uh, Zwsl, Zwsl, Zwsl, Uu, Uu, Uh, Md, Uh, Uh, Uu, Uu, Zvw, Zvw, Zwsl, Uh, Uh, Uu, Uu, Zwsl, Zvw, Zwsl, Uu, Uu, Zwsl, Zvw, Zvw, Zwsl, Zwsl, Qxua, Qxua, Qxua, Qxua, Qxua, Qxua, Qxua, Qxua, Qxua
Md^Xm, Md^Xm, Md^Xm, Md^Xm, Md^Xm, Md, Md, Uh, Uh, Uh, Uu, Uu^Zdcm, Zwsl^Zdcm, Zwsl^Zdcm, Zvw, Uu, Zwsl, Zwsl, Zwsl, Zwsl, Zwsl, Uu, Uu, Uh, Md, Uh, Uh, Uh, Uh, Uu, Zwsl^Zdcm, Zwsl, Uh, Uh, Uu, Uu, Zwsl, Zwsl, Zwsl, Uu, Uu, Zwsl, Zwsl, Zvw, Zwsl, Qxua, Qxua, Qxua, Qxua, Qxua, Qxua, Qxua, Qxua, Qxua, Qxua
Md^Xm, Md^Xm, Md^Xm, Md^Xm, Md^Xm, Md, Md, Md, Uh, Uu, Zwsl, Zwsl, Uu, Zwsl, Zwsl, Zvw, Zwsl, Zwsl, Zwsl, Zwsl, Zwsl, Zwsl, Zwsl, Uu, Uh, Md, Md, Uh, Uh, Uu, Zwsl^Zdcm, Zwsl^Zdcm, Uh, Uh, Uu, Zwsl, Zwsl, Zwsl^Vzps, Zwsl, Zwsl, Zwsl, Zwsl, Qxua, Zwsl, Qxua, Qxua, Qxua, Qxua, Qxua, Qxua, Qxua, Qxua, Qxua, Qxua, Qxua
Md^Xm, Md^Xm, Md^Xm, Md^Xm, Md^Xm, Md^Xm, Md^Xm, Md, Zvw, Zwsl, Md, Uu, Uh, Uu, Zwsl, Zwsl, Zwsl, Zwsl, Zwsl, Zwsl, Zvw, Zwsl, Zwsl, Uu, Uu, Uh, Uh, Uh, Uu, Uu^Zdcm, Zwsl^Zdcm, Zwsl^Zdcm, Zwsl, Uu, Zwsl, Zwsl, Zwsl, Zwsl, Zwsl, Zwsl, Qxua, Qxua, Qxua, Qxua, Qxua, Qxua, Qxua, Qxua, Qxua, Qxua, Qxua, Qxua, Qxua, Qxua, Qxua
Xu, Xu, Xu, Xu, Xu, Xu, Md^Xm, Md, Zwsl, Zwsl, Md, Md, Uh, Uh, Uu, Zwsl, Zwsl, Zwsl^Vzps, Zwsl, Zwsl, Zvw, Zwsl, Zwsl, Uu, Uu, Uu, Uh, Uh, Uu, Uu^Zdcm, Zwsl^Zdcm, Zvw^Zdcm, Zwsl, Zwsl, Zwsl, Zwsl, Zvw, Zvw, Qxua, Zwsl, Qxua, Qxua, Qxua, Qxua, Qxua, Qxua, Qxua, Qxua, Qxua, Qxua, Qxua, Qxua, Qxua, Qxua, Qxua
Xu, Xu, Uu, Xu, Ur, Xu, Uu, Uu, Md, Md, Md, Uh, Uh, Uh, Uu, Uu, Zwsl, Zwsl, Zwsl, Zwsl, Zvw, Zvw, Zwsl, Zwsl, Uu, Uu, Uh, Uh, Uu, Zwsl, Zvw, Zvw, Zwsl^Vzps, Zwsl, Zwsl, Zwsl, Zwsl, Qxua, Qxua, Qxua, Qxua, Qxua, Qxua, Qxua, Qxua, Qxua, Qxua, Qxua, Qxua, Qxua, Qxua, Qxua, Qxua, Qxua, Qxua
Xu, Xu, Uu^Vzps, Ur, Xu, Ur, Md^Xm, Md, Md, Md, Md, Md, Uh, Uh, Uh, Uu, Uu, Zwsl, Zwsl, Zwsl, Zwsl, Zvw, Zwsl, Zwsl, Zwsl, Uu, Uu, Uu, Zwsl, Zwsl, Zvw, Zwsl, Zwsl, Zwsl, Zwsl, Zwsl, Zwsl, Qxua, Qxua, Qxua, Qxua, Qxua, Qxua, Qxua, Qxua, Qxua, Qxua, Qxua, Qxua, Qxua, Qxua, Qxua, Qxua, Qxua, Qxua
Xu, Xu, Ur, Ur, Xu, Xu, Md^Xm, Md, Md, Md, Md, Md, Uh, Uh, Uh, Uh, Uu, Uu, Zwsl, Zwsl, Zwsl, Zwsl, 1 Zwsl, Zwsl, Zwsl, Uu, Uu, Uu, Zwsl, Zwsl, Zwsl, Zwsl, Zwsl, Zwsl, Zwsl, Zwsl, Qxua, Qxua, Qxua, Qxua, Qxua, Qxua, Qxua, Qxua, Qxua, Qxua, Qxua, Qxua, Uu^Ii, Qxua, Qxua, Qxua, Qxua, Qxua, Qxua
Xu, Xu, Uu, Xu, Ur, Xu, Md^Xm, Md^Xm, Md, Md, Md, Md, Md, Uh, Uh, Uh, Uh, Uu, Zwsl, Zwsl, Zwsl, Zwsl, Zwsl, Zwsl, Zwsl, Zwsl, Zwsl, Zwsl, Zwsl, Zwsl, Qxua, Qxua, Qxua, Qxua, Qxua, Zwsl, Qxua, Qxua, Qxua, Qxua, Qxua, Qxua, Qxua, Qxua, Qxua, Qxua, Qxua, Qxua, Qxua, Qxua, Qxua, Qxua, Qxua, Qxua, Qxua
Xu, Xu, Uu^Uf, Uu, Uu, Xu, Md^Xm, Md^Xm, Md^Xm, Md, Md, Md, Md, Md, Md, Uh, Uh, Uh, Zwsl, Zwsl, Zwsl, Zwsl, Zwsl, Zwsl, Zwsl, Zwsl, Zwsl, Zwsl, Zwsl, Qxua, Qxua, Qxua, Qxua, Qxua, Qxua, Qxua, Qxua, Qxua, Qxua, Qxua, Qxua, Qxua, Qxua, Qxua, Qxua, Qxua, Qxua, Qxua, Qxua, Qxua, Qxua, Qxua, Qxua, Qxua, Qxua
Xu, Xu, Xu, Xu, Xu, Xu, Md^Xm, Md^Xm, Md^Xm, Md^Xm, Md^Xm, Md^Xm, Md, Md, Md, Md, Md, Uh, Uh, Zwsl, Zwsl, Zwsl, Zwsl, Zwsl, Zwsl, Zwsl, Zwsl, Zwsl, Zwsl, Qxua, Qxua, Qxua, Qxua, Qxua, Qxua, Qxua, Qxua, Qxua, Qxua, Qxua, Qxua, Qxua, Qxua, Qxua, Qxua, Qxua, Qxua, Qxua, Qxua, Qxua, Qxua, Qxua, Qxua, Qxua, Qxua
