border_size=1
usage=map

Xu          , Xu          , Xu          , Xu          , Xu          , Xu          , Xu          , Xu          , Xu          , Xu          , Xu          , Xu          , Xu          , Xu          , Xu          , Xos         , Xos         , Xos         , Xos         , Xos         , Xos         , Xos         , Xos         , Xos         , Xos         , Xos         , Xos         , Xos         , Xos         , Xos         , Xos         , Xos         , Xos         , Xos         , Urb         , Urb         , Urb         , Urb         , Urb         , Xos         , Xos         , Xos         , Xos         , Xos         , Xos         , Xos         , Xos         , Xos         , Xos         , Xos         , Xos         , Xos         , Xos         , Xos         , Xos         , Xos         , Xos         
Xu          , Xu          , Xu          , Xu          , Xu          , Xu          , Xu          , Xu          , Xu          , Xu          , Xu          , Xu          , Xu          , Xu          , Xos         , Xos         , Xos         , Xos         , Xos         , Xos         , Xos         , Xos         , Urb         , Xos         , Xos         , Xos         , Xos         , Xos         , Xos         , Xos         , Xos         , Xos         , Xos         , Xos         , Urb         , Urb         , 1 Urb       , Urb         , Urb         , Xos         , Xos         , Xos         , Urb         , Xos         , Urb         , Xos         , Urb         , Urb         , Urb         , Xos         , Xos         , Xos         , Xos         , Xos         , Xos         , Xos         , Xos         
Xu          , Xu          , Xu          , Xu          , Xu          , Xu          , Xu          , Xu          , Xu          , Xu          , Xu          , Xu          , Xu          , Xu          , Xos         , Xos         , Urb         , Xos         , Xos         , Xos         , Urb         , Urb         , Urb         , Urb         , Uu^Vu       , Urb         , Urb         , Urb         , Urb         , Urb         , Xos         , Xos         , Xos         , Urb         , Urb         , Urb         , Urb         , Urb         , Urb         , Xos         , Urb         , Urb         , Urb         , Urb         , Urb         , Urb         , Urb         , Urb         , Urb         , Urb         , Urb         , Xos         , Urb         , Xos         , Xos         , Xos         , Xos         
Uh          , Xu          , Xu          , Xu          , Uh          , Xu          , Uh^Dr       , Xu          , Uu^Dr       , Xu          , Uu^Uf       , Uh          , Uu^Vu       , Xu          , Urb         , Urb         , Urb         , Urb         , Urb         , Urb         , Urb         , Urb         , Urb         , Urb         , Urb         , Urb         , Urb         , Urb         , Urb         , Urb         , Urb         , Urb         , Urb         , Urb         , Urb         , Urb         , Urb         , Urb         , Urb         , Urb         , Urb         , Urb         , Urb         , Uu^Vu       , Urb         , Urb         , Urb         , Urb         , Urb         , Urb         , Urb         , Urb         , Urb         , Xos         , Xos         , Xos         , Xos         
Uu          , Uh          , Uh^Dr       , Uh          , Uu          , Uu          , Ur          , Uu          , Uu          , Uh          , Uu          , Ur          , Urb         , Urb         , Urb         , Urb         , Urb         , Urb         , Urb         , Xos         , Xos         , Urb         , Urb         , Urb         , Urb         , Xos         , Xos         , Xos         , Urb         , Urb         , Urb         , Urb         , Xos         , Urb         , Xos         , Urb         , Urb         , Urb         , Urb         , Urb         , Xos         , Xos         , Xos         , Xos         , Xos         , Urb         , Urb         , Urb         , Xos         , Urb         , Uu^Vu       , Urb         , Urb         , Xos         , Xos         , Xos         , Xos         
Uu          , Uu          , Ur          , Uu          , Uh          , Uu          , Uh^Dr       , Uu          , Uh          , Ur          , Uh          , Uu          , Xu          , Urb         , Urb         , Urb         , Urb         , Xos         , Xos         , Xos         , Xos         , Xos         , Urb         , Urb         , Urb         , Urb         , Xos         , Xos         , Xos         , Xos         , Urb         , Urb         , Urb         , Xos         , Xos         , Urb         , Urb         , Urb         , Urb         , Urb         , Urb         , Xos         , Xos         , Xos         , Xos         , Urb         , Urb         , Xos         , Xos         , Xos         , Urb         , Urb         , Urb         , Xos         , Xos         , Xos         , Xos         
Xu          , Xu          , Xu          , Uh          , Uh          , Uh          , Uh          , Uh          , Uh          , Uh          , Xu          , Xu          , Xos         , Xos         , Urb         , Urb         , Urb         , Xos         , Xos         , Xos         , Xos         , Urb         , Urb         , Urb         , Uu^Vu       , Urb         , Urb         , Xos         , Urb         , Urb         , Urb         , Urb         , Urb         , Xos         , Urb         , Urb         , Urb         , Urb         , Urb         , Urb         , Xos         , Xos         , Xos         , Xos         , Xos         , Urb         , Urb         , Xos         , Xos         , Xos         , Urb         , Urb         , Urb         , Urb         , Xos         , Xos         , Xos         
Xu          , Xu          , Uh          , Uh          , Uh          , Uh          , Uu^Uf       , Uh^Dr       , Uh^Dr       , Uh          , Uu          , Xos         , Uu          , Xos         , Urb         , Urb         , Urb         , Urb         , Urb         , Xos         , Xos         , Urb         , Urb         , Urb         , Urb         , Urb         , Urb         , Urb         , Urb         , Urb         , Urb         , Uu^Vu       , Urb         , Urb         , Urb         , Urb         , Urb         , Urb         , Urb         , Xos         , Xos         , Xos         , Urb         , Urb         , Urb         , Urb         , Urb         , Xos         , Urb         , Xos         , Urb         , Urb         , Urb         , Urb         , Xos         , Xos         , Xos         
Xu          , Xu          , Uh^Emf      , Uh^Dr       , Uh          , Uh^Emf      , Uu^Uf       , Uu          , Uu          , Uu^Uf       , Uu          , Uu          , Uu          , Uu          , Uu^Uf       , Urb         , Urb         , Urb         , Urb         , Urb         , Urb         , Urb         , Urb         , Urb         , Urb         , Urb         , Urb         , Urb         , Xos         , Urb         , Urb         , Urb         , Urb         , Urb         , Urb         , Urb         , Urb         , Urb         , Urb         , Urb         , Urb         , Urb         , Urb         , Urb         , Urb         , Urb         , Urb         , Xos         , Urb         , Urb         , Urb         , Urb         , Urb         , Urb         , Xos         , Xos         , Xos         
Xu          , Xu          , Uh^Dr       , Uh^Emf      , Uu^Uf       , Uu^Uf       , Uu          , Uu^Emf      , Uh^Emf      , Uu^Emf      , Uu^Emf      , Uh          , Uu^Uf       , Uh          , Uu          , Uu          , Uu          , Uu^Vu       , Urb         , Urb         , Urb         , Urb         , Urb         , Xos         , Xos         , Urb         , Xos         , Xos         , Xos         , Xos         , Urb         , Urb         , Urb         , Urb         , Urb         , Urb         , Urb         , Urb         , Urb         , Urb         , Urb         , Urb         , Urb         , Urb         , Urb         , Urb         , Urb         , Urb         , Urb         , Urb         , Urb         , Urb         , Urb         , Urb         , Xos         , Xos         , Xos         
Xu          , Xu          , Xu          , Uh          , Uh          , Uu^Uf       , Uu^Uf       , Uu^Uf       , Uu^Uf       , Uh          , Uh          , Uu^Uf       , Uu^Uf       , Uu          , Uu^Emf      , Uu^Uf       , Uu          , Urb         , Urb         , Urb         , Urb         , Urb         , Urb         , Urb         , Urb         , Xos         , Xos         , Xos         , Xos         , Urb         , Urb         , Urb         , Xos         , Xos         , Xos         , Urb         , Urb         , Urb         , Urb         , Uu^Vu       , Urb         , Urb         , Urb         , Urb         , Urb         , Urb         , Urb         , Urb         , Urb         , Urb         , Xos         , Urb         , Urb         , Urb         , Xos         , Xos         , Xos         
Xu          , Xu          , Xu          , Uh          , Uh          , Uu          , Uh          , Uu          , Uu^Uf       , Uu^Uf       , Uh          , Uu^Vu       , Uu^Uf       , Uh          , Uh^Emf      , Uu          , Uu^Emf      , Uu          , Urb         , Urb         , Urb         , Urb         , Urb         , Urb         , Urb         , Urb         , Urb         , Xos         , Urb         , Urb         , Urb         , Urb         , Xos         , Xos         , Xos         , Xos         , Urb         , Urb         , Urb         , Urb         , Urb         , Urb         , Xos         , Xos         , Xos         , Urb         , Urb         , Urb         , Xos         , Xos         , Xos         , Urb         , Urb         , Urb         , Urb         , Xos         , Xos         
Xu          , Xu          , Xu          , Xu          , Uu^Uf       , Uu          , Uu^Uf       , Uu          , Uu          , Uu^Uf       , Uu          , Uu          , Uh          , Uh^Emf      , Uu^Uf       , Uh          , Ur          , Ur          , Uh          , Urb         , Uu          , Urb         , Xos         , Urb         , Xos         , Urb         , Urb         , Urb         , Urb         , Urb         , Urb         , Urb         , Urb         , Xos         , Urb         , Urb         , Urb         , Urb         , Urb         , Urb         , Urb         , Xos         , Xos         , Xos         , Xos         , Urb         , Urb         , Urb         , Xos         , Xos         , Xos         , Urb         , Urb         , Urb         , Xos         , Xos         , Xos         
Xu          , Xu          , Xu          , Uu          , Uh          , Uu^Uf       , Uh          , Uh          , Uh^Emf      , Uh          , Uu^Uf       , Uh^Emf      , Uh^Emf      , Uu          , Uu^Uf       , Uu^Uf       , Ur          , Uu^Emf      , Uu^Emf      , Uu          , Xu          , Xos         , Xos         , Xos         , Xos         , Xos         , Urb         , Urb         , Urb         , Urb         , Urb         , Urb         , Urb         , Urb         , Xos         , Urb         , Urb         , Urb         , Urb         , Urb         , Urb         , Xos         , Xos         , Xos         , Xos         , Urb         , Urb         , Urb         , Xos         , Xos         , Xos         , Urb         , Urb         , Urb         , Xos         , Xos         , Xos         
Xu          , Xu          , Xu          , Uh          , Uh          , Uh          , Uh          , Uh          , Uh          , Uu^Uf       , Uu          , Uu          , Uu          , Uu          , Uu          , Uu          , Wwg^Bw|r    , Uu          , Xu          , Xu          , Xu          , Xu          , Xu          , Xos         , Xos         , Xos         , Xos         , Urb         , Urb         , Urb         , Uu^Vu       , Urb         , Urb         , Xos         , Xos         , Xos         , Urb         , Urb         , Urb         , Urb         , Urb         , Urb         , Urb         , Xos         , Urb         , Urb         , Urb         , Urb         , Urb         , Xos         , Urb         , Urb         , Urb         , Urb         , Xos         , Xos         , Xos         
Xu          , Xu          , Xu          , Uu          , Uu^Uf       , Uu^Uf       , Uh^Emf      , Uh          , Xuc         , Xuc         , Xuc         , Xuc         , Xuc         , Xuc         , Wwg         , Wwg         , Wwg         , Wwg         , Wwg         , Xu          , Xu          , Xu          , Xu          , Xu          , Xu          , Xos         , Xos         , Xos         , Urb         , Urb         , Urb         , Urb         , Urb         , Xos         , Xos         , Xos         , Urb         , Urb         , Urb         , Urb         , Urb         , Urb         , Urb         , Urb         , Urb         , Urb         , Urb         , Urb         , Urb         , Urb         , Urb         , Urb         , Urb         , Urb         , Xos         , Xos         , Xos         
Xu          , Xu          , Xu          , Xu          , Uu^Uf       , Uu          , Uu^Uf       , Uu^Uf       , Uu^Uf       , Xuc         , Xuc         , Xuc         , Wwg         , Wwg         , Wog         , Wwg         , Wwg^Bw|r    , Wog         , Wog         , Xu          , Wwg         , Xu          , Xu          , Xu          , Xu          , Xos         , Xu          , Xos         , Xos         , Uu          , Uu          , Urb         , Uu          , Uu          , Xos         , Xos         , Urb         , Urb         , Urb         , Urb         , Urb         , Urb         , Urb         , Urb         , Uu^Vu       , Urb         , Xos         , Urb         , Urb         , Urb         , Urb         , Urb         , Urb         , Xos         , Xos         , Xos         , Xos         
Xu          , Xu          , Xu          , Xu          , Uu^Uf       , Uu^Uf       , Uu^Uf       , Uu^Uf       , Xuc         , Xuc         , Xuc         , Xuc         , Wog         , Wwg         , Wwg         , Wwg         , Ur          , Wwg         , Wwg         , Wwg         , Wog         , Wwg         , Wwg         , Xu          , Xu          , Xu          , Xu          , Xu          , Uu          , Uu          , Uu          , Ur          , Uu          , Uu          , Urb         , Urb         , Urb         , Uu^Vu       , Urb         , Xos         , Xos         , Xos         , Urb         , Urb         , Urb         , Urb         , Xos         , Urb         , Urb         , Urb         , Urb         , Urb         , Xos         , Xos         , Xos         , Xos         , Xos         
Uu^Emf      , Xu          , Uu^Uf       , Uh^Emf      , Uh^Emf      , Uh          , Uu^Emf      , Uu^Uf       , Uh          , Xuc         , Wwg         , Wwg         , Wwg         , Wwg         , Wwg         , Ur          , Ur          , Ur          , Uu^Vu       , Wwg         , Wog         , Wog         , Wog         , Wwg         , Wwg         , Xu          , Xu          , Uu          , Uu          , Uu          , Ur          , Ur          , Uu          , Uu          , Urb         , Urb         , Urb         , Urb         , Urb         , Urb         , Xos         , Xos         , Xos         , Urb         , Urb         , Xos         , Xos         , Xos         , Urb         , Urb         , Urb         , Xos         , Xos         , Xos         , Xos         , Xos         , Xos         
Uu^Emf      , Uu^Emf      , Uu^Emf      , Uu^Emf      , Uu^Emf      , Uu^Emf      , Uu^Emf      , Uh          , Uh          , Wwg         , Wwg         , Wwg         , Wog         , Wog         , Wwg         , Wwg         , Wwg         , Ur          , Ur          , Wwg         , Wog         , Wog         , Wog         , Wog         , Wog         , Wwg         , Wwg         , Uu          , Ur          , Ur          , Uu          , Uu          , Uu          , Uu          , Urb         , Xos         , Urb         , Urb         , Urb         , Urb         , Xos         , Xos         , Urb         , Urb         , Urb         , Xos         , Xos         , Xos         , Urb         , Urb         , Xos         , Xos         , Xos         , Xos         , Xos         , Xos         , Xos         
Uu^Emf      , Uu^Emf      , Uu^Uf       , Uu^Uf       , Uu^Emf      , Uu^Uf       , Uh          , Uh^Emf      , Uu^Emf      , Wwg         , Wwg         , Wog         , Wog         , Wog         , Wwg         , Wwg         , Wwg^Bw|r    , Wwg^Bw/r    , Wwg         , Wwg         , Wwg         , Wog         , Wog         , Wog         , Wog         , Wog         , Wwg         , Ur          , Uu          , Uu          , Uu          , Uu          , Uu          , Uu          , Xos         , Xos         , Xos         , Urb         , Urb         , Urb         , Urb         , Xos         , Urb         , Urb         , Urb         , Urb         , Urb         , Urb         , Urb         , Urb         , Xos         , Xos         , Xos         , Xos         , Xos         , Xos         , Xos         
Uu^Emf      , Uu^Emf      , Xu          , Uh          , Uh          , Uh^Emf      , Uh^Emf      , Uu^Uf       , Uu          , Wwg         , Wog         , Wog         , Wog         , Wog         , Wwg         , Wwg         , Ur          , Wwg         , Wwg         , Wwg         , Wwg         , Wog         , Wog         , Wog         , Wwg         , Wwg         , Wwg         , Uu          , Uu          , Uu^Vu       , Uu          , Xu          , Xu          , Uu          , Uu          , Xos         , Urb         , Urb         , Urb         , Urb         , Urb         , Urb         , Urb         , Urb         , Xos         , Urb         , Urb         , Urb         , Urb         , Urb         , Xos         , Xos         , Xos         , Xos         , Xos         , Xos         , Xos         
Xu          , Xu          , Xu          , Xu          , Uu          , Uu^Uf       , Uu^Uf       , Uu^Uf       , Uu          , Wwg         , Wwg         , Wog         , Wog         , Wog         , Wwg         , Ur          , Ur          , Wwg^Bw\r    , Wwg^Bw\r    , Ur          , Ur          , Wwg         , Wwg         , Wwf         , Wog         , Wog         , Wwg         , Uu          , Uu          , Uu          , Uu          , Xu          , Uu          , Uu          , Uu          , Uu          , Urb         , Uu^Vu       , Urb         , Urb         , Urb         , Urb         , Urb         , Xos         , Xos         , Xos         , Xos         , Urb         , Urb         , Urb         , Xos         , Xos         , Xos         , Xos         , Xos         , Xos         , Xos         
Xu          , Xu          , Xu          , Xu          , Uu^Uf       , Uh          , Uu^Uf       , Uu^Emf      , Uu          , Wwg         , Wwg         , Wwg         , Wwg         , Wwg         , Wwg         , Wwg         , Wwg^Bw|r    , Wwg         , Wwg         , Ur          , Wwg         , Wwg^Bw\r    , Ur          , Wwg         , Wwg         , Wog         , Wwg         , Wwg         , Uu          , Uu          , Uu          , Uu          , Uu          , Uu          , Urb         , Urb         , Urb         , Urb         , Xos         , Urb         , Xos         , Urb         , Urb         , Xos         , Xos         , Xos         , Urb         , Urb         , Urb         , Urb         , Urb         , Xos         , Xos         , Xos         , Xos         , Xos         , Xos         
Xu          , Xu          , Xu          , Xu          , Uu^Uf       , Uu^Uf       , Uh          , Uh^Emf      , Uh          , Uu          , Wwg         , Wwg         , Wwg         , Wwg         , Wog         , Wwg         , Wwg^Bw|r    , Wwg         , Wog         , Wog         , Wog         , Wwg         , Ur          , Ur          , Wwg         , Wwf         , Wog         , Wwg         , Wwg         , Uu          , Uu          , Uu          , Uu          , Uu          , Urb         , Urb         , Urb         , Urb         , Xos         , Xos         , Xos         , Urb         , Urb         , Urb         , Xos         , Xos         , Urb         , Urb         , Urb         , Urb         , Urb         , Xos         , Xos         , Xos         , Xos         , Xos         , Xos         
Xu          , Xu          , Xu          , Uh          , Uu^Uf       , Uh^Emf      , Uu^Uf       , Uh^Emf      , Uu          , Uh          , Wwg         , Wwg         , Wwg         , Wog         , Wog         , Wwg         , Ur          , Ur          , Wwg         , Wog         , Wwg         , Wog         , Wwg^Bw|r    , Wwg         , Wog         , Wog         , Wog         , Wog         , Wwg         , Ur          , Ur          , Uu          , Ur          , Ur          , Urb         , Urb         , Urb         , Urb         , Xos         , Xos         , Xos         , Urb         , Urb         , Urb         , Urb         , Urb         , Urb         , Urb         , Urb         , Urb         , Urb         , Urb         , Urb         , Xos         , Urb         , Xos         , Xos         
Xu          , Xu          , Xu          , Uh          , Uh          , Uu          , Uh          , Uu^Uf       , Uu^Uf       , Uu          , Uu^Uf       , Wwg         , Wog         , Wog         , Wog         , Wwg         , Wwg         , Uu^Vu       , Wwg         , Wog         , Ur          , Wwg         , Ur          , Wwg         , Wwg         , Wog         , Wog         , Wog         , Wwg         , Uu          , Uu          , Ur          , Uu          , Uu          , Urb         , Urb         , Urb         , Urb         , Xos         , Xos         , Xos         , Xos         , Urb         , Urb         , Urb         , Urb         , Urb         , Urb         , Uu^Vu       , Urb         , Urb         , Urb         , Urb         , Urb         , Urb         , Urb         , Urb         
Xu          , Xu          , Xu          , Uu^Uf       , Uu^Uf       , Uu^Uf       , Uu          , Uh          , Uu^Emf      , Uh^Emf      , Uu          , Wwg         , Wog         , Wog         , Wog         , Wog         , Wog         , Wwg         , Wwg         , Wwg         , Ur          , Ur          , Wwg         , Ur          , Wwg         , Wwf         , Wwg         , Wwg         , Wwf         , Uu          , Uu          , Xu          , Xu          , Uu          , Urb         , Urb         , Urb         , Urb         , Urb         , Urb         , Urb         , Urb         , Urb         , Urb         , Xos         , Urb         , Urb         , Urb         , Xos         , Urb         , Urb         , Urb         , Urb         , Urb         , Urb         , Urb         , Urb         
Xu          , Xu          , Xu          , Uu^Uf       , Uh          , Uu^Emf      , Uu^Uf       , Uu^Uf       , Uu^Uf       , Uh          , Uu          , Wwg         , Wwg         , Wog         , Wwg         , Wog         , Wog         , Wog         , Wwg         , Wwg         , Wwg^Bw|r    , Wwg         , Wwg         , Wwg         , Wog         , Wog         , Wwg         , Wwg         , Uu          , Ur          , Ur          , Uu          , Uu          , Uu          , Uu          , Urb         , Urb         , Urb         , Urb         , Urb         , Urb         , Urb         , Urb         , Urb         , Xos         , Xos         , Xos         , Xos         , Xos         , Urb         , Urb         , Urb         , Urb         , Urb         , Urb         , Urb         , Urb         
Xu          , Xu          , Xu          , Uu^Uf       , Uh          , Uu^Uf       , Uu^Uf       , Uu^Uf       , Uu^Uf       , Uu^Uf       , Uh          , Uu          , Uu^Uf       , Wwg         , Wwg         , Wog         , Wog         , Wog         , Wwg^Ii      , Wwg^Ii      , Ur^Ii       , Wwg         , Wwg         , Wog         , Wog         , Wog         , Wwg         , Wwg         , Uu          , Uu          , Uu          , Ur          , Ur          , Uu          , Uu          , Urb         , Urb         , Urb         , Urb         , Urb         , Uu^Vu       , Urb         , Urb         , Urb         , Xos         , Xos         , Urb         , Xos         , Urb         , Urb         , Urb         , Urb         , Urb         , Urb         , Urb         , Urb         , Xos         
Xu          , Xu          , Xu          , Uh          , Uu          , Uu^Uf       , Uu^Emf      , Uh          , Uu^Uf       , Uu^Uf       , Uu^Uf       , Uu^Uf       , Uu          , Wwg         , Uu^Emf      , Wwg         , Wwg         , Wwg^Ii      , Ur^Ii       , Ur^Ii       , Ur^Ii       , Ur^Ii       , Wwg         , Wog         , Wog         , Wog         , Wwg         , Uu          , Uu^Vu       , Uu          , Xu          , Uu          , Uu          , Ur          , Ur          , Urb         , Urb         , Urb         , Urb         , Urb         , Urb         , Urb         , Urb         , Urb         , Xos         , Xos         , Urb         , Urb         , Urb         , Urb         , Urb         , Urb         , Urb         , Urb         , Xos         , Xos         , Xos         
Xu          , Xu          , Xu          , Xu          , Uu^Uf       , Uu^Uf       , Uu^Uf       , Uu^Uf       , Uh          , Uu^Uf       , Uh          , Uh^Emf      , Uh          , Uu          , Uu^Uf       , Xu          , Xu          , Xu          , Xu          , 3 Ur^Ii     , Xu          , Ur^Ii       , Wwg         , Wog         , Wwg         , Wwg         , Uu          , Uu          , Uu          , Uu          , Xu          , Xu          , Uu          , Uu          , Uu          , Urb         , Urb         , Urb         , Urb         , Urb         , Urb         , Urb         , Urb         , Urb         , Urb         , Urb         , Urb         , Urb         , Urb         , Urb         , Urb         , Urb         , Urb         , Urb         , Xos         , Xos         , Xos         
Xu          , Xu          , Xu          , Xu          , Uu^Uf       , Uh          , Uu^Uf       , Uh          , Xu          , Uu^Uf       , Xu          , Uu^Uf       , Xu          , Xu          , Xu          , Xu          , Xu          , Xu          , Xu          , Xu          , Xu          , Xu          , Xu          , Wwg         , Xu          , Uu          , Uu          , Uu          , Uu          , Uu          , Xu          , Uu          , Xu          , Xu          , Xu          , Urb         , Urb         , Urb         , Urb         , Urb         , Urb         , Urb         , Urb         , Urb         , Urb         , Urb         , Xos         , Urb         , Urb         , Urb         , Urb         , Urb         , Xos         , Xos         , Xos         , Xos         , Xos         
Xu          , Xu          , Xu          , Xu          , Xu          , Uu^Uf       , Xu          , Xu          , Xu          , Xu          , Xu          , Xu          , Xu          , Xu          , Xu          , Xu          , Xu          , Xu          , Xu          , Xu          , Xu          , Xu          , Xu          , Xu          , Xu          , Xu          , Xu          , Uu          , Xu          , Xu          , Xu          , Xu          , Xu          , Xu          , Xu          , Xos         , Xos         , Urb         , Xos         , Urb         , Xos         , Xos         , Xos         , Urb         , Xos         , Xos         , Xos         , Xos         , Urb         , Urb         , Xos         , Xos         , Xos         , Xos         , Xos         , Xos         , Xos         
Xu          , Xu          , Xu          , Xu          , Xu          , Xu          , Xu          , Xu          , Xu          , Xu          , Xu          , Xu          , Xu          , Xu          , Xu          , Xu          , Xu          , Xu          , Xu          , Xu          , Xu          , Xu          , Xu          , Xu          , Xu          , Xu          , Xu          , Xu          , Xu          , Xu          , Xu          , Xu          , Xu          , Xu          , Xos         , Xos         , Xos         , Xos         , Xos         , Xos         , Xos         , Xos         , Xos         , Xos         , Xos         , Xos         , Xos         , Xos         , Xos         , Xos         , Xos         , Xos         , Xos         , Xos         , Xos         , Xos         , Xos         
