border_size=1
usage=map

Qxua        , Qxua        , Qxua        , Zwsl        , Zwsl        , Zwsl        , Zvw         , Zvw         , Zvw         , Zvw         , Zvw         , Zwsl        , Uh          , Uh          , Md          , Md          , Md^Xm       , Md^Xm       , Md^Xm       , Md^Xm       , Md^Xm       , Md^Xm       , Md^Xm       , Md^Xm       , Md^Xm       , Md^Xm       , Md^Xm       , Md^Xm       , Md^Xm       , Md^Xm       , Md^Xm       , Md^Xm       , Md^Xm       , Md^Xm       , Md^Xm       , Md^Xm       , Md^Xm       , Md^Xm       , Md^Xm       , Md^Xm       , Md^Xm       , Md^Xm       , Md^Xm       , Md^Xm       , Md^Xm       , Md^Xm       , Md^Xm       , Md^Xm       , Md^Xm       , Xol         , Xol         , Urb         , Xol         , Xol         , Xol         , Urb         , Xol         , Xol         , Xol         , Xol         
Qxua        , Qxua        , Qxua        , Zwsl        , Zwsl        , Zwsl        , Zwsl        , Zvw         , Zvw         , Zwsl        , Zvw         , Zwsl        , Uu          , Uh          , Md          , Md          , Md          , Md^Xm       , Md^Xm       , Md^Xm       , Md^Xm       , Md^Xm       , Md^Xm       , Md^Xm       , Md^Xm       , Md^Xm       , Md^Xm       , Md^Xm       , Md^Xm       , Md^Xm       , Md^Xm       , Md^Xm       , Md^Xm       , Md^Xm       , Md^Xm       , Md^Xm       , Md^Xm       , Md^Xm       , Md^Xm       , Md^Xm       , Md^Xm       , Md^Xm       , Md^Xm       , Md^Xm       , Md^Xm       , Md^Xm       , Md^Xm       , Md^Xm       , Md^Xm       , Xol         , Xol         , Urb         , Urb         , Xol         , Urb         , Urb         , Xol         , Xol         , Urb         , Urb         
Qxua        , Qxua        , Qxua        , Qxua        , Qxua        , Zwsl        , Zwsl        , Zwsl        , Zvw         , Zwsl        , Zvw         , Zvw         , Uu          , Uu          , Uu          , Uh          , Uh          , Md          , Md          , Md^Xm       , Md          , Md^Xm       , Md^Xm       , Md^Xm       , Md^Xm       , Md^Xm       , Md^Xm       , Md^Xm       , Md^Xm       , Md^Xm       , Md^Xm       , Md^Xm       , Md^Xm       , Md^Xm       , Md^Xm       , Md^Xm       , Md^Xm       , Md^Xm       , Md^Xm       , Md^Xm       , Md^Xm       , Md^Xm       , Md          , Md^Xm       , Md^Xm       , Md^Xm       , Md^Xm       , Md^Xm       , Md^Xm       , Xol         , Xol         , Xol         , Urb         , Urb         , Urb         , Urb         , Urb         , Urb         , Xol         , Xol         
Qxua        , Qxua        , Qxua        , Qxua        , Qxua        , Qxua        , Zwsl        , Zwsl        , Zwsl        , Zvw         , Zvw         , Zwsl        , Zwsl        , Uu          , Zwsl        , Uu          , Uh          , Uh          , Md          , Md          , Md          , Md^Xm       , Md          , Md          , Md^Xm       , Md^Xm       , Md^Xm       , Md^Xm       , Md^Xm       , Md^Xm       , Md^Xm       , Md^Xm       , Md^Xm       , Md^Xm       , Md^Xm       , Md^Xm       , Md^Xm       , Md^Xm       , Md          , Md^Xm       , Md          , Md          , Md          , Md          , Md          , Md^Xm       , Md^Xm       , Md^Xm       , Md^Xm       , Xol         , Urb         , Urb         , Urb         , Urb         , Urb         , Urb         , Urb         , Urb         , Xol         , Xol         
Qxua        , Qxua        , Qxua        , Qxua        , Qxua        , Qxua        , Qxua        , Zwsl        , Zwsl        , Zvw         , Zvw         , Zvw         , Zwsl        , Zwsl        , Zwsl        , Uu          , Zwsl        , Uh          , Uh          , Uu          , Uu          , Md          , Uu^Ziff     , Uh          , Md          , Md^Xm       , Md^Xm       , Md^Xm       , Md          , Md^Xm       , Md^Xm       , Md^Xm       , Md          , Md          , Md          , Md          , Md          , Md          , Uh          , Md          , Uu          , Md          , Uh          , Md          , Uh          , Md          , Chr         , Md^Xm       , Md^Xm       , Xol         , Urb         , Urb         , Urb         , Urb         , Urb         , Urb         , Urb         , Xol         , Xol         , Xol         
Qxua        , Qxua        , Qxua        , Qxua        , Qxua        , Qxua        , Qxua        , Zwsl        , Zwsl        , Zvw         , Zvw         , Zvw         , Zwsl        , Zwsl        , Zwsl        , Zwsl        , Zwsl^Ziff   , Zwsl        , Zwsl^Ziff   , Zwsl^Ziff   , Zwsl^Ziff   , Uu^Ziff     , Zwsl        , Uu          , Md          , Md          , Md          , Md          , Md          , Md          , Md          , Md          , Md          , Md          , Uh          , Uh          , Uh          , Md          , Zwsl        , Uu          , Uu^Ziff     , Uu          , Zwsl        , Uh          , Zwsl        , Uh          , Chr         , Chr         , 3 Khr       , Xol         , Xol         , Urb         , Urb         , Urb         , Urb         , Urb         , Xol         , Urb         , Urb         , Xol         
Qxua        , Qxua        , Qxua        , Qxua        , Qxua        , Qxua        , Zwsl        , Zwsl        , Zwsl        , Zvw         , Zvw         , Zwsl^Vzps   , Zwsl        , Zwsl        , Zwsl^Ziff   , Zwsl^Ziff   , Zwsl        , Zwsl^Ziff   , Zwsl        , Zwsl        , Zwsl        , Zwsl        , Zvw         , Zwsl        , Uu          , Md          , Uh          , Uh          , Uh          , Uh          , Uh          , Md          , Uh          , Uh          , Uu          , Uu          , Uu^Ziff     , Uu          , Zwsl^Ziff   , Zwsl^Ziff   , Zwsl        , Zwsl        , Zwsl        , Zwsl        , Zvw         , Zwsl        , Zwsl        , Chr         , Chr         , Xol         , Urb         , Urb         , Urb         , Urb         , Xol         , Urb         , Xol         , Xol         , Xol         , Urb         
Qxua        , Qxua        , Qxua        , Qxua        , Qxua        , Zwsl        , Zwsl        , Zwsl        , Zvw         , Zvw         , Zwsl        , Zwsl        , Zwsl        , Zwsl        , Zwsl^Ziff   , Zwsl        , Zwsl        , Zwsl        , Zwsl        , Zwsl        , Zwsl        , Zvw         , Zvw         , Zwsl        , Zwsl^Ziff   , Uu          , Uu          , Uu          , Uh          , Uh          , Uu          , Uh          , Uh          , Uh          , Zwsl^Ziff   , Uu^Ziff     , Zwsl        , Zwsl^Ziff   , Zwsl        , Zwsl        , Zwsl        , Zwsl        , Zwsl        , Zwsl^Vzps   , Zvw         , Zwsl        , Zwsl        , Zwsl        , Zwsl        , Urb         , Urb         , Urb         , Xol         , Xol         , Xol         , Xol         , Xol         , Xol         , Xol         , Xol         
Qxua        , Qxua        , Qxua        , Qxua        , Qxua        , Zwsl        , Zwsl        , Zwsl        , Zvw         , Zvw         , Zwsl        , Zwsl        , Zwsl        , Zwsl^Ziff   , Zwsl^Ziff   , Zwsl^Ziff   , Zwsl^Ziff   , Zwsl^Ziff   , Zwsl^Ziff   , Zwsl^Ziff   , Zwsl^Ziff   , Zwsl^Ziff   , Zwsl        , Zvw         , Zvw         , Zwsl        , Zwsl        , Uu          , Uu          , Uu          , Uu          , Uu          , Zwsl        , Zwsl^Ziff   , Zwsl^Ziff   , Zwsl        , Zwsl        , Zwsl        , Zwsl        , Zwsl^Ziff   , Zwsl^Ziff   , Zwsl^Ziff   , Zwsl        , Zwsl        , Zwsl        , Zwsl        , Zwsl        , Zwsl        , Chr         , Urb         , Xol         , Xol         , Xol         , Xol         , Xol         , Xol         , Xol         , Xol         , Xol         , Xol         
Qxua        , Qxua        , Qxua        , Qxua        , Qxua        , Qxua        , Zwsl        , Zwsl        , Zvw         , Zwsl        , Zwsl        , Zwsl^Ziff   , Zwsl^Ziff   , Zwsl        , Zwsl^Ziff   , Zwsl^Ziff   , Zwsl        , Zwsl^Ziff   , Zwsl        , Zwsl^Ziff   , Zwsl        , Zwsl        , Zvw         , Zvw         , Zvw         , Zwsl^Ziff   , Zwsl^Ziff   , Zwsl        , Zwsl        , Zwsl        , Zwsl        , Zwsl        , Zwsl^Ziff   , Zwsl^Ziff   , Zwsl^Ziff   , Zwsl        , Zwsl^Ziff   , Zwsl^Ziff   , Zwsl^Ziff   , Zwsl^Ziff   , Zwsl        , Zwsl        , Zwsl        , Zwsl        , Zwsl^Ziff   , Zwsl        , Zwsl        , Chr         , 2 Khr       , Xol         , Xol         , Xol         , Xol         , Xol         , Xol         , Xol         , Xol         , Xol         , Xol         , Xol         
Qxua        , Qxua        , Qxua        , Qxua        , Qxua        , Qxua        , Zwsl        , Zwsl        , Zwsl        , Zvw         , Zwsl        , Zwsl        , Zwsl^Ziff   , Zwsl^Ziff   , Zwsl^Ziff   , Zwsl        , Zwsl        , Zwsl        , Zvw         , Zwsl        , Zvw         , Zvw         , Zwsl        , Zvw         , Zwsl        , Zwsl^Ziff   , Zwsl        , Zwsl        , Zvw^Vzps    , Zwsl        , Zwsl        , Zwsl        , Zwsl^Ziff   , Zwsl        , Zwsl        , Zwsl^Ziff   , Zwsl        , Zwsl^Ziff   , Zwsl        , Zwsl        , Zwsl        , Zwsl        , Zwsl^Ziff   , Zwsl^Ziff   , Zwsl        , Zwsl^Ziff   , Zwsl        , Chr         , Chr         , Md^Xm       , Md^Xm       , Md^Xm       , Md^Xm       , Md^Xm       , Md^Xm       , Md^Xm       , Md^Xm       , Md^Xm       , Md^Xm       , Xol         
Qxua        , Qxua        , Qxua        , Qxua        , Qxua        , Qxua        , Zwsl        , Zwsl        , Zwsl        , Zwsl        , Zwsl        , Zwsl        , Zwsl        , Zwsl^Ziff   , Zwsl^Ziff   , Zwsl        , Zwsl        , Zwsl        , Zwsl        , Zvw^Vzps    , Zwsl        , Zwsl        , Zwsl        , Zwsl        , Zwsl^Ziff   , Zwsl^Ziff   , Zwsl        , Zvw         , Zvw         , Zwsl        , Zwsl        , Zwsl^Ziff   , Zwsl^Ziff   , Zwsl        , Zwsl        , Zwsl        , Zwsl        , Zwsl        , Zwsl        , Zwsl        , Zwsl^Ziff   , Zwsl^Ziff   , Zwsl^Ziff   , Zwsl^Ziff   , Zwsl        , Zwsl        , Zwsl        , Zwsl        , Zwsl        , Md          , Md          , Md          , Md          , Md^Xm       , Md^Xm       , Md^Xm       , Md^Xm       , Md^Xm       , Md^Xm       , Md^Xm       
Qxua        , Qxua        , Qxua        , Qxua        , Qxua        , Zwsl        , Zwsl        , Zwsl        , Zwsl^Ziff   , Zwsl^Ziff   , Zwsl^Ziff   , Zwsl^Ziff   , Zwsl        , Zwsl        , Zwsl        , Zwsl^Ziff   , Zwsl        , Zwsl        , Zwsl        , Zwsl        , Zwsl^Ziff   , Zwsl^Ziff   , Zwsl^Ziff   , Zwsl^Ziff   , Zwsl^Ziff   , Zwsl^Ziff   , Zwsl        , Zwsl        , Zwsl^Ziff   , Zwsl        , Zwsl^Ziff   , Zwsl^Ziff   , Zwsl^Ziff   , Zwsl^Ziff   , Zwsl        , Zwsl        , Zwsl        , Zvw         , Zwsl^Ziff   , Zwsl^Ziff   , Zwsl^Ziff   , Zwsl^Ziff   , Zwsl        , Zwsl        , Zvw         , Zvw         , Zvw^Vzps    , Zvw         , Zwsl        , Zwsl        , Zwsl        , Uh          , Uh          , Md          , Md          , Md^Xm       , Md^Xm       , Md^Xm       , Md^Xm       , Md^Xm       
Qxua        , Qxua        , Qxua        , Qxua        , Qxua        , Zwsl^Ziff   , Zwsl^Ziff   , Zwsl^Ziff   , Zwsl        , Zwsl^Ziff   , Zwsl^Ziff   , Zwsl^Ziff   , Zwsl^Ziff   , Zwsl        , Zwsl^Ziff   , Zwsl^Ziff   , Zwsl^Ziff   , Zwsl        , Zwsl        , Zwsl        , Zwsl^Ziff   , Zwsl^Ziff   , Zwsl^Ziff   , Zwsl^Ziff   , Zwsl        , Zwsl^Ziff   , Zwsl        , Zwsl^Ziff   , Zwsl^Ziff   , Zwsl^Ziff   , Zwsl^Ziff   , Zwsl^Ziff   , Zwsl        , Zwsl        , Zwsl        , Zwsl        , Zvw         , Zvw^Vzps    , Zwsl^Ziff   , Zwsl^Ziff   , Zwsl        , Zwsl        , Zwsl        , Zwsl        , Zwsl        , Zwsl        , Zwsl        , Zwsl        , Zwsl        , Zwsl        , Zwsl^Ziff   , Uu          , Uh          , Uh          , Md          , Md          , Md^Xm       , Md^Xm       , Md^Xm       , Md^Xm       
Qxua        , Qxua        , Qxua        , Qxua        , Qxua        , Zwsl^Ziff   , Zwsl        , Zwsl        , Zwsl        , Zwsl        , Zwsl        , Zwsl^Ziff   , Zwsl^Ziff   , Zwsl^Ziff   , Zwsl^Ziff   , Zwsl^Ziff   , Zwsl^Ziff   , Zwsl^Ziff   , Zwsl^Ziff   , Zwsl^Ziff   , Zwsl^Ziff   , Zwsl^Ziff   , Zwsl^Ziff   , Zwsl        , Zwsl        , Zwsl        , Zwsl        , Zwsl        , Zwsl^Ziff   , Zwsl^Ziff   , Zwsl^Ziff   , Zwsl        , Zwsl        , Zwsl        , Zwsl        , Zwsl        , Zvw         , Zvw         , Zwsl        , Zwsl^Ziff   , Zwsl^Ziff   , Zwsl^Ziff   , Uu          , Zwsl        , Zwsl        , Zwsl        , Zwsl^Ziff   , Zwsl        , Zwsl^Ziff   , Zwsl^Ziff   , Zwsl        , Zwsl        , Uu          , Uh          , Md          , Md          , Md^Xm       , Md^Xm       , Md^Xm       , Md^Xm       
Qxua        , Qxua        , Qxua        , Qxua        , Qxua        , Zwsl        , Zwsl        , Zwsl        , Zvw         , Zvw         , Zwsl        , Zwsl        , Zwsl^Ziff   , Zwsl^Ziff   , Zwsl^Ziff   , Zwsl^Ziff   , Zwsl^Ziff   , Zwsl^Ziff   , Zwsl^Ziff   , Zwsl^Ziff   , Zwsl^Ziff   , Zwsl^Ziff   , Zwsl        , Zwsl        , Zwsl        , Zwsl        , Zvw^Vzps    , Zvw         , Zwsl^Ziff   , Zwsl^Ziff   , Zwsl^Ziff   , Zwsl^Ziff   , Zwsl^Ziff   , Zwsl        , Zwsl        , Zvw         , Zvw         , Zvw         , Zvw         , Uu^Ziff     , Uh          , Uh          , Uu          , Uu          , Uu^Ziff     , Zwsl^Ziff   , Uu^Ziff     , Uu^Ziff     , Uu          , Uu          , Zwsl        , Zwsl        , Uu          , Md          , Md          , Md          , Md^Xm       , Md^Xm       , Md^Xm       , Md^Xm       
Qxua        , Qxua        , Qxua        , Qxua        , Zwsl        , Zwsl        , Zwsl        , Zwsl        , Zvw         , Zwsl        , Zwsl        , Zwsl        , Zwsl        , Zwsl^Ziff   , Zwsl        , Zwsl^Ziff   , Zwsl^Ziff   , Zwsl^Ziff   , Zwsl^Ziff   , Zwsl^Ziff   , Zwsl        , Zwsl        , Zwsl        , Zvw         , Zvw         , Zvw         , Zwsl        , Zwsl        , Zwsl        , Zwsl^Ziff   , Zwsl^Ziff   , Zwsl^Ziff   , Zwsl^Ziff   , Zwsl        , Zwsl        , Zvw         , Zwsl        , Zwsl        , Uu          , Uu          , Uu          , Uu          , Zwsl^Ziff   , Uu^Ziff     , Zwsl^Ziff   , Uu^Ziff     , Zwsl        , Zwsl        , Zwsl        , Zwsl        , Zwsl        , Uu          , Uu          , Md          , Md          , Md^Xm       , Md^Xm       , Md^Xm       , Md^Xm       , Md^Xm       
Qxua        , Qxua        , Qxua        , Qxua        , Zwsl        , Zwsl        , Zwsl        , Zvw         , Zvw         , Zwsl        , Zvw         , Zwsl        , Zwsl        , Zwsl        , Zwsl        , Uu          , Uu          , Uu^Ziff     , Uu          , Uu          , Uh          , Zwsl        , Uu          , Zwsl        , Uu          , Zwsl        , Uu          , Uu          , Uu          , Uu          , Uu          , Zwsl^Ziff   , Zwsl^Ziff   , Zwsl        , Zwsl^Ziff   , Zwsl        , Zwsl        , Zwsl        , Zwsl^Ziff   , Uu          , Zwsl^Ziff   , Zwsl^Ziff   , Zwsl        , Zwsl        , Zwsl        , Zwsl        , Zvw         , Zwsl        , Zvw         , Zvw         , Zwsl        , Zwsl        , Uu          , Uh          , Md          , Md^Xm       , Md^Xm       , Md^Xm       , Md^Xm       , Md^Xm       
Qxua        , Qxua        , Zwsl        , Zwsl        , Zwsl        , Zwsl        , Zvw         , Zvw         , Zvw         , Zvw^Vzps    , Zwsl        , Zvw         , Zwsl        , Zwsl        , Uu          , Uu          , Uh          , Uu          , Zwsl        , Uh          , Uu          , Uh          , Uh          , Uu          , Cud         , Uu          , Cud         , Uh          , Zwsl        , Zwsl        , Zwsl        , Zwsl^Ziff   , Zwsl^Ziff   , Zwsl^Ziff   , Zwsl^Ziff   , Zwsl^Ziff   , Zwsl        , Zwsl        , Zvw         , Zwsl^Ziff   , Zwsl^Ziff   , Zwsl^Ziff   , Zwsl        , Zwsl        , Uu^Ziff     , Zvw         , Zwsl        , Zvw^Vzps    , Zwsl        , Zwsl        , Zwsl^Ziff   , Zwsl        , Uu          , Uh          , Md          , Md          , Md^Xm       , Md^Xm       , Md^Xm       , Md^Xm       
Qxua        , Qxua        , Qxua        , Zwsl        , Qxua        , Qxua        , Qxua        , Zvw         , Zwsl        , Zvw         , Zwsl        , Zwsl        , Zwsl        , Zwsl        , Zwsl        , Uu          , Zwsl        , Uu          , Uu          , Uu          , Uu^Ziff     , Uu          , Uu          , Cud         , 4 Kud       , Cud         , Cud         , Zwsl        , Zwsl        , Zwsl        , Zwsl        , Zwsl^Ziff   , Zwsl^Ziff   , Zwsl^Ziff   , Zwsl        , Zwsl        , Zvw         , Zvw         , Zwsl        , Zwsl^Ziff   , Zwsl^Ziff   , Zwsl^Ziff   , Zwsl^Ziff   , Zwsl^Ziff   , Zwsl        , Zwsl^Ziff   , Zwsl        , Zwsl^Ziff   , Zwsl        , Zwsl^Ziff   , Zwsl        , Zwsl        , Uu          , Uh          , Md          , Md          , Md          , Md^Xm       , Md^Xm       , Md^Xm       
Qxua        , Zwsl^Ii     , Qxua        , Qxua        , Qxua        , Qxua        , Qxua        , Qxua        , Qxua        , Qxua        , Zwsl^Ziff   , Zwsl^Ziff   , Zwsl        , Zwsl        , Zwsl        , Zwsl        , Zwsl        , Zwsl        , Zwsl^Ziff   , Zwsl^Ziff   , Zwsl^Ziff   , Zwsl        , Zwsl        , Cud         , Cud         , Cud         , Zwsl        , Zwsl        , Zvw         , Zvw         , Zwsl        , Zwsl^Ziff   , Uh          , Uu          , Zvw         , Zvw         , Zwsl        , Zwsl        , Zwsl        , Zwsl^Ziff   , Zwsl        , Zwsl^Ziff   , Zwsl        , Zwsl        , Zwsl        , Zwsl        , Zwsl        , Zwsl        , Zwsl        , Zwsl        , Zwsl        , Zwsl        , Zwsl        , Uu          , Uu          , Md          , Md          , Md^Xm       , Md^Xm       , Md^Xm       
Qxua        , Qxua        , Qxua        , Qxua        , Qxua        , Qxua        , Qxua        , Qxua        , Qxua        , Zwsl^Ziff   , Zwsl^Ziff   , Zwsl^Ziff   , Zwsl        , Zwsl        , Zwsl        , Zwsl        , Zvw         , Zwsl^Ziff   , Zwsl^Ziff   , Zwsl        , Zwsl        , Zwsl        , Zwsl        , Zwsl        , Zwsl        , Zwsl        , Zwsl^Ziff   , Zwsl^Ziff   , Zwsl^Ziff   , Zwsl        , Zwsl        , Uu          , Zvw         , Zvw         , Zwsl        , Zvw         , Zwsl        , Zwsl        , Zwsl^Ziff   , Zwsl        , Zwsl        , Zwsl        , Zwsl        , Zwsl        , Zwsl        , Zwsl        , Zwsl        , Zwsl        , Zvw^Vzps    , Zwsl        , Zwsl        , Zwsl        , Uh          , Uh          , Md          , Md          , Md          , Md^Xm       , Md^Xm       , Md^Xm       
Qxua        , Qxua        , Qxua        , Qxua        , Qxua        , Qxua        , Qxua        , Qxua        , Qxua        , Qxua        , Zwsl        , Zwsl        , Zwsl        , Zwsl        , Zvw         , Zvw         , Zvw         , Zvw         , Zwsl        , Zwsl        , Zwsl^Ziff   , Zwsl        , Zwsl^Ziff   , Zwsl^Ziff   , Zwsl^Ziff   , Zwsl^Ziff   , Zwsl        , Zwsl^Ziff   , Zwsl        , Zwsl^Ziff   , Zvw         , Zvw         , Zvw         , Zwsl        , Zwsl        , Zwsl        , Zwsl        , Zwsl^Ziff   , Zwsl^Ziff   , Zwsl        , Zwsl        , Zwsl        , Zvw         , Zwsl        , Zvw         , Zvw         , Zwsl        , Zwsl        , Uu          , Zwsl        , Uh          , Uh          , Md          , Md          , Md          , Md^Xm       , Md^Xm       , Md^Xm       , Md^Xm       , Md^Xm       
Qxua        , Qxua        , Qxua        , Qxua        , Qxua        , Qxua        , Qxua        , Qxua        , Qxua        , Zwsl        , Zwsl        , Zwsl        , Zwsl        , Zwsl        , Zvw         , Zwsl        , Zwsl        , Zwsl        , Zwsl^Ziff   , Zwsl^Ziff   , Zwsl^Ziff   , Zwsl^Ziff   , Zwsl        , Zwsl^Ziff   , Zwsl        , Zwsl        , Zwsl        , Zwsl        , Zwsl^Ziff   , Zwsl^Ziff   , Zvw         , Zvw         , Zwsl        , Zwsl        , Zwsl        , Zwsl        , Zwsl^Ziff   , Zwsl^Ziff   , Zwsl^Ziff   , Zwsl^Ziff   , Zvw         , Zvw         , Zwsl        , Zvw         , Zwsl        , Zwsl        , Zwsl        , Uu          , Uh          , Uh          , Md          , Md          , Md          , Md          , Md^Xm       , Md^Xm       , Md^Xm       , Md^Xm       , Md^Xm       , Md^Xm       
Qxua        , Qxua        , Qxua        , Qxua        , Qxua        , Qxua        , Qxua        , Qxua        , Qxua        , Zwsl        , Zwsl        , Zwsl        , Zvw         , Zvw         , Zvw         , Zwsl        , Zwsl        , Zwsl^Ziff   , Zwsl        , Zwsl        , Zwsl        , Zwsl        , Zwsl        , Zwsl        , Zwsl        , Zwsl^Vzps   , Zwsl        , Zwsl^Ziff   , Zwsl^Ziff   , Zwsl        , Zwsl        , Zwsl        , Zwsl        , Zwsl        , Zwsl^Ziff   , Zwsl        , Zwsl^Ziff   , Zwsl^Ziff   , Zwsl        , Zwsl        , Zwsl        , Zwsl        , Uu          , Uu          , Uu          , Zwsl        , Zwsl        , Uu          , Uh          , Md          , Md          , Md          , Md^Xm       , Md^Xm       , Md^Xm       , Md^Xm       , Md^Xm       , Md^Xm       , Md^Xm       , Md^Xm       
Qxua        , Qxua        , Qxua        , Qxua        , Qxua        , Qxua        , Qxua        , Qxua        , Zwsl        , Zwsl        , Zwsl        , Zwsl        , Zvw         , Zvw         , Zwsl        , Zwsl        , Zvw         , Zwsl        , Zwsl        , Zwsl        , Zwsl        , Zwsl        , Zvw         , Zvw         , Uu          , Zwsl        , Uu^Ziff     , Zwsl^Ziff   , Uu          , Zwsl        , Uu          , Uu          , Uu          , Uu          , Uu^Ziff     , Zwsl^Ziff   , Zwsl        , Zwsl        , Zwsl        , Zwsl        , Zwsl        , Zwsl        , Uh          , Uu          , Uh          , Zwsl        , Zwsl        , Zwsl        , Md          , Md          , Md^Xm       , Md^Xm       , Md^Xm       , Md^Xm       , Md^Xm       , Md^Xm       , Md^Xm       , Md^Xm       , Md^Xm       , Md^Xm       
Qxua        , Qxua        , Qxua        , Qxua        , Qxua        , Qxua        , Qxua        , Qxua        , Zwsl        , Zwsl        , Zwsl        , Zvw         , Zvw         , Zvw         , Zvw         , Zvw         , Zvw         , Zvw         , Zvw         , Zvw         , Zvw         , Zvw         , Uu          , Uu          , Uh^Ziff     , Uu^Ziff     , Uu          , Uu          , Uh          , Uh          , Uu          , Uu          , Uh          , Uu^Ziff     , Uh          , Uu          , Uu          , Zwsl        , Zwsl        , Zwsl        , Uu          , Uh          , Md          , Uh          , Md          , Zwsl        , Zwsl        , Zwsl        , Md          , Md^Xm       , Md^Xm       , Md^Xm       , Md^Xm       , Md^Xm       , Md^Xm       , Md^Xm       , Md^Xm       , Md^Xm       , Md^Xm       , Md^Xm       
Qxua        , Qxua        , Qxua        , Qxua        , Qxua        , Qxua        , Zwsl        , Zwsl        , Zwsl        , Zwsl        , Zvw         , Zvw         , Zvw         , Zwsl^Vzps   , Zvw         , Zwsl        , Zwsl        , Zvw         , Uu          , Zvw         , Uh          , Uh          , Md          , Uh          , Md          , Uh          , Md          , Uu          , Md          , Md          , Md          , Md          , Md          , Uh          , Uh          , Uh          , Uu          , Zwsl        , Zwsl        , Uu          , Md          , Md          , Md          , Md          , Md^Xm       , Md          , Zwsl        , Zwsl        , Md^Xm       , Md^Xm       , Md^Xm       , Md^Xm       , Md^Xm       , Md^Xm       , Md^Xm       , Md^Xm       , Md^Xm       , Md^Xm       , Md^Xm       , Md^Xm       
Qxua        , Qxua        , Qxua        , Qxua        , Qxua        , Zwsl        , Zwsl        , Zwsl        , Zwsl        , Zwsl        , Zvw         , Zvw         , Zvw         , Zvw         , Zwsl        , Zwsl        , Uu          , Uu          , Uu          , Uh          , Md          , Md          , Md          , Md          , Md          , Md          , Md          , Md          , Md^Xm       , Md          , Md^Xm       , Md          , Md          , Uh          , Uh          , Uu          , Uu          , Zwsl        , Uu          , Md          , Md          , Md          , Md^Xm       , Md^Xm       , Md^Xm       , Md^Xm       , Uu          , Zwsl        , Md^Xm       , Md^Xm       , Md^Xm       , Md^Xm       , Md^Xm       , Md^Xm       , Md^Xm       , Md^Xm       , Md^Xm       , Md^Xm       , Md^Xm       , Md^Xm       
Qxua        , Qxua        , Qxua        , Qxua        , Qxua        , Zwsl        , Zwsl        , Zwsl        , Zvw         , Zvw         , Zvw         , Zvw         , Zvw         , Zwsl        , Zwsl        , Zwsl        , Uu          , Uh          , Uh          , Uh          , Md          , Md          , Md          , Md          , Md^Xm       , Md          , Md^Xm       , Md^Xm       , Md^Xm       , Md^Xm       , Md^Xm       , Mm          , Mm          , Mm          , Uh          , Uh          , Uu          , Zwsl        , Uu          , Md          , Md^Xm       , Md^Xm       , Md^Xm       , Md^Xm       , Md^Xm       , Xu          , Ur          , Ur          , Xu          , Xu          , Xu          , Xu          , Xu          , Xu          , Xu          , Xu          , Xu          , Xu          , Xu          , Xu          
Qxua        , Qxua        , Qxua        , Qxua        , Qxua        , Zwsl        , Zwsl        , Zvw         , Zwsl        , Zvw         , Zvw         , Zvw         , Zvw         , Zwsl        , Uu          , Uu          , Uh          , Uh          , Md          , Md          , Md          , Md          , Md^Xm       , Md^Xm       , Md^Xm       , Md^Xm       , Md^Xm       , Md^Xm       , Md^Xm       , Md^Xm       , Md^Xm       , Md^Xm       , Mm          , Mm          , Uh          , Uh          , Uu          , Zwsl        , Uu          , Md          , Md^Xm       , Md^Xm       , Md^Xm       , Md^Xm       , Md^Xm       , Xu          , Ur          , Uu          , Ur          , Uh          , Ur          , Uu          , Ur          , Xu          , Ur          , Uh          , Uh          , Xu          , Xu          , Xu          
Qxua        , Qxua        , Qxua        , Qxua        , Zwsl        , Zwsl        , Zwsl        , Zvw         , Zvw         , Zvw         , Zwsl        , Zvw         , Zwsl        , Zwsl        , Uu          , Uh          , Uh          , Md          , Md          , Md          , Md^Xm       , Md^Xm       , Md^Xm       , Md^Xm       , Md^Xm       , Md^Xm       , Md^Xm       , Md^Xm       , Md^Xm       , Md^Xm       , Md^Xm       , Md^Xm       , Md^Xm       , Mm          , Md          , Uh          , Uu          , Zwsl        , Uh          , Md^Xm       , Md^Xm       , Md^Xm       , Md^Xm       , Md^Xm       , Md^Xm       , Xu          , Xu          , Ur          , Ur          , Ur          , Ur          , Ur          , Ur          , Ur          , Ur          , Ur          , Uu          , Xu          , Xu          , Xu          
Qxua        , Qxua        , Qxua        , Qxua        , Zwsl        , Zwsl        , Zvw         , Zvw         , Zvw         , Zvw         , Zwsl        , Zvw         , Zwsl        , Zwsl        , Uu          , Uh          , Md          , Md          , Md          , Md^Xm       , Md^Xm       , Md^Xm       , Md^Xm       , Md^Xm       , Md^Xm       , Md^Xm       , Md^Xm       , Md^Xm       , Md^Xm       , Md^Xm       , Md^Xm       , Md^Xm       , Md^Xm       , Mm          , Mm          , Uh          , Uu          , Zwsl        , Uu          , Md^Xm       , Md^Xm       , Md^Xm       , Md^Xm       , Md^Xm       , Md^Xm       , Xu          , Xu          , Uu          , Ur          , Xu          , Xu          , Ur          , Ur          , 1 Ur        , Ur          , Ur          , Ur          , Xu          , Xu          , Xu          
Qxua        , Qxua        , Qxua        , Qxua        , Zwsl        , Zwsl        , Zwsl        , Zvw         , Zvw         , Zvw         , Zvw         , Zvw         , Zwsl        , Zwsl        , Uu          , Uh          , Md          , Md          , Md^Xm       , Md^Xm       , Md^Xm       , Md^Xm       , Md^Xm       , Md^Xm       , Md^Xm       , Md^Xm       , Md^Xm       , Md^Xm       , Md^Xm       , Md^Xm       , Md^Xm       , Md^Xm       , Md^Xm       , Md          , Md          , Uh          , Uu          , Zwsl        , Zwsl        , Zwsl        , Md^Xm       , Md^Xm       , Md^Xm       , Md^Xm       , Md^Xm       , Xu          , Xu          , Xu          , Uu          , Ur          , Ur          , Ur          , Ur          , Ur          , Ur          , Ur          , Ur          , Ur          , Ur          , Xu          
Qxua        , Qxua        , Qxua        , Qxua        , Zwsl        , Zwsl        , Zwsl        , Zvw         , Zvw         , Zvw         , Zwsl        , Zwsl        , Zwsl        , Uu          , Uu          , Uh          , Md          , Md          , Md^Xm       , Md^Xm       , Md^Xm       , Md^Xm       , Md^Xm       , Md^Xm       , Md^Xm       , Md^Xm       , Md^Xm       , Md^Xm       , Md^Xm       , Md^Xm       , Md^Xm       , Md^Xm       , Md^Xm       , Md          , Md          , Uh          , Uu          , Uu          , Zwsl        , Zwsl        , Md^Xm       , Md^Xm       , Md^Xm       , Md^Xm       , Md^Xm       , Xu          , Xu          , Xu          , Xu          , Xu          , Xu          , Uh          , Xu          , Uu          , Xu          , Xu          , Xu          , Xu          , Ur          , Xu          
