border_size=1
usage=map

Qxua, Qxua, Qxua, Qxua, Qxua, Qxua, Qxua, Qxua, Qxua, Qxua, Qxua, Qxua, Qxua, Qxua, Qxua, Qxua, Qxua, Qxua, Qxua, Qxua, Qxua, Qxua, Qxua, Qxua, Qxua, Qxua, Qxua, Qxua, Qxua, Qxua, Qxua, Qxua, Qxua, Qxua, Qxua, Qxua, Qxua, Qxua, Qxua, Qxua, Qxua, Qxua, Qxua, Qxua, Qxua, Qxua, Qxua, Md^Xm, Md^Xm, Md^Xm, Md^Xm, Md^Xm, Md^Xm, Md^Xm, Md^Xm, Md^Xm, Md^Xm, Md^Xm, Md^Xm, Md^Xm, Md^Xm, Md^Xm, Md^Xm, Md^Xm
Qxua, Qxua, Qxua, Qxua, Qxua, Qxua, Qxua, Qxua, Qxua, Qxua, Qxua, Qxua, Qxua, Qxua, Qxua, Qxua, Qxua, Qxua, Qxua, Qxua, Qxua, Qxua, Qxua, Qxua, Qxua, Qxua, Qxua, Qxua, Qxua, Qxua, Qxua, Qxua, Qxua, Qxua, Qxua, Qxua, Qxua, Qxua, Qxua, Qxua, Qxua, Qxua, Qxua, Qxua, Qxua, Qxua, Zwsl, Md, Md, Md^Xm, Md^Xm, Md^Xm, Md^Xm, Md^Xm, Md^Xm, Md^Xm, Md^Xm, Md^Xm, Md^Xm, Md^Xm, Md^Xm, Md^Xm, Md^Xm, Md^Xm
Qxua, Qxua, Qxua, Qxua, Qxua, Qxua, Qxua, Qxua, Qxua, Qxua, Qxua, Qxua, Qxua, Qxua, Qxua, Qxua, Qxua, Qxua, Qxua, Qxua, Qxua, Qxua, Qxua, Qxua, Qxua, Qxua, Qxua, Qxua, Zwsl, Qxua, Qxua, Qxua, Zwsl, Qxua, Qxua, Qxua, Zwsl, Qxua, Qxua, Qxua, Md^Xm, Md^Xm, Md^Xm, Md^Xm, Md^Xm, Md, Md, Zwsl, Md, Md^Xm, Md^Xm, Md^Xm, Md^Xm, Md^Xm, Md^Xm, Md^Xm, Md^Xm, Md^Xm, Md^Xm, Md^Xm, Md^Xm, Md^Xm, Md^Xm, Md^Xm
Qxua, Qxua, Qxua, Qxua, Qxua, Qxua, Qxua, Qxua, Qxua, Qxua, Qxua, Qxua, Qxua, Qxua, Qxua, Qxua, Qxua, Qxua, Qxua, Qxua, Qxua, Qxua, Qxua, Qxua, Qxua, Qxua, Zwsl, Qxua, Zwsl, Zwsl, Zwsl^Zewt, Zwsl, Zwsl^Ziff, Zwsl, Zwsl, Zwsl, Zvw, Uh, Md, Md^Xm, Md^Xm, Md^Xm, Md^Xm, Md^Xm, Md^Xm, Md^Xm, Md^Xm, Md, Md^Xm, Md^Xm, Md^Xm, Md^Xm, Md^Xm, Md^Xm, Md^Xm, Md^Xm, Md^Xm, Md^Xm, Md^Xm, Md^Xm, Md^Xm, Md^Xm, Md^Xm, Md^Xm
Qxua, Qxua, Qxua, Qxua, Qxua, Qxua, Qxua, Qxua, Qxua, Qxua, Qxua, Qxua, Qxua, Qxua, Qxua, Qxua, Qxua, Qxua, Zwsl, Zwsl^Zewc, Qxua, Qxua, Qxua, Qxua, Zwsl, Zwsl, Zwsl^Zewt, Zwsl, Zvw, Zwsl, Zwsl, Zwsl^Ziff, Zwsl^Ziff, Zwsl, Zwsl, Zwsl^Zewc, Zvw, Uh, Uh, Md, Md, Md^Xm, Md^Xm, Md^Xm, Md^Xm, Md^Xm, Md^Xm, Md^Xm, Md^Xm, Md^Xm, Md^Xm, Md^Xm, Md^Xm, Md^Xm, Md^Xm, Md^Xm, Md^Xm, Md^Xm, Md^Xm, Md^Xm, Md^Xm, Md^Xm, Md^Xm, Md^Xm
Qxua, Qxua, Qxua, Qxua, Qxua, Qxua, Qxua, Qxua, Qxua, Qxua, Qxua, Qxua, Qxua, Qxua, Qxua, Qxua, Qxua, Qxua, Zwsl, Zwsl, Zwsl, Zwsl, Zwsl, Zvw, Zvw, Zwsl, Zwsl, Zvw, Zvw, Zwsl, Zwsl, Zwsl, Zwsl^Ziff, Zwsl^Ziff, Zwsl^Ziff, Zwsl, Zvw, Zvw, Uh, Md, Md, Md, Md, Md, Md^Xm, Md^Xm, Md^Xm, Md^Xm, Md^Xm, Md^Xm, Md^Xm, Md^Xm, Md^Xm, Md^Xm, Md^Xm, Md^Xm, Md^Xm, Md^Xm, Md^Xm, Md^Xm, Md^Xm, Md^Xm, Md^Xm, Md^Xm
Qxua, Qxua, Qxua, Qxua, Qxua, Qxua, Qxua, Qxua, Qxua, Qxua, Qxua, Qxua, Qxua, Zwsl, Zwsl, Zwsl, Zwsl, Zwsl, Zvw, Zwsl^Zews, Zwsl, Zwsl, Zwsl, Zvw, Zwsl, Zvw, Zvw, Zwsl, Zvw, Zvw, Zvw, Zwsl, Zwsl, Zwsl^Ziff, Zwsl^Ziff, Zwsl, Zwsl, Zvw, Zvw, Uh, Uh, Md, Uh, Md, Xol, Xol, Xol, Xol, Xol, Xol, Xol, Xol, Xol, Xol, Xol, Xol, Xol, Xol, Xol, Xol, Xol, Xol, Xol, Xol
Qxua, Qxua, Qxua, Qxua, Qxua, Qxua, Qxua, Qxua, Qxua, Qxua, Qxua, Qxua, Zwsl, Zwsl, Zwsl, Zwsl, Zvw, Zvw, Zvw, Zvw, Zwsl, Zvw, Zvw^Vzps, Zvw, Zwsl, Zwsl^Zewe, Zwsl, Zvw, Zvw, Zvw, Zvw, Zgwl, Zwsl, Zwsl^Ziff, Zwsl^Ziff, Zwsl^Ziff, Zwsl, Zwsl, Zvw, Zvw, Zwsl, Uh, Zwsl, Uh, Urb, Cud, Cud, 2 Kud, Cud, Urb, Urb, Xol, Urb, Urb, Urb, Xol, Urb, Urb, Urb, Urb, Urb, Xol, Xol, Xol
Qxua, Qxua, Qxua, Qxua, Qxua, Qxua, Qxua, Qxua, Qxua, Qxua, Zwsl, Zwsl, Zwsl^Zewt, Zwsl, Zvw^Vzps, Zvw, Zwsl, Zwsl^Zewt, Zwsl, Zvw, Zvw, Zvw, Zwsl, Zvw, Zvw, Zwsl, Zwsl^Ziff, Zwsl, Zwsl, Zwsl^Zewc, Zvw, Zvw, Zvw^Vzps, Zwsl, Zwsl, Zwsl^Ziff, Zwsl, Zwsl^Zews, Zvw, Zvw, Zvw, Zwsl^Zewc, Zwsl, Zwsl, Urb, Urb, Urb, Cud, Urb, Urb, Urb, Urb, Urb, Urb, Urb, Urb, Urb, Urb, Urb, Urb, Urb, Urb, Urb, Urb
Qxua, Qxua, Qxua, Qxua, Qxua, Qxua, Qxua, Qxua, Qxua, Qxua, Zwsl, Zwsl, Zwsl, Zwsl, Zvw, Zwsl, Zwsl, Zwsl, Zwsl^Zewc, Zwsl, Zvw, Zvw, Zwsl, Zwsl, Zvw, Zwsl, Zwsl^Ziff, Zwsl, Zwsl, Zwsl^Zews, Zwsl, Zvw, Zvw, Zwsl, Zwsl^Zews, Zwsl^Ziff, Zwsl^Ziff, Zwsl, Zvw, Zwsl, Zvw, Zwsl, Zvw, Zwsl, Urb, Urb, Urb, Urb, Urb, Urb, Urb, Urb, Xol, Xol, Xol, Urb, Urb, Urb, Urb, Urb, Urb, Urb, Urb, Urb
Qxua, Qxua, Qxua, Qxua, Qxua, Qxua, Qxua, Qxua, Zwsl, Zwsl, Zvw, Zvw, Zwsl, Zvw, Zwsl, Zwsl, Zwsl^Ziff, Zwsl, Zwsl, Zvw, Zvw, Zvw, Zvw, Zvw, Zvw, Zwsl, Zwsl^Ziff, Zwsl^Ziff, Zwsl, Zwsl^Ziff, Zwsl, Zvw, Zvw, Zwsl, Zwsl^Zewc, Zwsl, Zwsl^Ziff, Zwsl, Zvw, Zwsl, Zwsl, Zvw, Zvw, Zwsl, Urb, Urb, Cud, Urb, Cud, Urb, Urb, Urb, Urb, Xol, Xol, Urb, Urb, Urb, Urb, Urb, Urb, Urb, Urb, Urb
Qxua, Qxua, Qxua, Qxua, Qxua, Qxua, Zwsl, Zwsl, Zvw, Zvw, Zwsl, Zvw, Zvw, Zvw, Zwsl, Zwsl, Zwsl^Ziff, Zwsl, Zgwl, Zwsl, Zwsl^Zewt, Zvw, Zvw, Zvw, Zwsl, Zwsl, Zwsl^Zewc, Zwsl^Ziff, Zwsl^Ziff, Zwsl^Ziff, Zwsl, Zwsl, Zvw, Zvw, Zvw, Zwsl, Zwsl, Zwsl, Zwsl, Zvw, Zwsl, Zvw, Zvw, Zwsl, Urb, Cud, Cud, Cud, 3 Kud, Cud, Xol, Urb, Xol, Xol, Xol, Xol, Xol, Urb, Xol, Urb, Xol, Xol, Xol, Xol
Qxua, Qxua, Qxua, Qxua, Qxua, Qxua, Zwsl, Zvw, Zwsl, Zwsl^Zewe, Zwsl^Zewc, Zvw, Zvw, Zvw, Zwsl, Zwsl^Zews, Zwsl^Ziff, Zwsl, Zwsl^Ziff, Zwsl, Zwsl, Zwsl, Zvw, Zvw, Zwsl, Zwsl, Zwsl, Zwsl, Zwsl^Ziff, Zwsl^Ziff, Zwsl^Ziff, Zwsl, Zwsl^Zewt, Zvw, Zvw, Zvw, Zvw, Zwsl, Zwsl, Zvw^Zewt, Zvw, Zwsl, Uh, Zwsl, Xol, Xol, Xol, Xol, Xol, Xol, Xol, Xol, Xol, Xol, Xol, Xol, Xol, Xol, Xol, Xol, Xol, Xol, Xol, Xol
Qxua, Qxua, Qxua, Qxua, Qxua, Zwsl, Zvw, Zvw, Zwsl, Zwsl, Zwsl, Zvw, Zvw, Zwsl, Zwsl, Zwsl, Zwsl^Ziff, Zwsl^Ziff, Zwsl^Ziff, Zwsl, Zwsl, Zvw, Zwsl, Zvw, Zvw, Zwsl, Zwsl^Zewt, Zwsl, Zwsl, Zwsl^Ziff, Zwsl^Ziff, Zwsl, Zwsl, Zwsl, Zvw, Zvw, Zvw, Zvw, Zwsl, Zwsl, Zvw, Uh, Md, Md, Md^Xm, Md^Xm, Md^Xm, Md^Xm, Md^Xm, Md^Xm, Md^Xm, Md^Xm, Md^Xm, Md^Xm, Md^Xm, Md^Xm, Md^Xm, Md^Xm, Md^Xm, Md^Xm, Md^Xm, Md^Xm, Md^Xm, Md^Xm
Qxua, Qxua, Qxua, Qxua, Zwsl, Zwsl, Zvw, Zwsl, Zwsl^Ziff, Zwsl^Ziff, Zwsl, Zwsl, Zvw, Zgwl, Zwsl, Zwsl^Ziff, Zwsl^Ziff, Zwsl^Ziff, Zwsl^Ziff, Zwsl, Zwsl, Zvw, Zwsl, Zwsl, Zvw, Zvw, Zwsl, Zwsl, Zwsl^Zewc, Zwsl, Zwsl^Ziff, Zwsl^Ziff, Zwsl, Zvw, Zvw, Zvw, Zwsl, Zvw, Zvw, Zwsl, Zwsl, Uh, Uh, Md, Md, Md^Xm, Md^Xm, Md^Xm, Md^Xm, Md^Xm, Md^Xm, Md^Xm, Md^Xm, Md^Xm, Md^Xm, Md^Xm, Md^Xm, Md^Xm, Md^Xm, Md^Xm, Md^Xm, Md^Xm, Md^Xm, Md^Xm
Qxua, Qxua, Qxua, Zwsl, Zwsl^Zews, Zvw, Zwsl, Zwsl, Zwsl^Ziff, Zwsl^Ziff, Zwsl, Zwsl, Zwsl, Zvw, Zwsl, Zwsl^Ziff, Zwsl^Ziff, Zwsl^Ziff, Zwsl^Ziff, Zwsl, Zwsl^Zewt, Zvw, Zwsl, Zvw^Zews, Zwsl, Zvw^Vzps, Zvw, Zwsl, Zvw, Zwsl, Zwsl, Zwsl, Zwsl, Zvw, Zwsl, Zvw, Zwsl, Zwsl^Vzps, Zwsl, Zvw, Zwsl, Uh^Zewc, Md, Md, Md, Md, Md^Xm, Md^Xm, Md^Xm, Md^Xm, Md^Xm, Md^Xm, Md^Xm, Md^Xm, Md^Xm, Md^Xm, Md^Xm, Md^Xm, Md^Xm, Md^Xm, Md^Xm, Md^Xm, Md^Xm, Md^Xm
Qxua, Qxua, Qxua, Zwsl, Zwsl, Zvw, Zwsl, Zwsl, Zwsl^Ziff, Zwsl^Ziff, Zwsl^Ziff, Zwsl^Zewc, Zwsl, Zvw, Zvw, Zwsl, Zwsl^Ziff, Zwsl^Ziff, Zwsl^Ziff, Zwsl, Zwsl^Zewe, Zvw, Zvw, Zvw, Zwsl, Zwsl, Zwsl, Zvw, Zwsl, Zvw, Zvw, Zwsl, Zgwl, Zvw, Zwsl, Zwsl^Zewe, Zwsl, Zwsl, Zwsl^Zews, Zvw, Zvw, Uh, Md, Md, Md^Xm, Md^Xm, Md^Xm, Md^Xm, Md^Xm, Md^Xm, Md^Xm, Md^Xm, Md^Xm, Md^Xm, Md^Xm, Md^Xm, Md^Xm, Md^Xm, Md^Xm, Md^Xm, Md^Xm, Md^Xm, Md^Xm, Md^Xm
Qxua, Qxua, Qxua, Zwsl, Zwsl, Zvw^Vzps, Zvw, Zwsl^Zews, Zwsl, Zwsl^Ziff, Zwsl^Ziff, Zwsl, Zwsl, Zvw, Zwsl, Zwsl, Zwsl, Zwsl^Ziff, Zwsl^Ziff, Zwsl, Zwsl, Zwsl, Zvw, Zvw, Zwsl, Zwsl, Zwsl^Ziff, Zwsl, Zwsl, Zwsl^Zewt, Zvw, Zvw, Zvw, Zvw, Zvw, Zwsl, Zwsl^Ziff, Zwsl, Zwsl, Zwsl, Zwsl, Uh, Uh, Md, Md^Xm, Md^Xm, Md^Xm, Md^Xm, Md^Xm, Md^Xm, Md^Xm, Md^Xm, Md^Xm, Md^Xm, Md^Xm, Md^Xm, Md^Xm, Md^Xm, Md^Xm, Md^Xm, Md^Xm, Md^Xm, Md^Xm, Md^Xm
Qxua, Qxua, Qxua, Zwsl, Zwsl, Zwsl, Zvw, Zwsl, Zwsl, Zwsl^Ziff, Zwsl^Ziff, Zwsl, Zwsl, Zvw, Zwsl, Zwsl^Vzps, Zwsl^Zewt, Zwsl, Zwsl^Ziff, Zwsl^Ziff, Zwsl, Zwsl, Zwsl, Zvw, Zvw, Zwsl, Zwsl^Ziff, Zwsl^Ziff, Zwsl^Ziff, Zwsl, Zwsl, Zvw, Zvw, Zvw, Zvw, Zwsl, Zwsl, Zwsl^Ziff, Zwsl^Ziff, Zwsl, Zwsl, Zwsl, Uh, Md, Md, Md^Xm, Md^Xm, Md^Xm, Md^Xm, Md^Xm, Md^Xm, Md^Xm, Md^Xm, Md^Xm, Md^Xm, Md^Xm, Md^Xm, Md^Xm, Md^Xm, Md^Xm, Md^Xm, Md^Xm, Md^Xm, Md^Xm
Qxua, Qxua, Qxua, Qxua, Zwsl, Zwsl, Zvw, Zvw, Zwsl, Zwsl^Ziff, Zwsl^Ziff, Zwsl, Zwsl, Zvw, Zvw, Zwsl, Zwsl, Zwsl, Zwsl, Zwsl^Ziff, Zwsl^Ziff, Zwsl, Zvw, Zwsl, Zvw, Zvw, Zwsl, Zwsl^Ziff, Zwsl^Ziff, Zwsl^Ziff, Zwsl^Ziff, Zwsl, Zwsl, Zvw, Zvw, Zvw, Zwsl, Zwsl^Ziff, Zwsl^Ziff, Zwsl^Ziff, Zwsl^Zewt, Zwsl, Zwsl, Uh^Zewc, Md, Md, Md^Xm, Md^Xm, Md^Xm, Md^Xm, Md^Xm, Md^Xm, Md^Xm, Md^Xm, Md^Xm, Md^Xm, Md^Xm, Md^Xm, Md^Xm, Md^Xm, Md^Xm, Md^Xm, Md^Xm, Md^Xm
Qxua, Qxua, Qxua, Qxua, Zwsl, Zwsl^Zewe, Zvw, Zwsl, Zwsl, Zwsl^Ziff, Zwsl^Ziff, Zwsl, Zwsl^Zews, Zvw, Zvw, Zwsl, Zwsl^Zewc, Zwsl, Zwsl, Zwsl, Zwsl, Zwsl, Zwsl, Zvw, Zvw, Zvw, Zwsl, Zwsl^Ziff, Zwsl^Ziff, Zwsl^Ziff, Zwsl^Ziff, Zwsl, Zwsl, Zgwl, Chr, Chr, Chr, Zwsl, Zwsl, Zwsl^Ziff, Zwsl^Ziff, Zwsl, Zwsl^Ziff, Uh, Md, Md, Md^Xm, Md^Xm, Md^Xm, Md^Xm, Md^Xm, Md^Xm, Md^Xm, Md^Xm, Md^Xm, Md^Xm, Md^Xm, Md^Xm, Md^Xm, Md^Xm, Md^Xm, Md^Xm, Md^Xm, Md^Xm
Qxua, Qxua, Qxua, Qxua, Zwsl^Zewt, Zwsl, Zvw, Zwsl, Zwsl, Zwsl^Ziff, Zwsl, Zwsl, Zwsl, Zvw, Zvw, Zwsl, Zwsl, Zwsl, Zgwl, Zwsl, Zwsl^Ziff, Zwsl, Zwsl^Zews, Zvw, Zvw, Zvw, Zwsl, Zwsl^Zewe, Zwsl, Zwsl^Ziff, Zwsl, Zwsl^Ziff, Zwsl, Zwsl^Zewt, Chr, 4 Khr, Chr, Chr, Chr, Zwsl, Zwsl^Ziff, Zwsl^Ziff, Zwsl^Ziff, Uh, Uh, Md, Md, Md^Xm, Md^Xm, Md^Xm, Md^Xm, Md^Xm, Md^Xm, Md^Xm, Md^Xm, Md^Xm, Md^Xm, Md^Xm, Md^Xm, Md^Xm, Md^Xm, Md^Xm, Md^Xm, Md^Xm
Qxua, Qxua, Qxua, Qxua, Qxua, Zwsl, Zwsl, Zvw, Zvw, Zvw, Zvw, Zwsl, Zwsl, Zvw, Zvw, Zvw, Zwsl, Zwsl, Zwsl, Zwsl^Ziff, Zwsl^Ziff, Zwsl, Zwsl, Zwsl, Zwsl, Zvw^Vzps, Zvw, Zwsl, Zwsl, Zwsl^Ziff, Zwsl, Zwsl, Zwsl, Zwsl, Zwsl, Chr, Zvw, Chr, Chr, Zwsl, Zwsl, Zwsl^Ziff, Zwsl^Ziff, Zwsl, Uh, Md, Md, Md^Xm, Md^Xm, Md^Xm, Md^Xm, Md^Xm, Md^Xm, Md^Xm, Md^Xm, Md^Xm, Md^Xm, Md^Xm, Md^Xm, Md^Xm, Md^Xm, Md^Xm, Md^Xm, Md^Xm
Qxua, Qxua, Qxua, Qxua, Qxua, Zwsl, Zwsl, Zwsl, Zvw, Zwsl, Zwsl, Zwsl, Zwsl, Zwsl, Zvw, Zvw, Zvw, Zwsl, Zwsl, Zwsl, Zwsl^Ziff, Zwsl^Ziff, Zwsl^Ziff, Zwsl, Zwsl, Zwsl, Zwsl, Zvw, Zvw, Zwsl, Zvw, Zwsl^Zewt, Zwsl, Zwsl, Zwsl, Zvw, Zvw, Zwsl, Zwsl, Zvw, Zvw, Zwsl^Ziff, Zwsl^Ziff, Zwsl^Ziff, Zwsl, Uh, Md, Md, Md^Xm, Md^Xm, Md^Xm, Md^Xm, Md^Xm, Md^Xm, Md^Xm, Md^Xm, Md^Xm, Md^Xm, Md^Xm, Md^Xm, Md^Xm, Md^Xm, Md^Xm, Md^Xm
Qxua, Qxua, Qxua, Qxua, Qxua, Qxua, Zwsl, Zwsl, Zvw, Zvw^Zewc, Zvw, Zwsl^Zews, Zwsl, Zwsl, Zwsl, Zvw, Zwsl, Zwsl, Zwsl, Zwsl^Zewe, Zwsl, Zwsl^Ziff, Zwsl^Ziff, Zwsl^Ziff, Zwsl^Ziff, Zwsl^Ziff, Zwsl, Zwsl, Zwsl, Zvw, Zvw, Zvw, Zwsl^Ziff, Zwsl^Ziff, Zwsl^Ziff, Zwsl, Zwsl, Zvw, Zvw, Zwsl^Zews, Zvw^Zewt, Zwsl, Zwsl, Zwsl^Ziff, Zwsl, Uh, Uh, Md, Md^Xm, Md^Xm, Md^Xm, Md^Xm, Md^Xm, Xu, Xu, Xu, Xu, Xu, Xu, Xu, Xu, Xu, Xu, Xu
Qxua, Qxua, Qxua, Qxua, Qxua, Qxua, Qxua, Zwsl, Zwsl^Zewt, Zvw, Zvw, Zwsl, Zwsl, Zvw, Zvw, Zvw, Zvw, Zwsl^Zewc, Zwsl, Zwsl, Zwsl, Zwsl^Zewt, Zwsl, Zwsl^Ziff, Zwsl^Ziff, Zwsl^Ziff, Zwsl^Ziff, Zwsl, Zwsl^Zewc, Zwsl, Zvw, Zwsl, Zwsl^Ziff, Zwsl^Ziff, Zwsl^Ziff, Zwsl^Ziff, Zwsl^Ziff, Zwsl, Zwsl, Zvw, Zvw, Zvw, Zvw, Zwsl, Zwsl, Uh^Zewc, Uh, Md, Md^Xm, Md^Xm, Md^Xm, Md^Xm, Md^Xm, Xu, Xu, Xu, Xu, Xu, Uu, Ur, Ur, Xu, Xu, Xu
Qxua, Qxua, Qxua, Qxua, Qxua, Qxua, Zwsl, Zwsl, Zvw, Zwsl, Zwsl, Zwsl^Zewc, Zwsl, Zwsl, Zwsl, Zvw, Zvw, Zvw, Zvw, Zvw, Zvw, Zwsl, Zvw, Zwsl^Ziff, Zwsl, Zwsl^Ziff, Zwsl^Ziff, Zwsl, Zgwl, Zwsl, Zvw, Zwsl, Zwsl, Zwsl^Ziff, Zwsl^Ziff, Zwsl, Zwsl^Ziff, Zwsl, Zwsl, Zwsl, Zwsl, Zvw^Vzps, Zvw, Zvw, Zwsl, Uh, Md, Md, Md^Xm, Md^Xm, Md^Xm, Md^Xm, Md^Xm, Xu, Xu, Xu, Uu^Uf, Xu, Uu, Ur, Xu, Ur, Ur, Xu
Qxua, Qxua, Qxua, Qxua, Qxua, Zwsl, Zvw, Zvw, Zwsl, Zwsl, Zwsl, Zvw, Zvw, Zvw^Vzps, Zwsl, Zwsl, Zwsl^Zews, Zwsl, Zwsl, Zwsl, Zwsl, Zvw, Zwsl, Zvw, Zvw, Zwsl, Zwsl, Zwsl, Zwsl, Zwsl, Zvw, Zvw, Zwsl, Zwsl, Zwsl, Zwsl^Ziff, Zwsl^Ziff, Zwsl^Ziff, Zwsl^Ziff, Zwsl^Zews, Zwsl, Zwsl, Zvw, Zvw, Zvw, Uh, Md, Md, Md^Xm, Md^Xm, Md^Xm, Md^Xm, Md^Xm, Xu, Uh, Uh, Xu, Ur, Ur^Zews, Ur, Xu, Ur, Xu, Xu
Qxua, Qxua, Qxua, Qxua, Qxua^Bw/r, Qxua^Bw/r, Qxua, Zwsl, Zvw, Zvw, Zvw, Zwsl, Zwsl, Zvw, Zvw, Zwsl, Zwsl, Zwsl, Zwsl^Zewe, Zwsl, Zwsl, Zwsl, Zwsl, Zwsl, Zwsl, Zvw, Zvw, Zwsl, Zvw, Zwsl, Zvw, Zvw, Zwsl, Zwsl, Zwsl, Zwsl^Ziff, Zwsl^Ziff, Zwsl^Ziff, Zwsl^Ziff, Zwsl^Ziff, Zwsl, Zwsl^Zewt, Zwsl, Zvw, Zvw, Uh, Uh, Md, Md^Xm, Md^Xm, Md^Xm, Md^Xm, Md^Xm, Xu, Xu, Uh, Uu^Uf, Xu, Ur, Uu, Uu, Ur, Xu, Xu
Qxua, Qxua, Qxua^Bw/r, Qxua^Bw/r, Qxua, Qxua, Qxua, Qxua, Zvw, Zvw, Zwsl, Zvw, 1 Zvw, Zwsl, Zwsl, Zwsl, Zwsl, Zwsl, Zwsl, Zwsl^Ziff, Zwsl^Ziff, Zwsl^Ziff, Zwsl, Zwsl, Zwsl^Zews, Zwsl, Zvw, Zvw, Zwsl, Zvw, Zvw, Zvw, Zvw, Zwsl^Zewt, Zwsl, Zwsl, Zwsl, Zwsl^Ziff, Zwsl^Ziff, Zwsl^Ziff, Zwsl^Ziff, Zwsl, Zwsl, Zvw, Zvw, Uh, Uh, Md, Md, Md, Md^Xm, Md^Xm, Md^Xm, Xu, Xu, Uu^Uf, Uu^Uf, Ur, Xu, Uu, Xu, Ur, Ur, Xu
Qxua^Bw/r, Qxua^Bw/r, Qxua, Qxua, Qxua, Qxua, Qxua^Bw/r, Qxua^Bw/r, Qxua, Zvw, Zwsl, Zvw, Zwsl, Zwsl, Zwsl, Zwsl, Zwsl^Zewc, Zwsl, Zwsl, Zwsl, Zwsl^Ziff, Zwsl^Ziff, Zwsl^Ziff, Zwsl, Zwsl, Zwsl, Zwsl, Zvw, Zvw, Zwsl, Zvw, Zvw, Zvw^Vzps, Zvw, Zvw, Zwsl, Zwsl, Zwsl, Zwsl, Zwsl^Ziff, Zwsl, Zwsl, Zwsl, Zwsl^Zewt, Zvw, Zvw, Zvw, Uh, Uh, Md, Md, Md^Xm, Md^Xm, Xu, Xu, Xu, Xu, Ur, Ur, Xu, Xu, Ur^Zewc, Ur, Xu
Qxua, Qxua, Qxua, Qxua, Qxua^Bw/r, Qxua^Bw/r, Qxua, Qxua, Qxua, Qxua, Zvw, Zvw, Zvw, Zwsl, Zgwl, Zwsl, Zwsl, Zwsl, Zwsl, Zwsl, Zwsl, Zwsl^Ziff, Zwsl^Ziff, Zwsl^Ziff, Zwsl, Zwsl, Zwsl^Zewe, Zwsl, Zvw, Zwsl, Zwsl^Zewc, Zvw, Zvw, Zvw, Zvw, Zvw, Zvw, Zwsl^Zewt, Zwsl, Zwsl, Zwsl, Zwsl^Zewc, Zwsl, Zwsl, Zvw, Zvw, Zvw, Zwsl, Zwsl, Uh, Md, Md^Xm, Md^Xm, Xu, Xu, Xu, Xu, Uu, Ur, Xu, Xu, Ur, Xu, Xu
Aa, Qxua, Qxua^Bw/r, Qxua^Bw/r, Qxua, Qxua, Qxua, Qxua, Qxua^Bw/r, Qxua^Bw/r, Qxua, Zwsl, Zvw, Zwsl, Zwsl, Zvw, Zvw, Zwsl, Zwsl, Zwsl^Zewt, Zwsl, Zwsl, Zwsl, Zwsl^Ziff, Zwsl^Ziff, Zwsl, Zwsl, Zwsl, Zwsl, Zvw, Zvw, Zvw, Zwsl, Zvw, Zvw, Zvw, Zvw, Zvw, Zvw, Zgwl, Zwsl, Zwsl, Zwsl, Zwsl^Zews, Zvw, Zvw, Zwsl, Zvw, Zwsl, Uh, Md, Md^Xm, Md^Xm, Xu, Xu, Xu, Ur, Uu, Uu, Uu^Zewc, Uu, Ur, Xu, Xu
Aa, Zaw, Aa, Qxua, Qxua, Qxua, Qxua^Bw/r, Qxua^Bw/r, Qxua, Qxua, Qxua, Qxua, Zvw, Zwsl, Zwsl^Zews, Zwsl, Zvw, Zwsl, Zvw, Zwsl, Zwsl^Zews, Zwsl, Zwsl, Zwsl^Ziff, Zwsl^Ziff, Zwsl^Ziff, Zwsl^Ziff, Zwsl, Zwsl, Zwsl, Zvw, Zwsl, Zwsl, Zgwl, Zwsl, Zvw, Zwsl, Zvw, Zvw, Zvw, Zvw, Zwsl, Zwsl, Zwsl, Zvw, Zwsl, Zwsl, Zvw, Zwsl, Zwsl^Zewe, Zwsl, Md, Zwsl, Uu, Ur, Ur, Xu, Xu, Uu^Uf, Ur, Uu^Uf, Uu^Uf, Xu, Xu
Zaw, Zaw, Aa, Aa, Zaw, Qxua^Bw/r, Qxua, Qxua, Qxua, Qxua, Qxua, Qxua, Zvw, Zwsl, Zwsl, Zwsl, Zwsl, Zvw, Zvw, Zwsl, Zwsl, Zwsl, Zwsl^Zewt, Zwsl, Zwsl^Zewc, Zwsl^Ziff, Zwsl^Ziff, Zwsl, Zwsl, Zwsl, Zvw^Zewc, Zvw, Zwsl, Zwsl, Zwsl, Zwsl, Zwsl^Zews, Zwsl, Zwsl, Zvw, Zvw, Zvw, Zvw, Zvw, Zvw, Zwsl, Zwsl, Zvw, Zwsl, Zwsl, Md, Zwsl, Md^Xm, Xu, Xu, Xu, Xu, Xu, Uu^Uf, Uu^Uf, Xu, Xu, Xu, Xu
Zaw, Aa, Aa, Aa, Zaw^Zewt, Qxua, Qxua, Qxua, Qxua, Qxua, Qxua^Bw/r, Qxua^Bw/r, Qxua, Zvw, Zwsl, Zwsl, Zgwl, Zwsl, Zvw, Zvw^Vzps, Zwsl, Zwsl, Zwsl, Zwsl, Zwsl, Zwsl, Zwsl, Zwsl, Zwsl, Zwsl, Zvw, Zvw, Zwsl, Zwsl, Zwsl^Ziff, Zwsl, Zwsl, Zwsl, Zwsl, Zwsl, Zwsl, Zvw, Zvw, Zvw, Zwsl, Zwsl^Zewc, Zwsl, Zwsl, Zwsl, Uh, Uh, Md, Md^Xm, Xu, Xu, Xu, Xu, Xu, Xu, Xu, Xu, Xu, Xu, Xu
Zvw, Aa, Aa, Aa, Zaw, Aa, Qxua, Qxua, Qxua^Bw/r, Qxua^Bw/r, Qxua, Qxua, Qxua, Qxua, Qxua, Zwsl, Zwsl, Zwsl, Zwsl, Zvw, Zwsl, Zvw, Zvw, Zwsl, Zwsl, Zwsl, Zwsl, Zwsl, Zwsl^Zews, Zwsl, Zwsl, Zvw, Zwsl, Zwsl, Zwsl, Zwsl^Ziff, Zwsl, Zwsl, Zwsl, Zwsl^Zewc, Zwsl, Zvw, Zvw, Zwsl, Zwsl^Vzps, Zwsl, Zwsl, Zwsl, Zwsl^Ziff, Uh^Zewt, Uh, Md, Md, Md^Xm, Md^Xm, Md^Xm, Md^Xm, Md^Xm, Md^Xm, Md^Xm, Md^Xm, Md^Xm, Md^Xm, Md^Xm
Zvw, Zvw, Zvw, Aa, Zaw, Aa, Zaw, Qxua^Bw/r, Qxua, Qxua, Qxua, Qxua, Qxua, Qxua, Qxua, Qxua, Qxua, Zwsl, Zwsl, Zwsl, Zwsl, Zgwl, Zwsl, Zvw, Zvw, Zgwl, Zwsl, Zwsl, Zwsl, Zwsl, Zwsl, Zvw, Zwsl^Zewc, Zwsl, Zwsl^Ziff, Zwsl^Ziff, Zwsl^Ziff, Zwsl, Zwsl^Zewt, Zwsl, Zwsl, Zvw, Zvw, Zwsl, Zwsl, Zwsl, Zwsl, Zwsl^Ziff, Zwsl^Ziff, Zwsl^Ziff, Zwsl^Ziff, Uh^Zewt, Uh, Md, Md, Md^Xm, Md^Xm, Md^Xm, Md^Xm, Md^Xm, Md^Xm, Md^Xm, Md^Xm, Md^Xm
Zwsl, Zvw, Zwsl, Zvw, Zgwl, Zaw^Zewe, Aa, Aa, Qxua, Qxua, Qxua, Qxua, Qxua, Qxua, Qxua, Qxua, Qxua, Qxua, Qxua, Zwsl^Zewc, Zwsl, Zwsl, Zwsl^Zewe, Zwsl, Zvw, Zvw, Zvw, Zwsl, Zwsl^Zewe, Zwsl, Zwsl, Zvw, Zwsl, Zwsl, Zwsl, Zwsl^Ziff, Zwsl^Ziff, Zwsl^Ziff, Zwsl, Zwsl, Zwsl^Zewe, Zwsl, Zvw, Zwsl^Zewt, Zwsl, Zwsl, Zwsl^Zewe, Zwsl^Ziff, Zwsl^Ziff, Zwsl^Ziff, Zwsl^Ziff, Uh, Uh, Md, Md, Md^Xm, Md^Xm, Md^Xm, Md^Xm, Md^Xm, Md^Xm, Md^Xm, Md^Xm, Md^Xm
Zwsl, Zwsl, Aa, Zwsl, Aa, Zwsl, Aa, Aa, Qxua, Qxua, Qxua, Qxua, Qxua, Qxua, Qxua, Qxua, Qxua, Qxua, Qxua, Qxua, Qxua, Zwsl, Zwsl, Zwsl, Zvw, Zvw, Zvw, Zvw, Zvw, Zwsl, Zvw, Zvw, Zwsl, Zwsl, Zwsl, Zwsl, Zwsl, Zwsl^Ziff, Zwsl^Ziff, Zwsl, Zwsl, Zwsl, Zvw, Zvw, Zvw, Zwsl, Zwsl, Zwsl, Zwsl^Zewt, Zwsl^Ziff, Zwsl^Ziff, Zwsl^Ziff, Zwsl^Ziff, Uh, Md, Md^Xm, Md^Xm, Md^Xm, Md^Xm, Md^Xm, Md^Xm, Md^Xm, Md^Xm, Md^Xm
Aa, Zwsl, Aa, Aa, Aa, Aa, Aa, Aa, Qxua, Qxua, Qxua, Qxua, Qxua, Qxua, Qxua, Qxua, Qxua, Qxua, Qxua, Qxua, Qxua, Qxua, Qxua, Zwsl^Zewt, Zwsl, Zvw, Zwsl, Zvw, Zvw, Zvw, Zvw, Zwsl, Zwsl, Zgwl, Zwsl, Zwsl, Zwsl, Zwsl^Ziff, Zwsl^Ziff, Zwsl, Zwsl, Zwsl, Zvw, Zvw, Zvw, Zwsl, Zwsl, Zwsl, Zwsl, Zwsl, Zwsl^Ziff, Zwsl^Ziff, Zwsl, Uh, Md, Md^Xm, Md^Xm, Md^Xm, Md^Xm, Md^Xm, Md^Xm, Md^Xm, Md^Xm, Md^Xm
Aa, Aa, Aa, Aa, Aa, Aa, Aa, Aa, Qxua, Qxua, Qxua, Qxua, Qxua, Qxua, Qxua, Qxua, Qxua, Qxua, Qxua, Qxua, Qxua, Qxua, Qxua, Qxua, Qxua, Zwsl, Zwsl, Zwsl^Zewt, Zwsl, Zwsl^Vzps, Zwsl, Zvw, Zvw, Zwsl, Zwsl, Zwsl^Zews, Zwsl, Zwsl, Zwsl, Zwsl, Zwsl, Zwsl, Zwsl, Zvw, Zwsl, Zvw, Zvw, Zwsl, Zvw^Zews, Zwsl, Zwsl, Zwsl, Zwsl, Uh^Zewc, Md, Md, Md^Xm, Md^Xm, Md^Xm, Md^Xm, Md^Xm, Md^Xm, Md^Xm, Md^Xm
Aa, Aa, Aa, Aa, Aa, Aa, Aa, Qxua, Qxua, Qxua, Qxua, Qxua, Qxua, Qxua, Qxua, Qxua, Qxua, Qxua, Qxua, Qxua, Qxua, Qxua, Qxua, Qxua, Qxua, Qxua, Qxua, Zwsl, Zwsl, Zwsl, Zwsl, Zwsl, Zwsl, Zvw, Zvw, Zwsl, Zwsl^Zewt, Zwsl, Zwsl, Zwsl, Zwsl^Zewc, Zwsl, Zwsl, Zvw^Zews, Zvw, Zwsl^Vzps, Zvw, Zvw, Zwsl, Zvw, Zvw, Zwsl, Zvw, Uh, Uh, Md, Md, Md^Xm, Md^Xm, Md^Xm, Md^Xm, Md^Xm, Md^Xm, Md^Xm
Aa, Aa, Aa, Aa, Aa, Aa, Qxua, Qxua, Qxua, Qxua, Qxua, Qxua, Qxua, Qxua, Qxua, Qxua, Qxua, Qxua, Qxua, Qxua, Qxua, Qxua, Qxua, Qxua, Qxua, Qxua, Qxua, Qxua, Qxua, Qxua, Qxua, Zwsl, Zwsl, Zwsl, Zwsl, Zvw, Zwsl, Zwsl, Zwsl, Zwsl, Zwsl, Zwsl, Zwsl, Zwsl, Zwsl, Zvw, Zvw, Zwsl, Zwsl^Zewt, Zwsl, Zwsl, Zvw, Zwsl, Uh, Uh^Zewc, Md, Md, Md^Xm, Md^Xm, Md^Xm, Md^Xm, Md^Xm, Md^Xm, Md^Xm
Aa, Aa, Qxua, Aa, Qxua, Qxua, Qxua, Qxua, Qxua, Qxua, Qxua, Qxua, Qxua, Qxua, Qxua, Qxua, Qxua, Qxua, Qxua, Qxua, Qxua, Qxua, Qxua, Qxua, Qxua, Qxua, Qxua, Qxua, Qxua, Qxua, Qxua, Qxua, Zwsl, Zwsl, Zwsl^Zewc, Zvw, Zvw, Zwsl, Zwsl, Zwsl^Zews, Zwsl, Zwsl, Zwsl, Zwsl, Zwsl, Zwsl, Zwsl, Zwsl, Zwsl, Zwsl, Zwsl^Ziff, Zwsl, Zwsl^Ziff, Zwsl, Uh, Uh, Md, Md, Md^Xm, Md^Xm, Md^Xm, Md^Xm, Md^Xm, Md^Xm
Qxua, Qxua, Qxua, Qxua, Qxua, Qxua, Qxua, Qxua, Qxua, Qxua, Qxua, Qxua, Qxua, Qxua, Qxua, Qxua, Qxua, Qxua, Qxua, Qxua, Qxua, Qxua, Qxua, Qxua, Qxua, Qxua, Qxua, Qxua, Qxua, Qxua, Qxua, Qxua, Zwsl, Zwsl, Zwsl, Zwsl^Zewc, Zvw, Zwsl, Zwsl, Zwsl, Zwsl^Zewc, Zwsl^Ziff, Zwsl^Ziff, Zwsl, Zwsl^Ziff, Zwsl, Zwsl, Zwsl, Zwsl, Zwsl, Zwsl, Zwsl^Ziff, Zwsl^Ziff, Zwsl^Ziff, Zwsl, Uh, Uh, Md, Md, Md^Xm, Md^Xm, Md^Xm, Md^Xm, Md^Xm
Qxua, Qxua, Qxua, Qxua, Qxua, Qxua, Qxua, Qxua, Qxua, Qxua, Qxua, Qxua, Qxua, Qxua, Qxua, Qxua, Qxua, Qxua, Qxua, Qxua, Qxua, Qxua, Qxua, Qxua, Qxua, Qxua, Qxua, Qxua, Qxua, Qxua, Qxua, Qxua, Zwsl, Zwsl, Zwsl, Zwsl, Zvw, Zwsl, Zgwl, Zwsl, Zwsl, Zwsl, Zwsl, Zwsl^Ziff, Zwsl^Ziff, Zwsl^Ziff, Zwsl^Ziff, Zwsl^Zews, Zwsl, Zwsl, Zwsl, Zwsl^Ziff, Zwsl^Ziff, Zwsl^Ziff, Zwsl^Ziff, Zwsl, Uh, Md, Md, Md, Md^Xm, Md^Xm, Md^Xm, Md^Xm
Qxua, Qxua, Qxua, Qxua, Qxua, Qxua, Qxua, Qxua, Qxua, Qxua, Qxua, Qxua, Qxua, Qxua, Qxua, Qxua, Qxua, Qxua, Qxua, Qxua, Qxua, Qxua, Qxua, Qxua, Qxua, Qxua, Qxua, Qxua, Qxua, Qxua, Qxua, Qxua, Qxua, Zwsl, Qxua, Zwsl, Zwsl, Zwsl, Zwsl, Zwsl, Zwsl, Zwsl, Zwsl, Zwsl^Ziff, Zwsl^Ziff, Zwsl^Ziff, Zwsl^Ziff, Zwsl, Zwsl, Zwsl^Zewt, Zwsl, Zwsl, Zwsl, Zwsl^Ziff, Zwsl^Ziff, Zwsl, Uh, Uh, Uh, Md, Md, Md^Xm, Md^Xm, Md^Xm
Qxua, Qxua, Qxua, Qxua, Qxua, Qxua, Qxua, Qxua, Qxua, Qxua, Qxua, Qxua, Qxua, Qxua, Qxua, Qxua, Qxua, Qxua, Qxua, Qxua, Qxua, Qxua, Qxua, Qxua, Qxua, Qxua, Qxua, Qxua, Qxua, Qxua, Qxua, Qxua, Qxua, Qxua, Qxua, Qxua, Qxua, Qxua, Qxua, Zwsl, Zwsl, Zwsl^Vzps, Zwsl, Zwsl, Zwsl, Zwsl^Ziff, Zwsl^Ziff, Zwsl^Ziff, Zwsl, Zwsl, Zwsl, Zwsl, Zwsl^Zews, Zwsl, Zwsl, Zwsl, Zwsl, Uh, Uh^Zewc, Md, Md, Md^Xm, Md^Xm, Md^Xm
Qxua, Qxua, Qxua, Qxua, Qxua, Qxua, Qxua, Qxua, Qxua, Qxua, Qxua, Qxua, Qxua, Qxua, Qxua, Qxua, Qxua, Qxua, Qxua, Qxua, Qxua, Qxua, Qxua, Qxua, Qxua, Qxua, Qxua, Qxua, Qxua, Qxua, Qxua, Qxua, Qxua, Qxua, Qxua, Qxua, Qxua, Qxua, Qxua, Qxua, Zwsl, Zwsl, Zwsl, Zwsl, Zwsl^Zewt, Zwsl, Zwsl, Zwsl^Ziff, Zwsl, Zwsl^Zewe, Zwsl, Zwsl, Zwsl, Zwsl, Zwsl, Zwsl^Zewt, Zwsl, Uh, Uh, Md, Md, Md^Xm, Md^Xm, Md^Xm
Qxua, Qxua, Qxua, Qxua, Qxua, Qxua, Qxua, Qxua, Qxua, Qxua, Qxua, Qxua, Qxua, Qxua, Qxua, Qxua, Qxua, Qxua, Qxua, Qxua, Qxua, Qxua, Qxua, Qxua, Qxua, Qxua, Qxua, Qxua, Qxua, Qxua, Qxua, Qxua, Qxua, Qxua, Qxua, Qxua, Qxua, Qxua, Qxua, Qxua, Qxua, Zwsl, Zwsl, Zwsl, Zwsl, Zwsl, Zwsl, Zwsl, Zwsl, Zwsl, Zwsl, Zgwl, Zwsl, Zwsl, Zwsl^Zewc, Zwsl, Zwsl, Uh, Uh, Md, Md, Md^Xm, Md^Xm, Md^Xm
Qxua, Qxua, Qxua, Qxua, Qxua, Qxua, Qxua, Qxua, Qxua, Qxua, Qxua, Qxua, Qxua, Qxua, Qxua, Qxua, Qxua, Qxua, Qxua, Qxua, Qxua, Qxua, Qxua, Qxua, Qxua, Qxua, Qxua, Qxua, Qxua, Qxua, Qxua, Qxua, Qxua, Qxua, Qxua, Qxua, Qxua, Qxua, Qxua, Qxua, Qxua, Qxua, Qxua, Zwsl, Zwsl, Zwsl, Zwsl, Zwsl, Zwsl, Zwsl, Zwsl, Zwsl, Zwsl, Zwsl, Zwsl, Zwsl, Zwsl, Uh, Uh, Md, Md, Md^Xm, Md^Xm, Md^Xm
Qxua, Qxua, Qxua, Qxua, Qxua, Qxua, Qxua, Qxua, Qxua, Uu^Ii, Qxua, Qxua, Qxua, Qxua, Qxua, Qxua, Qxua, Qxua, Qxua, Qxua, Qxua, Qxua, Qxua, Qxua, Qxua, Qxua, Qxua, Qxua, Qxua, Qxua, Qxua, Qxua, Qxua, Qxua, Qxua, Qxua, Qxua, Qxua, Qxua, Qxua, Qxua, Qxua, Qxua, Qxua, Qxua, Zwsl, Zwsl, Zwsl, Zwsl^Zews, Zwsl, Zwsl, Zwsl^Zewe, Zwsl, Zwsl, Zwsl, Zwsl, Zwsl, Zwsl, Uh, Uh, Md, Md^Xm, Md^Xm, Md^Xm
Qxua, Qxua, Qxua, Qxua, Qxua, Qxua, Qxua, Qxua, Qxua, Qxua, Qxua, Qxua, Qxua, Qxua, Qxua, Qxua, Qxua, Qxua, Qxua, Qxua, Qxua, Qxua, Qxua, Qxua, Qxua, Qxua, Qxua, Qxua, Qxua, Qxua, Qxua, Qxua, Qxua, Qxua, Qxua, Qxua, Qxua, Qxua, Qxua, Qxua, Qxua, Qxua, Qxua, Qxua, Qxua, Qxua, Qxua, Zwsl, Zwsl, Zwsl, Zwsl, Zwsl, Zwsl, Zwsl, Zwsl, Zwsl, Zgwl, Zwsl, Zwsl, Uh, Md, Md, Md^Xm, Md^Xm
Qxua, Qxua, Qxua, Qxua, Qxua, Qxua, Qxua, Qxua, Qxua, Qxua, Qxua, Qxua, Qxua, Qxua, Qxua, Qxua, Qxua, Qxua, Qxua, Qxua, Qxua, Qxua, Qxua, Qxua, Qxua, Qxua, Qxua, Qxua, Qxua, Qxua, Qxua, Qxua, Qxua, Qxua, Qxua, Qxua, Qxua, Qxua, Qxua, Qxua, Qxua, Qxua, Qxua, Qxua, Qxua, Qxua, Qxua, Qxua, Zwsl, Zwsl, Zwsl, Zwsl, Zwsl, Zwsl, Zwsl, Zwsl, Zwsl, Zwsl, Zwsl, Uh, Md, Md, Md^Xm, Md^Xm
Qxua, Qxua, Qxua, Qxua, Qxua, Qxua, Qxua, Qxua, Qxua, Qxua, Qxua, Qxua, Qxua, Qxua, Qxua, Qxua, Qxua, Qxua, Qxua, Qxua, Qxua, Qxua, Qxua, Qxua, Qxua, Qxua, Qxua, Qxua, Qxua, Qxua, Qxua, Qxua, Qxua, Qxua, Qxua, Qxua, Qxua, Qxua, Qxua, Qxua, Qxua, Qxua, Qxua, Qxua, Qxua, Qxua, Qxua, Qxua, Zwsl, Zwsl, Zwsl, Zwsl, Zwsl, Zwsl, Zwsl, Zwsl, Zwsl, Zwsl, Zwsl, Uh, Uh, Md, Md^Xm, Md^Xm
