border_size=1
usage=map

Xu          , Xu          , Xu          , Xu          , Xu          , Xu          , Xu          , Xu          , Xu          , Xu          , Xu          , Xu          , Xu          , Xu          , Xu          , Xu          , Xu          , Xu          , Xu          , Xu          , Xu          , Xu          , Xu          , Xu          , Zic         , Zic         , Zic         , Zic         , Zic         , Zic         , Zic         , Zic         , Zic         , Zic         , Zic         , Zic         , Zic         , Zic         , Zic         , Zic         , Zic         , Zic         , Zic         , Zic         , Zic         , Zic         , Zic         , Zic         , Zic         , Zic         
Xu          , Xu          , Xu          , Xu          , Ql          , Mv          , Ql          , Xu          , Ql          , Ql          , Ql          , Xu          , Mv          , Xu          , Xu          , Xu          , Xu          , Xu          , Xu          , Xu          , Xu          , Xu          , Xu          , Xu          , Xu          , Zic         , Zic         , Zic         , Aa          , Zic         , Zic         , Zic         , Aa          , Zic         , Zic         , Zic         , Aa          , Aa          , Zaw         , Zic         , Zaw         , Zic         , Zic         , Zic         , Ai          , Ai          , Ai          , Zic         , Zic         , Zic         
Xu          , Xu          , Mv          , Ql          , Ql          , Ql          , Qlf         , Ql          , Qlf         , Qlf         , Qlf         , Ql          , Ql          , Ql          , Ql          , Mv          , Xu          , Xu          , Xu          , Xu          , Xu          , Xu          , Xu          , Xu          , Xu          , Zic         , Zic         , Zic         , Zaw         , Aa          , Zaw         , Zaw^Xis     , Zvw         , Zvw^Xis     , Zvw         , Zaw         , Zvw         , Zaw^Xis     , Zaw         , Zaw         , Zaw^Xis     , Aa          , Aa          , Ai          , Wwg         , Ai          , Ai          , Zic         , Zic         , Zic         
Xu          , Xu          , Ql          , Ql          , Qlf         , Qlf         , Cud         , Mv          , Cud         , Mv          , Qlf         , Qlf         , Qlf         , Qlf         , Qlf         , Ql          , Ql^Bs/      , Zvw         , Zvw         , Zvw         , Zvw         , Xu          , Zvw         , Xu          , Zvw         , Zaw         , Zaw         , Zaw^Vzps     , Zvw         , Zaw         , Zvw         , Zaw         , Zvw         , Zvw         , Ql          , Zvw         , Ql          , Zvw         , Xu          , Zaw         , Zaw         , Zaw^Xis     , Zaw^Xis     , Aa          , Aa          , Ai          , Ai          , Zic         , Zic         , Zic         
Xu          , Xu          , Ql          , Ql          , Qlf         , Mv          , Cud         , 2 Khr       , Cud         , Cud         , Zvw         , Zvw^Vzps     , Qlf         , Qlf         , Zvw         , Qlf^Bs/     , Qlf         , Ql          , Ql^Bs/      , Zvw         , Ql          , Zvw         , Zvw         , Zvw         , Zvw         , Zvw         , Zvw         , Zvw         , Xu          , Zvw         , Ql          , Ql          , Ql          , Ql          , Ql          , Ql^Bs|      , Ql          , Ql          , Ql          , Xu          , Zvw         , Zaw^Vzps     , Zaw         , Zaw^Xis     , Aa          , Aa          , Zic         , Zic         , Zic         , Zic         
Xu          , Xu          , Ql          , Ql          , Qlf         , Qlf         , Mv          , Cud         , Cud         , Zvw         , Zvw         , Zvw         , Qlf^Bs\     , Mv          , Zvw         , Zvw^Vzps     , Zvw         , Qlf^Bs/     , Qlf         , Ql          , Ql          , Ql          , Ql          , Ql          , Ql          , Zvw         , Ql          , Ql          , Ql          , Ql          , Ql          , Ql          , Ql          , Ql          , Ql^Bs/      , Zvw         , Ql          , Ql          , Ql          , Ql          , Ql^Bs/      , Zvw         , Zvw         , Zaw         , Zaw         , Aa          , Zic         , Zic         , Xu          , Zic         
Xu          , Xu          , Mv          , Ql          , Ql          , Qlf         , Qlf         , Qlf         , Qlf         , Zvw         , Qlf^Bs|     , Qlf         , Qlf         , Zvw         , Zvw         , Zvw         , Zvw         , Zvw         , Zvw         , Qlf         , Qlf         , Mv          , Ql          , Ql          , Ql          , Ql          , Ql          , Ql          , Ql          , Ql          , Xu          , Ql          , Xu          , Zvw         , Zvw         , Ql          , Ql          , Ql          , Ql^Bs/      , Zvw         , Ql          , Ql          , Ql          , Zvw         , Xu          , Xu          , Xu          , Xu          , Xu          , Xu          
Xu          , Xu          , Xu          , Ql          , Ql          , Ql          , Ql          , Qlf         , Qlf         , Qlf         , Zvw^Vzps     , Qlf         , Zvw         , Qlf^Bs/     , Mv          , Qlf         , Qlf^Bs/     , Zvw         , Qlf         , Qlf^Bs\     , Ql^Bs\      , Ql          , Zvw         , Ql          , Ql          , Ql          , Xu          , Xu          , Xu          , Xu          , Zic         , Zic         , Zaw         , Zvw         , Zaw         , Xu          , Zvw         , Zvw         , Zvw         , Ql          , Xu          , Ql          , Ql          , Ql          , Ql          , Xu          , Xu          , Xu          , Xu          , Xu          
Xu          , Xu          , Xu          , Xu          , Xu          , Ql          , Ql          , Ql          , Qlf^Bs/     , Zvw         , Zvw         , Zvw         , Qlf         , Qlf^Bs\     , Zvw         , Zvw         , Zvw         , Qlf         , Ql          , Ql          , Ql          , Zvw         , Zvw         , Zvw         , Xu          , Xu          , Zic         , Zic         , Zic         , Zic         , Zaw         , Zaw         , Zaw         , Zaw         , Zaw         , Zaw         , Zaw         , Zaw         , Zic         , Zvw         , Xu          , Xu          , Xu          , Ql          , Ql          , Ql          , Ql          , Xu          , Xu          , Xu          
Xu          , Xu          , Zic         , Xu          , Zic         , Xu          , Zaw         , Ql^Bs/      , Ql          , Qlf         , Qlf^Bs/     , Zvw         , Qlf         , Qlf         , Qlf         , Zvw         , Qlf^Bs\     , Qlf         , Ql          , Ql          , Zvw         , Zvw         , Zaw         , Zaw         , Zaw         , Zic         , Zic         , Zic         , Zaw^Xis     , Zaw^Xis     , Zaw         , Zaw         , Zic         , Zaw         , Zaw         , Zic         , Zic         , Zic         , Zic         , Zic         , Zic         , Xu          , Xu          , Xu          , Xu          , Ql          , Ql          , Xu          , Xu          , Xu          
Zic         , Zic         , Aa          , Zic         , Zaw         , Aa          , Zaw         , Zaw         , Zaw         , Ql^Bs/      , Ql          , Qlf         , Mv          , Qlf         , Ql          , Qlf         , Ql          , Ql^Bs\      , Zvw         , Zvw         , Zaw         , Zaw         , Zaw         , Zaw         , Zaw^Xis     , Zaw         , Zaw^Xis     , Zaw         , Zaw^Xis     , Zaw^Xis     , Aa          , Zic         , Zic         , Zic         , Zic         , Zic         , Zic         , Zic         , Zic         , Zic         , Zic         , Zic         , Xu          , Xu          , Xu          , Ql          , Ql          , Ql          , Ql          , Ql          
Zic         , Zic         , Aa          , Zaw         , Zaw^Xis     , Zaw^Xis     , Zaw         , Zaw         , Aa          , Xu          , Ql          , Ql          , Ql          , Ql          , Ql          , Ql          , Xu          , Ql          , Xu          , Zvw         , Zaw         , Zaw         , Zaw         , Zaw         , Zaw^Xis     , Zaw^Xis     , Zaw^Xis     , Zaw^Vzps     , Zaw^Xis     , Aa          , Aa          , Zic         , Zic         , Zic         , Zic         , Zic         , Zic         , Zic         , Zic         , Zic         , Zic         , Xu          , Xu          , Xu          , Xu          , Xu          , Ql          , Ql          , Ql          , Ql          
Zic         , Aa          , Zaw         , Zaw^Xis     , Zaw         , Zaw         , Zic         , Aa          , Zic         , Xu          , Ql          , Ql          , Ql          , Ql          , Xu          , Xu          , Xu          , Xu          , Zic         , Zic         , Zic         , Aa          , Aa          , Aa          , Aa          , Zaw         , Zaw         , Zaw^Xis     , Zaw         , Zaw         , Zaw         , Zic         , Aa          , Zic         , Aa          , Zic         , Zic         , Zic         , Zic         , Zic         , Xu          , Xu          , Xu          , Xu          , Xu          , Xu          , Ql          , Ql          , Ql          , Ql          
Zic         , Aa          , Zaw         , Zaw^Vzps     , Zaw         , Zic         , Zic         , Zic         , Xu          , Xu          , Ql          , Ql          , Xu          , Xu          , Xu          , Xu          , Xu          , Zic         , Ai          , Zic         , Ai          , Zic         , Zic         , Zic         , Zic         , Zic         , Zaw         , Zaw^Xis     , Zaw         , Zaw         , Zaw         , Zaw         , Zaw         , Aa          , Zaw         , Zaw         , Zaw         , Zaw         , Zaw         , Xu          , Xu          , Xu          , Xu          , Xu          , Xu          , Xu          , Ql          , Ql          , Xu          , Xu          
Zic         , Zaw         , Aa          , Zaw^Xis     , Zaw^Xis     , Zaw         , Zic         , Zic         , Zic         , Xu          , Ql          , Ql          , Xu          , Xu          , Xu          , Xu          , Zic         , Zic         , Ai          , Wwg         , Ai          , Aa          , Zaw         , Zaw^Xis     , Zaw^Xis     , Aa^Xis      , Zaw         , Zaw^Xis     , Zaw^Xis     , Aa          , Zaw         , Zaw         , Zaw         , Zaw^Vzps     , Zaw         , Zaw         , Xu          , Zaw         , Zvw         , Zvw         , Ql^Bs\      , Ql          , Ql          , Ql          , Ql          , Ql          , Ql          , Ql          , Xu          , Xu          
Zic         , Aa          , Aa          , Aa          , Ur          , Zaw^Xis     , Zaw^Xis     , Zic         , Zic         , Xu          , Ql          , Ql          , Ql          , Xu          , Xu          , Xu          , Zic         , Ai          , Ai          , Ai          , Aa          , Aa          , Zaw         , Zaw^Xis     , Zaw         , Zaw^Xis     , Zaw^Xis     , Zaw^Xis     , Zaw         , Zaw         , Zaw         , Zaw         , Zaw         , Zaw         , Zaw         , Zaw         , Xu          , Xu          , Ql          , Ql          , Ql          , Ur          , Ql          , Ql          , Zvw         , Ql          , Ql          , Xu          , Xu          , Zic         
Zic         , Aa          , Zic         , Zic         , Zic         , Ur^Xis      , Zaw         , Zic         , Xu          , Xu          , Xu          , Ql          , Xu          , Xu          , Xu          , Xu          , Zic         , Zic         , Ai          , Ai          , Aa          , Zic         , Zaw^Xis     , Zaw^Xis     , Zaw^Xis     , Zaw^Xis     , Zaw         , Zaw         , Aa          , Zaw         , Zic         , Zaw         , Zic         , Zaw         , Zvw         , Zvw         , Ql          , Ql          , Ql          , Ql          , Ql          , Ql^Bs|      , Ql          , Ql          , Zvw         , Zvw         , Xu          , Xu          , Zic         , Zic         
Zic         , Aa          , Zic         , Zic         , Zaw^Xis     , Ur^Xis      , Zaw         , Zic         , Xu          , Xu          , Xu          , Ql          , Ql          , Xu          , Zic         , Zic         , Aa          , Zic         , Zic         , Zic         , Zic         , Zic         , Zaw^Xis     , Zaw^Vzps     , Zaw^Xis     , Zaw         , Aa          , Aa          , Zic         , Zic         , Zic         , Zic         , Zic         , Xu          , Zvw         , Zvw         , Ql^Bs/      , Zaw         , Ql^Bs\      , Ql          , Zvw         , Zvw         , Zvw         , Zvw         , Aa          , Xu          , Xu          , Xu          , Zic         , Zic         
Zic         , Zic         , Zic         , Aa          , Zaw^Xis     , Zaw         , Zic         , Zic         , Xu          , Xu          , Ql          , Ql          , Ql          , Xu          , Zvw         , Zaw         , Zaw         , Aa          , Aa          , Aa          , Zaw         , Zaw^Xis     , Zaw^Xis     , Zaw^Xis     , Aa          , Aa          , Zic         , Zic         , Zic         , Zic         , Xu          , Xu          , Xu          , Xu          , Xu          , Zvw         , Ql          , Ql          , Zvw         , Zvw         , Aa          , Zaw         , Zaw         , Zaw         , Zaw         , Aa          , Zic         , Zic         , Zic         , Zic         
Zic         , Zic         , Aa          , Zaw^Xis     , Zaw^Vzps     , Zaw         , Zic         , Zic         , Xu          , Xu          , Xu          , Ql          , Ql          , Ql          , Zvw         , Zaw         , Zaw         , Zaw         , Zaw         , Zaw         , Zaw         , Zaw         , Zaw         , Aa          , Aa          , Zic         , Zic         , Zic         , Xu          , Xu          , Xu          , Xu          , Ql          , Xu          , Ql          , Ql          , Ql          , Ql          , Xu          , Zaw         , Aa          , Aa          , Zaw         , Aa          , Zaw         , Zaw         , Zaw^Vzps     , Zic         , Zic         , Zic         
Zic         , Aa          , Aa          , Zaw^Xis     , Zaw^Xis     , Zaw         , Zic         , Zic         , Zic         , Xu          , Zic         , Zvw         , Zvw         , Ql^Bs/      , Ql          , Xu          , Xu          , Zaw         , Zaw         , Zaw         , Zaw         , Zaw         , Aa          , Aa          , Zic         , Zic         , Xu          , Xu          , Xu          , Xu          , Ql          , Ql          , Ql          , Ql          , Ql          , Ql          , Xu          , Xu          , Zic         , Zic         , Zaw         , Zaw         , Aa          , Aa          , Zaw^Xis     , Zaw         , Zaw         , Zic         , Zic         , Zic         
Zic         , Zic         , Aa          , Zaw         , Zaw^Xis     , Zaw^Xis     , Aa          , Zic         , Aa          , Zic         , Zaw         , Zvw         , Zvw         , Ql          , Ql          , Ql          , Zvw         , Zaw         , Zaw         , Zaw         , Zaw         , Zaw         , Zic         , Zic         , Zic         , Zic         , Xu          , Xu          , Ql          , Ql          , Ql          , Ql          , Xu          , Ql          , Xu          , Xu          , Zic         , Zic         , Zaw         , Zaw         , Zaw^Xis     , Zaw         , Zaw         , Aa          , Zaw         , Zaw         , Zic         , Zic         , Zic         , Zic         
Zic         , Zic         , Zic         , Zaw         , Zaw         , Zaw^Xis     , Zaw^Xis     , Aa          , Zaw^Xis     , Zaw         , Zaw         , Zaw         , Zaw         , Zvw         , Zvw         , Ql          , Zvw         , Zaw         , Zaw         , Zaw         , Zic         , Zic         , Zic         , Zic         , Xu          , Xu          , Xu          , Xu          , Ql          , Ql          , Xu          , Xu          , Xu          , Xu          , Zic         , Zic         , Zaw^Vzps     , Zaw         , Zaw^Xis     , Zaw^Xis     , Zaw         , Zaw^Xis     , Zaw         , Zaw         , Zic         , Zic         , Zic         , Zic         , Zic         , Zic         
Zic         , Zic         , Zic         , Zic         , Zic         , Aa          , Aa          , Zaw^Xis     , Zaw         , Zaw         , Zaw         , Zaw         , Zaw         , Zvw         , Zvw         , Ql^Bs/      , Ql          , Zvw         , Zvw         , Zaw         , Zic         , Xu          , Xu          , Xu          , Xu          , Xu          , Xu          , Xu          , Ql          , Ql          , Xu          , Xu          , Zic         , Zic         , Zic         , Zic         , Zaw         , Zaw^Xis     , Zaw^Xis     , Zaw         , Zaw         , Aa          , Aa          , Zic         , Zic         , Zic         , Zic         , Zic         , Zic         , Zic         
Zic         , Zic         , Zic         , Zic         , Zic         , Zic         , Aa          , Zaw^Xis     , Zaw^Xis     , Zaw         , Zaw         , Zaw         , Aa          , Zaw         , Xu          , Ql          , Ql          , Xu          , Xu          , Zic         , Xu          , Xu          , Xu          , Xu          , Ql          , Xu          , Ql          , Ql          , Ql          , Ql          , Xu          , Xu          , Zic         , Zic         , Zaw         , Zaw         , Zaw^Xis     , Zaw^Xis     , Zaw         , Zaw         , Zic         , Aa          , Ai          , Zic         , Ai          , Zic         , Zic         , Zic         , Zic         , Zic         
Zic         , Zic         , Zic         , Zic         , Zic         , Aa          , Aa          , Zaw         , Zaw         , Zaw^Vzps     , Zaw         , Aa          , Aa          , Aa          , Zic         , Xu          , Xu          , Ql          , Ql          , Xu          , Xu          , Zvw         , Ql          , Ql          , Ql          , Ql          , Ql          , Ql          , Xu          , Xu          , Xu          , Zic         , Zic         , Zic         , Zaw^Xis     , Zaw         , Zaw^Xis     , Zaw         , Zic         , Zic         , Zic         , Ai          , Ai          , Ai          , Wwg         , Ai          , Zic         , Zic         , Zic         , Zic         
Zic         , Zic         , Zic         , Zic         , Zic         , Aa          , Aa          , Zaw         , Zaw         , Zaw         , Zaw         , Aa          , Zic         , Zic         , Zic         , Zic         , Xu          , Xu          , Xu          , Ql          , Ql          , Ql          , Ql          , Ql          , Xu          , Ql          , Xu          , Xu          , Xu          , Xu          , Xu          , Zic         , Zic         , Zaw         , Zaw^Xis     , Zaw         , Zaw         , Zic         , Zic         , Zic         , Zic         , Zic         , Zic         , Ai          , Ai          , Ai          , Ai          , Zic         , Zic         , Zic         
Zic         , Zic         , Zic         , Zic         , Zic         , Zic         , Zaw         , Zaw         , Zaw         , Zaw         , Zic         , Zic         , Xu          , Zic         , Xu          , Xu          , Xu          , Xu          , Ql          , Ql          , Xu          , Xu          , Xu          , Xu          , Uu          , Xu          , Xu          , Xu          , Xu          , Xu          , Zic         , Zic         , Zic         , Zaw         , Zaw^Xis     , Zaw         , Zic         , Zic         , Zic         , Zic         , Zic         , Zic         , Aa^Xis      , Aa^Xis      , Aa^Xis      , Aa          , Aa          , Zic         , Zic         , Zic         
Zic         , Zic         , Zic         , Zic         , Xu          , Zaw         , Zaw         , Zaw         , Zaw         , Zaw         , Xu          , Xu          , Xu          , Xu          , Xu          , Xu          , Xu          , Ql          , Ql          , Xu          , Xu          , Xu          , Uu          , Ur          , Ur          , Ur          , Ur          , Xu          , Xu          , Zic         , Zic         , Zic         , Aa          , Zaw         , Zaw         , Zaw^Vzps     , Zic         , Zic         , Zic         , Zic         , Zic         , Zic         , Zaw^Xis     , Zaw^Xis     , Zic         , Zic         , Zic         , Zic         , Zic         , Zic         
Zic         , Zic         , Zic         , Xu          , Xu          , Zaw         , Zaw         , Zaw         , Zvw         , Zvw         , Xu          , Xu          , Xu          , Xu          , Xu          , Xu          , Ql          , Ql          , Xu          , Xu          , Xu          , Uu          , Ur          , Uu          , Ur          , Ur^Vzps      , Ur          , Ur          , Ur          , Ur          , Ur          , Uu          , Uu^Xis      , Zaw         , Zaw^Xis     , Zaw^Xis     , Zaw         , Zic         , Zic         , Zic         , Zaw         , Zaw^Xis     , Zaw^Xis     , Zaw         , Zic         , Zic         , Zic         , Zic         , Zic         , Zic         
Zic         , Zic         , Xu          , Xu          , Zvw         , Zaw         , Zvw         , Zvw         , Zaw         , Xu          , Xu          , Xu          , Ql          , Ql          , Ql          , Ql          , Ql          , Ql          , Xu          , Xu          , Ur          , Ur          , Ur          , Ur          , Ur          , Ur          , Ur          , Ur          , Ur          , Ur          , Ur          , Uu          , Uu^Xis      , Uu          , Aa          , Zaw^Xis     , Zaw^Xis     , Zaw^Xis     , Zaw^Xis     , Zaw^Xis     , Zaw^Xis     , Zaw         , Zaw         , Zaw         , Zaw         , Zic         , Zic         , Zic         , Zic         , Zic         
Xu          , Xu          , Xu          , Zaw         , Zaw         , Zvw         , Zvw         , Zvw         , Zvw         , Xu          , Ql          , Ql          , Ql          , Ql          , Ql          , Ql          , Xu          , Xu          , Xu          , Uu          , Uu          , Uu          , Xu          , Xu          , Xu          , Ur          , Ur          , Ur          , Ur          , Ur          , Zic         , Zic         , Zic         , Aa          , Aa          , Zaw         , Aa          , Zaw         , Zaw         , Zaw         , Zic         , Zaw         , Zaw         , Zaw^Xis     , Zaw^Xis     , Zaw         , Zaw         , Zic         , Zic         , Zic         
Xu          , Xu          , Xu          , Zaw         , Zvw^Vzps     , Zvw         , Zaw         , Zvw         , Zvw         , Zvw         , Ql^Bs/      , Zvw         , Ql^Bs\      , Ql          , Zvw         , Zvw         , Zvw         , Xu          , Zvw         , Zvw         , Zvw         , Zvw         , Xu          , Xu          , Xu          , Ur          , Ur          , Ur          , Xu          , Zic         , Zic         , Zic         , Zic         , Zic         , Zic         , Aa          , Zic         , Aa          , Zic         , Zic         , Zic         , Zaw         , Zaw^Xis     , Zaw         , 1 Zaw^Xis   , Zaw^Xis     , Zaw         , Zic         , Zic         , Zic         
Xu          , Xu          , Zaw         , Zvw         , Zaw         , Zaw         , Zvw         , Zvw         , Zvw         , Zvw         , Ql          , Ql          , Ql^Bs/      , Zvw         , Zvw         , Zvw         , Zvw         , Zvw         , Zvw         , Zvw         , Zvw         , Zvw         , Ur          , Xu          , Xu          , Xu          , Xu          , Xu          , Xu          , Zic         , Zic         , Zic         , Zic         , Zic         , Zic         , Zic         , Zic         , Zic         , Zic         , Zic         , Zic         , Zaw         , Zaw         , Zaw^Xis     , Zaw         , Zaw^Xis     , Zaw^Xis     , Zaw         , Zic         , Zic         
Xu          , Xu          , Zvw         , Zvw         , Zvw         , Zvw         , Zvw         , Zvw         , Zvw         , Zvw         , Ql^Bs/      , Ur          , Ql          , Ql          , Zvw         , Zvw         , Zvw         , Zvw^Vzps     , Zvw         , Zvw         , Zvw         , Zvw         , Xu          , Xu          , Xu          , Xu          , Xu          , Xu          , Xu          , Zic         , Zic         , Zic         , Zic         , Zic         , Zic         , Zic         , Zic         , Zic         , Zic         , Zic         , Zic         , Zaw         , Zaw         , Zaw         , Zaw         , Zaw^Xis     , Zaw^Xis     , Zaw         , Zic         , Zic         
Xu          , Xu          , Xu          , Zvw         , Zaw         , Zaw         , Xu          , Zvw         , Zvw         , Zvw         , Ql          , Ql          , Ql          , Ql          , Zvw         , Zvw         , Xu          , Xu          , Xu          , Zvw         , Xu          , Zvw         , Xu          , Xu          , Xu          , Xu          , Xu          , Xu          , Zic         , Zic         , Zic         , Zic         , Zic         , Zic         , Zic         , Zic         , Zic         , Zic         , Zic         , Zic         , Zic         , Zic         , Zic         , Zaw         , Zaw         , Zaw^Xis     , Zaw^Xis     , Zaw         , Zic         , Zic         
Xu          , Xu          , Xu          , Xu          , Xu          , Xu          , Xu          , Xu          , Xu          , Zvw         , Ql          , Ql          , Ql          , Ql          , Xu          , Zvw         , Xu          , Xu          , Xu          , Xu          , Xu          , Xu          , Xu          , Xu          , Xu          , Xu          , Xu          , Xu          , Xu          , Zic         , Zic         , Zic         , Zic         , Zic         , Zic         , Zic         , Zic         , Zic         , Zic         , Zic         , Zic         , Zic         , Zic         , Zic         , Zic         , Zaw         , Zaw         , Zaw         , Zic         , Zic         
Xu          , Xu          , Xu          , Xu          , Xu          , Xu          , Xu          , Xu          , Xu          , Xu          , Xu          , Ql          , Ql          , Ql          , Xu          , Xu          , Xu          , Xu          , Xu          , Xu          , Xu          , Xu          , Xu          , Xu          , Xu          , Xu          , Xu          , Xu          , Xu          , Zic         , Zic         , Zic         , Zic         , Zic         , Zic         , Zic         , Zic         , Zic         , Zic         , Zic         , Zic         , Zic         , Zic         , Zic         , Zic         , Zic         , Zaw         , Zaw         , Zic         , Zic         
Xu          , Xu          , Zaw         , Xu          , Xu          , Xu          , Xu          , Xu          , Xu          , Xu          , Xu          , Ql          , Ql          , Ql          , Xu          , Xu          , Xu          , Xu          , Xu          , Xu          , Xu          , Xu          , Xu          , Xu          , Xu          , Xu          , Xu          , Xu          , Xu          , Zic         , Zic         , Zic         , Zic         , Zic         , Zic         , Zic         , Zic         , Zic         , Zic         , Zic         , Zic         , Zic         , Zic         , Zic         , Zic         , Zic         , Zaw         , Zic         , Zic         , Zic         
