border_size=1
usage=map

Xol         , Xol         , Xol         , Xol         , Xol         , Xol         , Xol         , Xol         , Xol         , Xol         , Xol         , Xol         , Xol         , Xol         , Xol         , Xol         , Xol         , Xol         , Xol         , Xol         , Xol         , Xol         , Xol         , Xol         , Xol         , Xol         , Xol         , Xol         , Xol         , Xol         , Xol         , Xol         , Xol         , Xol         , Xol         , Xol         , Xol         , Xol         , Xol         , Xol         , Xol         , Xol         , Xol         , Xol         , Xol         , Xol         
Xol         , Xol         , Xol         , Xol         , Xol         , Xol         , Xol         , Xol         , Urb         , Xol         , Xol         , Xol         , Xol         , Xol         , Xol         , Xol         , Xol         , Xol         , Xol         , Xol         , Xol         , Xol         , Xol         , Xol         , Xol         , Xol         , Xol         , Xol         , Xol         , Xol         , Xol         , Xol         , Xol         , Xol         , Xol         , Xol         , Xol         , Xol         , Xol         , Xol         , Xol         , Xol         , Xol         , Xol         , Xol         , Xol         
Xol         , Xol         , Xol         , Xol         , Xol         , Xol         , Urb         , Urb         , Urb         , Urb         , Urb         , Xol         , Urb         , Urb         , Urb         , Urb         , Urb         , Xol         , Urb         , Urb         , Urb         , Urb^Vzps     , Urb         , Xol         , Xol         , Xol         , Xol         , Xol         , Xol         , Xol         , Xol         , Xol         , Xol         , Xol         , Xol         , Xol         , Xol         , Xol         , Xol         , Xol         , Xol         , Xol         , Xol         , Xol         , Xol         , Xol         
Xol         , Xol         , Xol         , Xol         , Urb         , Urb         , Urb         , Urb         , Urb         , Urb         , Urb^Vzps     , Urb         , Urb         , Xol         , Urb         , Urb         , Urb         , Urb         , Urb         , Urb         , Urb         , Urb         , Urb         , Urb         , Urb         , Xol         , Urb         , Xol         , Urb         , Xol         , Xol         , Xol         , Xol         , Xol         , Xol         , Xol         , Xol         , Xol         , Xol         , Xol         , Xol         , Xol         , Xol         , Xol         , Xol         , Xol         
Xol         , Xol         , Xol         , Xol         , Urb         , Urb         , Urb         , Urb         , Urb         , Urb         , Urb         , Urb         , Urb         , Urb         , Xol         , Xol         , Xol         , Xol         , Urb         , Urb         , Urb         , Urb         , Urb         , Urb         , Urb         , Urb         , Urb         , Urb         , Xol         , Xol         , Xol         , Xol         , Xol         , Xol         , Xol         , Xol         , Xol         , Xol         , Xol         , Xol         , Xol         , Xol         , Xol         , Xol         , Xol         , Xol         
Xol         , Xol         , Xol         , Xol         , Urb         , Urb         , Urb         , Urb         , Urb         , Urb         , Xol         , Xol         , Xol         , Urb         , Xol         , Xol         , Urb         , Urb         , Urb         , Urb         , Urb         , Urb         , Xol         , Urb         , Xol         , Urb         , Urb         , Xol         , Urb^Vzps     , Xol         , Xol         , Xol         , Xol         , Xol         , Xol         , Xol         , Xol         , Xol         , Xol         , Xol         , Xol         , Xol         , Xol         , Xol         , Xol         , Xol         
Xol         , Xol         , Xol         , Xol         , Urb         , Urb         , Xol         , Urb         , Urb         , Xol         , Xol         , Xol         , Urb         , Urb         , Urb         , Urb         , Urb         , Urb         , Xol         , Xol         , Urb         , Urb         , Urb         , Xol         , Xol         , Xol         , Urb         , Urb         , Urb         , Urb         , Xol         , Xol         , Xol         , Xol         , Xol         , Xol         , Xol         , Xol         , Xol         , Xol         , Xol         , Xol         , Xol         , Xol         , Xol         , Xol         
Xol         , Xol         , Xol         , Urb^Vzps     , Urb         , Xol         , Xol         , Urb         , Xol         , Urb         , Urb         , Urb         , Urb         , Xol         , Urb         , Urb         , Xol         , Xol         , Xol         , Xol         , Xol         , Urb         , Urb         , Urb         , Urb         , Urb         , Urb         , Urb         , Xol         , Urb         , Xol         , Xol         , Xol         , Xol         , Xol         , Xol         , Xol         , Xol         , Xol         , Xol         , Xol         , Xol         , Xol         , Xol         , Xol         , Xol         
Xol         , Xol         , Xol         , Urb         , Urb         , Xol         , Urb         , Xol         , Xol         , Xol         , Xol         , Urb         , Urb         , Urb         , Urb         , Urb         , Xol         , Xol         , Xol         , Xol         , Xol         , Xol         , Urb         , Urb         , Urb         , Xol         , Urb         , Urb         , Urb         , Xol         , Xol         , Xol         , Xol         , Xol         , Xol         , Xol         , Xol         , Xol         , Urb         , Xol         , Xol         , Xol         , Xol         , Xol         , Xol         , Xol         
Xol         , Xol         , Xol         , Urb         , Urb         , Urb         , Urb         , Urb         , Urb         , Urb         , Urb         , Urb         , Urb         , Urb         , Urb         , Urb^Vzps     , Xol         , Xol         , Xol         , Xol         , Xol         , Urb         , Urb         , Urb         , Xol         , Urb         , Urb         , Urb         , Urb         , Xol         , Xol         , Xol         , Xol         , Xol         , Xol         , Xol         , Urb         , Urb         , Urb         , Urb         , Urb         , Xol         , Xol         , Xol         , Xol         , Xol         
Xol         , Xol         , Xol         , Xol         , Xol         , Urb         , Xol         , Xol         , Urb         , Urb         , Urb         , Urb         , Urb         , Urb         , Urb         , Xol         , Xol         , Xol         , Xol         , Xol         , Xol         , Urb^Vzps     , Urb         , Urb         , Urb         , Urb         , Urb         , Urb         , Urb         , Urb         , Urb         , Xol         , Urb^Vzps     , Xol         , Urb         , Urb         , Urb         , Urb         , Urb         , Urb         , Urb         , Urb         , Urb         , Xol         , Xol         , Xol         
Xol         , Xol         , Xol         , Xol         , Xol         , Xol         , Xol         , Urb         , Xol         , Urb         , Urb         , Urb         , Urb         , Urb         , Urb         , Urb         , Urb         , Xol         , Xol         , Xol         , Xol         , Xol         , Xol         , Urb         , Urb         , Urb         , Urb         , Urb         , Urb         , Urb         , Urb         , Urb         , Urb         , Urb         , Urb         , Urb         , Urb         , Urb         , Urb         , Urb         , 1 Urb       , Urb         , Urb         , Urb         , Urb         , Xol         
Xol         , Xol         , Xol         , Xol         , Xol         , Xol         , Xol         , Xol         , Xol         , Xol         , Xol         , Urb         , Urb         , Urb         , Urb         , Urb         , Urb         , Urb         , Urb         , Xol         , Xol         , Xol         , Xol         , Xol         , Xol         , Urb         , Urb         , Xol         , Urb         , Urb         , Urb         , Urb         , Urb         , Urb         , Urb         , Urb         , Urb         , Urb         , Urb         , Urb         , Urb         , Urb         , Urb         , Urb         , Urb         , Urb         
Xol         , Xol         , Xol         , Xol         , Xol         , Xol         , Xol         , Xol         , Xol         , Xol         , Xol         , Xol         , Xol         , Urb         , Urb         , Urb         , Urb         , Urb         , Xol         , Urb         , Urb         , Xol         , Xol         , Xol         , Xol         , Xol         , Xol         , Xol         , Xol         , Urb         , Urb         , Urb         , Xol         , Xol         , Xol         , Urb         , Urb         , Urb         , Urb         , Urb         , Urb         , Urb         , Urb         , Urb         , Xol         , Urb         
Xol         , Xol         , Xol         , Xol         , Xol         , Xol         , Urb         , Urb         , Urb         , Urb         , Xol         , Xol         , Xol         , Xol         , Xol         , Urb         , Urb         , Urb         , Urb         , Xol         , Urb         , Xol         , Xol         , Xol         , Xol         , Xol         , Xol         , Xol         , Xol         , Xol         , Xol         , Xol         , Xol         , Xol         , Xol         , Xol         , Xol         , Urb         , Urb         , Urb         , Urb         , Urb         , Xol         , Xol         , Xol         , Xol         
Xol         , Xol         , Xol         , Xol         , Xol         , Xol         , Urb         , Urb         , Urb         , Urb         , Urb         , Urb         , Urb         , Xol         , Urb         , Urb         , Xol         , Urb         , Urb         , Urb         , Urb^Vzps     , Xol         , Xol         , Xol         , Xol         , Xol         , Xol         , Xol         , Xol         , Xol         , Xol         , Xol         , Xol         , Xol         , Xol         , Xol         , Xol         , Urb         , Xol         , Xol         , Xol         , Xol         , Xol         , Xol         , Xol         , Xol         
Xol         , Xol         , Xol         , Xol         , Xol         , Xol         , Urb^Vzps     , Urb         , Xol         , Xol         , Urb         , Urb         , Xol         , Urb         , Xol         , Urb         , Xol         , Xol         , Xol         , Urb         , Xol         , Xol         , Urb         , Xol         , Xol         , Xol         , Xol         , Xol         , Xol         , Urb         , Urb         , Urb         , Xol         , Xol         , Xol         , Xol         , Xol         , Xol         , Xol         , Xol         , Xol         , Xol         , Xol         , Xol         , Xol         , Xol         
Xol         , Xol         , Xol         , Xol         , Xol         , Xol         , Urb         , Urb         , Urb         , Xol         , Xol         , Urb         , Urb         , Xol         , Xol         , Xol         , Urb         , Urb         , Urb         , Urb         , Urb         , Urb         , Urb         , Urb         , Urb         , Urb         , Urb         , Urb         , Urb         , Urb         , Xol         , Urb         , Xol         , Urb         , Urb         , Xol         , Xol         , Xol         , Xol         , Xol         , Xol         , Xol         , Xol         , Xol         , Xol         , Xol         
Xol         , Xol         , Xol         , Xol         , Xol         , Xol         , Xol         , Urb         , Urb         , Urb         , Urb         , Xol         , Urb         , Urb         , Urb         , Urb         , Urb         , Xol         , Urb         , Urb         , Urb         , Xol         , Xol         , Urb         , Xol         , Xol         , Urb         , Urb         , Xol         , Xol         , Urb         , Xol         , Urb         , Xol         , Urb         , Urb         , Urb         , Xol         , Xol         , Xol         , Xol         , Xol         , Xol         , Xol         , Xol         , Xol         
Xol         , Xol         , Xol         , Xol         , Xol         , Xol         , Xol         , Xol         , Xol         , Urb         , Urb         , Urb         , Urb         , Urb         , Urb         , Urb         , Urb         , Urb         , Urb         , Xol         , Urb         , Urb         , Urb^Vzps     , Xol         , Xol         , Urb         , Urb         , Xol         , Urb^Vzps     , Xol         , Xol         , Urb         , Xol         , Xol         , Xol         , Urb         , Urb         , Urb         , Xol         , Xol         , Xol         , Xol         , Xol         , Xol         , Xol         , Xol         
Xol         , Xol         , Xol         , Xol         , Xol         , Xol         , Xol         , Xol         , Xol         , Xol         , Xol         , Urb         , Urb         , Urb         , Urb^Vzps     , Xol         , Xol         , Urb         , Urb         , Urb         , Urb         , Urb         , Urb         , Urb         , Urb         , Urb         , Xol         , Urb         , Urb         , Urb         , Urb         , Urb         , Urb         , Xol         , Urb         , Urb         , Urb         , Xol         , Xol         , Xol         , Xol         , Xol         , Xol         , Xol         , Xol         , Xol         
Xol         , Xol         , Xol         , Xol         , Xol         , Xol         , Xol         , Xol         , Xol         , Xol         , Xol         , Xol         , Xol         , Xol         , Xol         , Xol         , Xol         , Xol         , Xol         , Urb         , Xol         , Urb         , Urb         , Urb         , Urb         , Urb         , Urb         , Xol         , Urb         , Urb         , Urb         , Urb         , Urb^Vzps     , Urb         , Urb         , Urb         , Urb         , Urb         , Urb         , Xol         , Xol         , Xol         , Xol         , Xol         , Xol         , Xol         
Xol         , Xol         , Xol         , Xol         , Xol         , Xol         , Xol         , Xol         , Xol         , Xol         , Xol         , Xol         , Xol         , Xol         , Xol         , Xol         , Urb         , Xol         , Xol         , Xol         , Xol         , Xol         , Xol         , Urb         , Xol         , Urb         , Urb         , Urb         , Xol         , Urb         , Urb         , Urb         , Urb         , Urb         , Urb         , Xol         , Urb         , Urb         , Urb         , Cud         , Xol         , Xol         , Xol         , Xol         , Xol         , Xol         
Xol         , Xol         , Xol         , Xol         , Xol         , Xol         , Xol         , Xol         , Xol         , Xol         , Urb         , Xol         , Urb         , Xol         , Urb         , Urb         , Xol         , Urb         , Urb         , Xol         , Xol         , Xol         , Xol         , Xol         , Xol         , Xol         , Urb         , Urb         , Urb         , Urb         , Xol         , Xol         , Xol         , Urb         , Xol         , Urb         , Urb         , Urb         , Urb         , Cud         , Xol         , Xol         , Xol         , Xol         , Xol         , Xol         
Xol         , Xol         , Xol         , Xol         , Xol         , Xol         , Xol         , Xol         , Urb         , Urb         , Xol         , Urb         , Urb         , Urb         , Urb         , Xol         , Xol         , Urb         , Urb         , Urb         , Urb         , Xol         , Urb         , Xol         , Xol         , Urb         , Urb         , Urb         , Xol         , Xol         , Xol         , Urb         , Urb         , Urb         , Urb         , Xol         , Urb         , Xol         , Urb         , Cud         , Xol         , Xol         , Xol         , Xol         , Xol         , Xol         
Xol         , Xol         , Xol         , Xol         , Xol         , Xol         , Xol         , Urb         , Xol         , Xol         , Xol         , Urb         , Urb         , Xol         , Xol         , Urb         , Urb^Vzps     , Urb         , Xol         , Xol         , Xol         , Urb         , Urb         , Urb         , Urb         , Urb         , Urb         , Urb         , Urb         , Urb         , Urb         , Urb         , Urb         , Urb         , Xol         , Urb         , Urb         , Urb         , Cud         , Cud         , Xol         , Xol         , Xol         , Xol         , Xol         , Xol         
Xol         , Xol         , Xol         , Xol         , Xol         , Xol         , Xol         , Urb         , Xol         , Xol         , Urb         , Urb         , Xol         , Xol         , Urb         , Urb         , Xol         , Xol         , Xol         , Urb         , Urb         , Urb         , Urb         , Urb         , Urb         , Urb         , Urb         , Urb         , Urb         , Urb^Vzps     , Urb         , Urb         , Urb         , Xol         , Urb         , Xol         , Xol         , Cud         , Cud         , Xol         , Xol         , Xol         , Xol         , Xol         , Xol         , Xol         
Xol         , Xol         , Xol         , Xol         , Xol         , Xol         , Urb         , Urb         , Urb         , Urb         , Urb         , Xol         , Urb         , Urb         , Xol         , Xol         , Urb         , Urb         , Urb         , Urb         , Urb^Vzps     , Urb         , Urb         , Urb         , Xol         , Xol         , Urb         , Xol         , Urb         , Urb         , Urb         , Urb         , Urb         , Urb         , Urb         , Urb         , Xol         , 2 Kud       , Xol         , Xol         , Xol         , Xol         , Xol         , Xol         , Xol         , Xol         
Xol         , Xol         , Xol         , Xol         , Urb         , Urb         , Urb         , Urb         , Urb         , Urb         , Urb         , Urb         , Xol         , Xol         , Xol         , Xol         , Urb         , Urb         , Xol         , Urb         , Urb         , Urb         , Xol         , Xol         , Xol         , Urb         , Urb         , Urb         , Urb         , Urb         , Urb         , Urb         , Urb         , Urb         , Xol         , Xol         , Xol         , Xol         , Xol         , Xol         , Xol         , Xol         , Xol         , Xol         , Xol         , Xol         
Xol         , Xol         , Urb         , Urb         , Urb         , Urb         , Urb         , Urb         , Urb         , Urb         , Urb         , Urb         , Urb         , Urb         , Urb         , Urb         , Urb         , Urb         , Urb         , Urb         , Xol         , Xol         , Xol         , Xol         , Xol         , Xol         , Urb         , Urb         , Urb         , Xol         , Xol         , Xol         , Xol         , Xol         , Xol         , Xol         , Xol         , Xol         , Xol         , Xol         , Xol         , Xol         , Xol         , Xol         , Xol         , Xol         
Xol         , Xol         , Urb         , Urb         , Urb         , Urb         , Urb         , Urb         , Urb         , Urb         , Urb         , Urb         , Urb         , Urb         , Urb         , Urb         , Urb         , Urb         , Xol         , Xol         , Xol         , Xol         , Xol         , Xol         , Xol         , Xol         , Xol         , Urb         , Xol         , Xol         , Xol         , Xol         , Xol         , Xol         , Xol         , Xol         , Xol         , Xol         , Xol         , Xol         , Xol         , Xol         , Xol         , Xol         , Xol         , Xol         
Urb         , Urb         , Urb         , Urb         , Urb         , Urb         , Urb         , Urb         , Urb         , Urb         , Urb         , Urb         , Xol         , Xol         , Xol         , Urb         , Xol         , Xol         , Xol         , Xol         , Xol         , Xol         , Xol         , Xol         , Xol         , Xol         , Xol         , Xol         , Xol         , Xol         , Xol         , Xol         , Xol         , Xol         , Xol         , Xol         , Xol         , Xol         , Xol         , Xol         , Xol         , Xol         , Xol         , Xol         , Xol         , Xol         
Xol         , Urb         , Xol         , Urb         , Urb         , Urb         , Urb         , Urb         , Urb         , Urb         , Xol         , Xol         , Xol         , Xol         , Xol         , Xol         , Xol         , Xol         , Xol         , Xol         , Xol         , Xol         , Xol         , Xol         , Xol         , Xol         , Xol         , Xol         , Xol         , Xol         , Xol         , Xol         , Xol         , Xol         , Xol         , Xol         , Xol         , Xol         , Xol         , Xol         , Xol         , Xol         , Xol         , Xol         , Xol         , Xol         
Xol         , Xol         , Xol         , Xol         , Xol         , Xol         , Xol         , Xol         , Xol         , Xol         , Xol         , Xol         , Xol         , Xol         , Xol         , Xol         , Xol         , Xol         , Xol         , Xol         , Xol         , Xol         , Xol         , Xol         , Xol         , Xol         , Xol         , Xol         , Xol         , Xol         , Xol         , Xol         , Xol         , Xol         , Xol         , Xol         , Xol         , Xol         , Xol         , Xol         , Xol         , Xol         , Xol         , Xol         , Xol         , Xol         
Xol         , Xol         , Xol         , Xol         , Xol         , Xol         , Xol         , Xol         , Xol         , Xol         , Xol         , Xol         , Xol         , Xol         , Xol         , Xol         , Xol         , Xol         , Xol         , Xol         , Xol         , Xol         , Xol         , Xol         , Xol         , Xol         , Xol         , Xol         , Xol         , Xol         , Xol         , Xol         , Xol         , Xol         , Xol         , Xol         , Xol         , Xol         , Xol         , Xol         , Xol         , Xol         , Xol         , Xol         , Xol         , Xol         
