border_size=1
usage=map

Rrc         , Rrc         , Rrc         , Rrc         , Ch          , Rrc         , Rrc         , Rrc         , Rr^Vhc      , Rrc         , Rrc         , Kh          , Kh          , Kh          , Ket         , Ket         , Kv          , Kv          , Kd          , Kd          , Kd          , Kd          , Kd          
Rrc         , Rr^Vhc      , Rrc         , Rrc         , Ch          , Rrc         , Rrc         , Rrc         , Rrc         , Rrc         , Rrc         , Kh          , Kh          , Kh          , Ket         , Ket         , Kv          , Kv          , Kv          , Kd          , Kd          , Kd          , Kd          
Rrc         , Rrc         , Rrc         , Rrc         , Ch          , Rrc         , Rrc         , Rrc         , Rrc         , Rrc         , Rrc         , Kh          , Kh          , Kh          , Ket         , Ket         , Ket         , Kv          , Kv          , Kv          , Kv          , Kd          , Kd          
Rrc         , Rrc         , Rrc         , Rrc         , Ch          , Rr^Vhc      , Rrc         , Rrc         , Rrc         , Rrc         , Rrc         , Khr         , Kh          , Kh          , Kh          , 1 Ket       , Ket         , Ket         , Ket         , Kv          , Kv          , Kv          , Kv          
Rrc         , Rrc         , Rr^Vhc      , Rrc         , Rrc         , Rrc         , Rrc         , Rr^Vhc      , Rrc         , Rrc         , Rrc         , Kh          , Kh          , Kh          , Kh          , Kh          , Kh          , Ket         , Ket         , Ket         , Ket         , Kv          , Kv          
Rrc         , Rrc         , Rrc         , Rrc         , Rrc         , Ch          , Ch          , Rrc         , Rrc         , Rr^Vhc      , Rrc         , Rrc         , Rrc         , Kh          , Kh          , Kh          , Kh          , Kh          , Kh          , Ket         , Ket         , Ket         , Ket         
Rrc         , Rrc         , Rr^Vhc      , Rrc         , Rrc         , Rrc         , Rr^Vhc      , Ch          , Ch          , Rrc         , Rrc         , Rrc         , Rr^Vhc      , Rrc         , Rrc         , Kh          , Kh          , Kh          , Kh          , Kh          , Kh          , Ket         , Ket         
Rrc         , Rrc         , Rrc         , Rrc         , Rrc         , Rrc         , Rrc         , Rrc         , Rrc         , Rrc         , Rrc         , Rrc         , Rrc         , Rrc         , Rrc         , Rrc         , Rrc         , Khr         , Kh          , Kh          , Kh          , Kh          , Kh          
Rrc         , Rrc         , Rrc         , Rrc         , Rrc         , Rrc         , Rrc         , Rrc         , Rrc         , Rr^Vhc      , Rrc         , Ch          , Ch          , Rrc         , Rrc         , Rrc         , Rr^Vhc      , Rrc         , Rrc         , Kh          , Kh          , Kh          , Kh          
Rrc         , Rrc         , Rrc         , Rr^Vhc      , Rrc         , Rrc         , Rrc         , Rrc         , Rrc         , Rrc         , Rrc         , Rrc         , Rrc         , Ch          , Ch          , Rrc         , Rrc         , Rrc         , Rrc         , Rrc         , Rrc         , Kh          , Kh          
