border_size=1
usage=map

Md^Xm, Md^Xm, Md^Xm, Md^Xm, Md^Xm, Md^Xm, Md^Xm, Md^Xm, Md^Xm, Md^Xm, Md^Xm, Md^Xm, Md^Xm, Md^Xm, Md^Xm, Md^Xm, Xu, Xu, Xu, Xu, Xu, Xu, Xu, Xu, Xu, Xu, Xu, Xu, Xu, Xu, Xu, Xu, Xu, Xu, Xu, Xu, Xu, Xu, Xu, Xu, Xu, Xu, Xu, Xu, Xu, Xu, Xu, Xu, Xu, Xu, Xu, Xu, Xu, Xu
Md^Xm, Md^Xm, Md^Xm, Md^Xm, Md^Xm, Md^Xm, Md^Xm, Md^Xm, Md^Xm, Md^Xm, Md^Xm, Md^Xm, Md^Xm, Md^Xm, Md^Xm, Md^Xm, Xu, Xu, Xu, Xu, Ur, Xu, Ur, Xu, Xu, Xu, Uu, Uu, Uu, Xu, Xu, Xu, Ur, Uu^Zewc, Ur, Xu, Ur, Xu, Xu, Xu, Uu, Xu, Xu, Xu, Uu, Xu, Xu, Xu, Uu, Xu, Ur, Uu, Ur, Xu
Md^Xm, Md^Xm, Md^Xm, Md^Xm, Md, Md, Md, Md, Md, Md^Xm, Md^Xm, Md^Xm, Md^Xm, Md^Xm, Md^Xm, Md^Xm, Xu, Xu, Ur, Uu, Xu, Ur, Xu, Uu, Ur, Uu, Xu, Xu, Xu, Uu, Uu, Ur, Xu, Xu, Xu, Uu, Xu, Uu, Ur, Uu, Xu, Uu, Uu, Ur, Xu, Ur, Uu, Ur, Xu, Uu, Xu, Xu, Xu, Uu
Md^Xm, Md^Xm, Md^Xm, Md, Md, Md, Md, Md, Md, Md, Md, Md^Xm, Md, Md^Xm, Md^Xm, Md^Xm, Xu, Uu, Xu, Xu, Xu, Xu, Xu, Xu, Xu, Xu, Xu, Xu, Xu, Xu, Xu, Xu, Xu, Xu, Xu, Xu, Xu, Xu, Xu, Xu, Xu, Xu, Xu, Xu, Xu, Xu, Xu, Xu, Xu, Xu, Xu, Xu, Xu, Xu
Md^Xm, Md^Xm, Md, Md, Uh, Md, Uh, Md, Uh, Uh, Uh, Md, Md, Md, Md, Md^Xm, Md^Xm, Zwsl, Md^Xm, Md^Xm, Md^Xm, Md^Xm, Md^Xm, Md^Xm, Md^Xm, Md^Xm, Md^Xm, Md^Xm, Md^Xm, Md^Xm, Md^Xm, Md^Xm, Md^Xm, Md^Xm, Md^Xm, Md^Xm, Md^Xm, Md^Xm, Md^Xm, Md^Xm, Md^Xm, Md^Xm, Md^Xm, Md^Xm, Md^Xm, Md^Xm, Md^Xm, Md^Xm, Md^Xm, Md^Xm, Md^Xm, Md^Xm, Md^Xm, Md^Xm
Md^Xm, Md^Xm, Md, Md, Uh, Uh, Uh, Uh, Uh, Uh, Uh^Zewt, Uh, Uh, Uh, Uh, Md, Md, Zwsl, Md, Md, Md, Md, Md, Md^Xm, Md^Xm, Md, Md, Md^Xm, Md^Xm, Md^Xm, Md, Md^Xm, Md^Xm, Md^Xm, Md^Xm, Md^Xm, Md^Xm, Md^Xm, Md, Md^Xm, Md^Xm, Md, Md, Md, Md, Md, Md^Xm, Md^Xm, Md^Xm, Md^Xm, Md^Xm, Md^Xm, Md^Xm, Md^Xm
Md^Xm, Md^Xm, Md, Md, Uh, Uh^Zewt, Zwsl, Uh, Zvw, Zwsl, Zwsl, Zwsl, Zwsl, Uh, Zwsl, Uh, Zwsl, Zwsl, Uh, Uh, Uh, Md, Md, Md, Md, Md, Md, Md, Md, Md, Md, Md, Md, Md, Md, Md^Xm, Md, Md, Md, Md, Md, Md, Md, Md, Uh, Md, Md, Md, Md, Md^Xm, Md^Xm, Md^Xm, Md^Xm, Md^Xm
Md^Xm, Md^Xm, Md, Md, Uh, Uh, Zwsl, Zvw, Zvw, Zvw, Zvw, Zwsl, Zwsl, Zgwl, Zwsl, Zwsl, Zwsl, Zwsl, Zwsl, Zwsl, Zwsl^Zewt, Uh, Uh, Uh, Uh, Uh, Uh, Uh, Uh, Md, Uh, Md, Uh, Md, Md, Md, Md, Md, Uh, Md, Md, Md, Uh, Uh, Uh, Uh, Uh, Md, Md, Md, Md, Md^Xm, Md^Xm, Md^Xm
Md^Xm, Md^Xm, Md, Md, Md, Uh, Uh, Zwsl, Zwsl^Zews, Zvw, Zvw, Zvw, Zvw, Zwsl, Zwsl, Zvw, Zvw, Zvw, Zwsl, Zwsl, Zwsl, Zwsl, Zwsl, Uh, Uh, Uh, Zwsl, Uh, Zwsl, Uh^Zewt, Uh, Uh, Uh, Uh, Uh, Md, Uh, Uh, Uh, Uh, Uh, Uh, Uh, Uh^Zewc, Zvw, Uh, Uh, Md, Md, Md, Md, Md^Xm, Md^Xm, Md^Xm
Md^Xm, Md^Xm, Md, Md, Md, Uh, Uh, Zwsl, Zwsl, Zwsl, Zvw, Zvw, Zvw, Zvw^Zewt, Zwsl, Zwsl^Zewt, Zvw, Zwsl, Zvw, Zgwl, Zwsl, Zwsl, Zwsl^Vzps, Zwsl, Zwsl, Zwsl, Zvw, Zwsl, Zwsl, Zwsl, Zwsl, Zwsl, Zwsl, Zwsl, Uh, Uh, Uh, Uh^Zewt, Zwsl, Zwsl, Zvw, Uh, Zwsl, Zwsl, Zvw, Uh, Uh, Uh, Uh, Md, Md, Md, Md^Xm, Md^Xm
Md^Xm, Md^Xm, Md, Md, Md, Uh, Zwsl, Zwsl, Zgwl, Zwsl, Zvw^Vzps, Zvw, Zvw, Zvw, Zvw, Zwsl, Zwsl, Zvw, Zwsl, Zwsl, Zwsl, Zwsl, Zvw, Zwsl, Zvw, Zvw, Zwsl^Zewe, Zwsl, Zwsl, Zwsl^Zews, Zvw, Zwsl, Zwsl^Zewe, Zwsl, Zvw, Zvw, Zvw^Zewe, Zvw, Zvw, Zvw, Chr, Chr, Chr, Zvw^Zewt, Zwsl, Zgwl, Uh, Uh^Zewc, Uh, Md, Md^Xm, Md^Xm, Md^Xm, Md^Xm
Md^Xm, Md^Xm, Md^Xm, Md, Md, Uh, Uh, Zwsl, Zwsl, Zwsl, Zvw, Zvw, Zvw, Zvw, Zvw, Zvw, Zwsl^Zewt, Zwsl, Zwsl^Zewc, Zwsl, Zwsl^Zewt, Zvw, Zwsl, Zvw, Zwsl, Zwsl, Zwsl, Zwsl, Zwsl, Zwsl, Zvw, Zwsl, Zwsl, Zvw, Zwsl, Zwsl, Zwsl^Zewt, Zwsl, Zwsl, Zwsl, Chr, 6 Khr, Chr, Zwsl, Zwsl, Uh, Uh, Uh, Md, Md, Md, Md^Xm, Md^Xm, Md^Xm
Md^Xm, Md^Xm, Md, Md, Uh, Uh, Uh, Zwsl, Zwsl, Zwsl^Zewc, Zvw, Zvw, Zvw, Zvw, Zvw, Zvw, Zwsl, Zwsl, Zvw, Zwsl, Zwsl, Zwsl, Zwsl^Zewc, Zwsl, Zwsl, Zwsl, Zwsl, Zwsl^Zewe, Zvw, Zwsl, Zwsl, Zvw, Zvw, Zwsl, Zwsl, Zwsl, Zwsl, Zwsl, Zwsl, Zwsl, Zwsl, Chr, Zwsl, Zvw, Zwsl, Uh^Zewc, Uh, Uh, Md, Md, Md^Xm, Md^Xm, Md^Xm, Md^Xm
Md^Xm, Md^Xm, Md^Xm, Md, Md, Uh, Zwsl, Zwsl^Zewt, Zwsl, Zwsl, Zwsl^Zewe, Zvw, Zwsl, Zwsl, Zwsl^Zews, Zwsl, Zwsl, Zwsl, Zvw, Zwsl, Zwsl, Zwsl, Zwsl, Zwsl, Zwsl, Zwsl, Zwsl, Zwsl, Zvw, Zwsl, Zwsl, Zwsl^Vzps, Zwsl, Zwsl, Zwsl, Zwsl, Zwsl, Zgwl, Zwsl, Zwsl, Zvw, Zwsl, Zvw^Vzps, Zvw, Zwsl, Uh, Uh, Md, Md, Md^Xm, Md^Xm, Md^Xm, Md^Xm, Md^Xm
Md^Xm, Md^Xm, Md, Md, Md, Uh, Uh, Zwsl, Zvw, Zwsl, Zwsl, Zwsl, Zvw, Zvw, Zgwl, Zgwl, Zvw, Zvw, Zwsl^Zewe, Zvw, Zwsl, Zwsl, Zwsl^Zewt, Zwsl, Zwsl, Zwsl^Zewe, Zwsl, Zwsl, Chr, Zwsl, Zwsl, Zwsl^Zewt, Zwsl, Zwsl, Zwsl, Zwsl^Zewe, Zwsl, Zwsl, Zvw, Zvw, Zvw, Zvw, Zwsl, Zwsl, Zwsl, Uh, Uh, Md, Md, Md, Md^Xm, Md^Xm, Md^Xm, Md^Xm
Md^Xm, Md^Xm, Md^Xm, Md, Md, Md, Uh, Uh, Zwsl, Zvw, Zwsl, Zwsl, Zwsl, Zwsl, Zwsl, Zwsl, Zvw, Zvw, Zvw, Zwsl, Zvw, Zwsl, Zvw, Zvw, Zvw, Zwsl, Zwsl, Chr, 3 Khr, Chr, Zwsl, Zwsl, Zwsl^Zews, Zwsl, Zwsl^Zewt, Zwsl, Zwsl, Zvw, Zwsl, Zvw, Zwsl^Zews, Zvw, Zvw, Zwsl^Zewe, Zwsl, Zwsl, Uh, Md, Md, Md, Md, Md^Xm, Md^Xm, Md^Xm
Md^Xm, Md^Xm, Md^Xm, Md^Xm, Md, Md, Md, Uh, Uh, Zwsl, Zwsl^Zewc, Zwsl, Zwsl^Zewt, Zwsl, Zwsl^Zewe, Zwsl, Zvw, Zwsl, Zwsl, Zvw, Zwsl, Zvw, Zwsl, Zwsl, Zwsl, Zwsl, Zwsl^Zewc, Chr, Chr, Chr, Zwsl, Zwsl, Zwsl, Zwsl, Zvw, Zwsl, Zvw, Zvw, Zvw, Zvw, Zwsl, Zwsl, Zwsl, Zgwl, Zvw, Uh, Uh, Uh^Zewc, Uh, Md, Md, Md^Xm, Md^Xm, Md^Xm
Md^Xm, Md^Xm, Md^Xm, Md^Xm, Md, Md, Md, Uh, Uh, Uh, Zwsl, Zwsl, Zwsl, Zwsl, Zwsl, Zwsl, Zvw, Zwsl, Zwsl, Zwsl^Zewc, Zwsl, Zwsl, Zwsl, Zwsl, Zwsl, Zwsl, Zwsl, Zwsl, Zwsl, Zwsl^Zews, Zwsl, Zwsl, Zvw, Zvw, Zwsl, Zvw, Zvw, Zvw^Zewt, Zwsl, Zwsl, Zwsl^Zewt, Zwsl, Zwsl, Zwsl, Zvw, Zvw, Zwsl, Uh, Uh, Md, Md, Md^Xm, Md^Xm, Md^Xm
Md^Xm, Md^Xm, Md^Xm, Md^Xm, Md^Xm, Md, Md, Uh, Uh, Zwsl, Zwsl, Zwsl, Zvw, Zwsl^Zews, Zwsl, Zwsl, Zvw, Zwsl^Zewe, Zgwl, Zwsl, Zwsl, Zwsl, Zwsl^Zewt, Zwsl, Zwsl, Zwsl^Zewt, Zwsl, Zwsl, Zwsl, Zwsl, Zwsl, Zvw, Zwsl, Zwsl, Zwsl^Zewe, Zwsl^Zewt, Zvw, Zwsl, Zvw, Zvw, Zwsl, Zwsl, Zwsl^Zewt, Zwsl, Zwsl, Zvw, Zvw, Zwsl, Uh, Uh, Md, Md, Md^Xm, Md^Xm
Md^Xm, Md^Xm, Md^Xm, Md^Xm, Md^Xm, Md, Md, Uh, Zwsl, Zwsl, Zwsl, Zwsl^Zewt, Zwsl, Zvw, Zvw, Zvw, Zwsl, Zwsl, Zwsl, Zwsl, Zwsl, Zwsl, Zvw, Zwsl, Zwsl, Zwsl, Zwsl^Zewt, Zwsl, Zwsl, Zgwl, Zwsl, Zvw, Zwsl, Zwsl, Zwsl, Zwsl, Zwsl, Zwsl, Zvw, Zvw, Zvw, Zwsl, Zwsl, Zwsl, Zwsl, Zgwl, Zwsl, Uh, Uh, Md, Md, Md, Md^Xm, Md^Xm
Md^Xm, Md^Xm, Md^Xm, Md^Xm, Md^Xm, Md^Xm, Md, Uh, Zgwl, Zwsl, Zwsl^Vzps, Zwsl, Zwsl, Zvw^Zewc, Zvw, Zwsl, Zvw, Zvw, Zvw, Zwsl, Zwsl, Zvw, Zwsl, Zvw, Zvw, Zwsl, Zvw, Zwsl, Zwsl, Zwsl, Zwsl^Zewt, Zwsl, Zwsl, Zwsl, Zgwl, Zvw, Zvw, Zvw, Zvw, Zwsl, Zwsl, Zvw^Vzps, Zvw, Zvw, Zwsl, Zwsl, Zwsl, Uh, Uh^Zewc, Uh, Md, Md, Md, Md^Xm
Xol, Xol, Xol, Xol, Xol, Md^Xm, Md, Uh, Zwsl, Zvw, Zvw, Zvw, Zvw, Zwsl, Zvw, Zvw, Zwsl, Zwsl, Zvw, Zvw, Zwsl, Zgwl, Zwsl, Zwsl, Zwsl, Zvw^Zewc, Zwsl^Vzps, Zvw, Zvw, Zwsl, Zvw, Zwsl, Zwsl, Zwsl, Zwsl, Zwsl, Zvw, Zvw, Zvw, Zwsl, Zwsl, Zwsl, Zwsl, Zwsl, Zwsl, Zwsl^Zewt, Zvw, Uh, Uh, Uh, Md, Md, Md, Md^Xm
Urb, Urb, Urb, Urb, Urb, Cud, Cud, Zwsl, Zwsl, Zvw, Zvw, Zvw, Zvw, Zwsl, Zvw, Zvw, Zvw, Zwsl^Zews, Zwsl, Zvw, Chr, Chr, Chr, Zwsl, Zwsl, Zwsl, Zvw, Zwsl, Zgwl, Zvw, Zwsl^Zewe, Zwsl, Zwsl, Zwsl^Zewt, Zwsl, Zwsl^Zews, Zvw, Zwsl, Zwsl, Zwsl, Zwsl, Zwsl^Zewt, Zwsl, Zwsl, Zwsl, Zgwl, Zvw, Zwsl, Uh, Md, Md, Md, Md^Xm, Md^Xm
Urb, Urb, Urb, Urb, Urb, Cud, Cud, Zwsl, Zwsl^Zewe, Zwsl, Zwsl, Zvw, Zwsl, Zvw, Zwsl, Zwsl, Zwsl, Zwsl^Zewe, Zwsl, Chr, Chr, 2 Khr, Chr, Zvw, Zvw, Zvw, Zwsl, Zwsl, Zwsl, Zwsl, Zwsl, Zwsl, Zwsl, Zwsl, Zwsl, Zwsl, Zwsl^Zewt, Zwsl, Zwsl, Zwsl, Zwsl, Zwsl, Zwsl, Zwsl, Zvw, Zvw, Zwsl, Uh, Uh, Md, Md, Md^Xm, Md^Xm, Md^Xm
Urb, Urb, Urb, Urb, Urb, 1 Kud, Cud, Zwsl, Zwsl, Zwsl, Zwsl, Zwsl, Zwsl, Zwsl^Zewt, Zwsl, Zwsl, Zwsl, Zwsl, Zwsl, Zwsl, Zwsl, Chr, Zwsl, Zwsl, Zwsl^Zewt, Zwsl, Zwsl, Zwsl, Zvw, Zvw, Zwsl, Zwsl^Zewc, Zwsl, Zwsl, Chr, Zwsl, Chr, Zwsl, Zvw, Zgwl, Zvw, Zvw, Zwsl^Zewt, Zwsl, Zvw, Zwsl, Zwsl, Uh, Uh, Md, Md, Md^Xm, Md^Xm, Md^Xm
Urb, Urb, Urb, Urb, Urb, Cud, Cud, Zwsl, Zwsl, Zgwl, Zwsl, Zwsl^Zewc, Zwsl, Zwsl, Zgwl, Zgwl, Zwsl, Zwsl, Zwsl, Zwsl, Zvw^Zewt, Zwsl, Zvw, Zwsl, Zvw, Zwsl, Zvw, Zvw, Zwsl^Zewe, Zwsl, Zvw, Zwsl, Zwsl, Chr, Chr, Chr, 4 Khr, Chr, Zvw, Zvw, Zwsl, Zwsl, Zwsl, Zvw, Zwsl^Zewt, Zwsl, Uh, Uh, Uh^Zewc, Md, Md, Md^Xm, Md^Xm, Md^Xm
Xol, Xol, Xol, Xol, Xol, Cud, Md, Zwsl, Zwsl, Zwsl, Zwsl, Zvw, Zvw, Zwsl, Zwsl, Zwsl, Zwsl, Zwsl^Zewt, Zwsl, Zwsl, Zwsl^Zews, Zvw, Zwsl, Zvw^Zewe, Zwsl, Zvw, Zwsl, Zwsl, Zvw, Zvw, Zvw, Zwsl^Zewe, Zwsl, Zvw, Zvw, Chr, Chr, Chr, Zvw, Zwsl, Zwsl, Zwsl, Zwsl, Zwsl, Zwsl, Zwsl, Uh, Uh, Md, Md, Md^Xm, Md^Xm, Md^Xm, Md^Xm
Md^Xm, Md^Xm, Md^Xm, Md^Xm, Md^Xm, Md^Xm, Md, Uh, Uh, Zwsl, Uh, Zwsl, Zvw, Zwsl, Zwsl, Zwsl, Zwsl, Zwsl, Zwsl, Zwsl, Zwsl, Zwsl, Zwsl, Zwsl, Zwsl^Zewt, Zwsl, Zgwl, Zwsl, Zwsl, Zvw, Zwsl, Zwsl, Zwsl^Vzps, Zwsl, Zwsl^Zewt, Zwsl, Zvw, Zvw, Zwsl, Zvw^Zewe, Zvw, Zvw, Zvw^Vzps, Zwsl, Zvw, Zvw, Uh, Uh, Md, Md, Md^Xm, Md^Xm, Md^Xm, Md^Xm
Md^Xm, Md^Xm, Md^Xm, Md^Xm, Md^Xm, Md^Xm, Md, Md, Md, Uh, Uh, Zwsl, Zwsl, Zvw, Zvw, Zwsl, Zwsl^Vzps, Zvw, Zvw, Zwsl, Zvw, Zwsl, Zwsl^Zewt, Zwsl, Zwsl, Zwsl, Zwsl, Zwsl, Zwsl, Zwsl, Zwsl, Zwsl, Zwsl, Zvw, Zvw, Zwsl, Zwsl, Zvw, Zwsl, Zwsl, Zvw, Zvw, Zvw, Zwsl, Zwsl, Zvw, Uh, Uh, Md, Md, Md, Md, Md^Xm, Md^Xm
Md^Xm, Md^Xm, Md^Xm, Md^Xm, Md^Xm, Md^Xm, Md^Xm, Md, Md, Md, Uh, Uh^Zewt, Uh, Zwsl, Zwsl, Zvw, Zvw, Zwsl, Zwsl, Zwsl^Zewe, Zvw, Zwsl, Zwsl, Zwsl, Zwsl, Zwsl, Zwsl, Zwsl, Zvw, Zwsl, Zwsl^Zewt, Zwsl, Zwsl, Zvw^Zews, Zvw, Zwsl, Zwsl, Zvw, Zwsl, Zwsl, Zwsl, Zvw, Zvw, Zvw, Zvw^Zewt, Zwsl, Uh, Uh, Uh, Md, Md, Md, Md^Xm, Md^Xm
Md^Xm, Md^Xm, Md^Xm, Md^Xm, Md^Xm, Md^Xm, Md^Xm, Md^Xm, Md^Xm, Md, Md, Uh, Uh, Uh, Zwsl, Zwsl, Zwsl, Zvw, Zvw, Zvw, Zwsl, Zwsl, Chr, Chr, Chr, Zvw, Zvw, Zvw, Zwsl, Zvw, Zwsl, Zwsl, Zwsl^Zewe, Zwsl, Zvw, Zwsl, Zvw, Zwsl, Zwsl, Zwsl^Zewt, Zwsl, Zvw, Zwsl, Zwsl, Zwsl, Zvw, Zvw, Uh, Uh, Md, Md, Md^Xm, Md^Xm, Md^Xm
Md^Xm, Md^Xm, Md^Xm, Md^Xm, Md^Xm, Md^Xm, Md^Xm, Md^Xm, Md^Xm, Md, Md, Md, Uh, Uh, Zwsl, Zgwl, Zwsl, Zwsl, Zwsl, Zwsl, Zwsl, Zwsl, Chr, Chr, 5 Khr, Chr, Zwsl, Zwsl, Zwsl, Zwsl^Zewc, Zwsl, Zwsl, Zwsl, Zwsl, Zwsl, Zwsl, Zwsl, Zgwl, Zwsl, Zwsl, Zvw, Zvw, Zwsl, Zvw^Zewt, Zwsl, Zwsl, Zvw, Uh, Uh, Md, Md, Md, Md^Xm, Md^Xm
Md^Xm, Md^Xm, Md^Xm, Md^Xm, Md^Xm, Md^Xm, Md^Xm, Md^Xm, Md^Xm, Md^Xm, Md^Xm, Md, Uh, Zwsl, Zwsl, Zwsl, Zwsl, Zwsl^Zews, Zwsl^Zewt, Zwsl, Zwsl, Zgwl, Zwsl, Chr, Chr, Chr, Zwsl, Zwsl^Zewt, Zwsl, Zgwl, Zvw, Zwsl, Zvw, Zvw, Zgwl, Zwsl, Zwsl, Zvw, Zwsl, Zvw, Zwsl, Zwsl, Zwsl, Zvw, Zwsl, Zwsl, Zvw^Zewt, Uh, Uh, Md, Md, Md^Xm, Md^Xm, Md^Xm
Xu, Xu, Xu, Xu, Xu, Xu, Xu, Xu, Xu, Xu, Md^Xm, Md, Zwsl, Zwsl, Zwsl, Zgwl, Zwsl, Zwsl, Zwsl, Zvw, Zvw, Zwsl, Zwsl, Zwsl, Zwsl^Zewe, Chr, Zwsl, Zwsl, Zvw^Vzps, Zwsl, Zvw, Zvw, Zvw, Zvw, Zgwl, Zwsl, Zwsl, Zwsl, Zgwl, Zwsl, Zwsl, Zwsl^Zewe, Zwsl, Zvw, Zwsl^Zewe, Zwsl, Zvw, Uh, Uh, Md, Md, Md, Md^Xm, Md^Xm
Xu, Xu, Xu, Xu, Xu, Xu, Xu, Xu, Xu, Xu, Zwsl, Zwsl, Uh, Zwsl^Zewt, Zwsl, Zvw, Zvw, Zwsl, Zvw, Zwsl, Zvw, Zvw, Zwsl^Zewt, Zwsl, Zwsl, Zwsl, Zgwl, Zvw, Zwsl, Zwsl, Zwsl, Zvw, Zwsl, Zwsl, Zwsl, Zvw, Zvw, Zwsl, Zwsl, Zwsl, Zwsl, Zgwl, Zwsl, Zvw, Zvw, Zwsl, Zvw, Uh, Uh, Md, Md, Md, Md^Xm, Md^Xm
Xu, Xu, Xu, Xu, Uh, Xu, Ur, Xu, Uu, Uu, Md^Xm, Md, Md, Uh, Uh, Uh, Zwsl, Zvw, Zwsl, Zwsl, Zwsl, Zvw, Zvw, Zwsl, Zwsl, Zvw, Zwsl, Zwsl, Zwsl, Zwsl, Zwsl^Zewe, Zwsl, Zwsl, Zvw, Zvw^Zewe, Zwsl, Zwsl, Zwsl^Vzps, Zwsl, Zwsl^Zewe, Zwsl, Zwsl, Zwsl, Zvw, Zvw, Zvw, Zvw, Uh, Uh, Uh, Md, Md, Md^Xm, Md^Xm
Xu, Xu, Xu, Uh, Uh, Ur, Xu, Uu, Xu, Xu, Md^Xm, Md^Xm, Md^Xm, Md, Md, Uh, Uh, Zwsl, Zwsl^Zewt, Zwsl^Zewc, Zwsl, Zvw, Zvw, Zvw, Zwsl, Zwsl, Zwsl, Zwsl, Zvw, Zwsl, Zwsl, Zwsl^Zewt, Zwsl, Zwsl, Zwsl, Zwsl^Zewt, Zwsl, Zwsl, Zvw, Zwsl, Zwsl, Zwsl, Zwsl, Zvw, Zvw, Zvw, Zwsl, Zvw, Zwsl, Uh, Uh, Md, Md, Md^Xm
Xu, Xu, Xu, Xu, Xu, Uh, Xu, Ur, Uh, Xu, Md^Xm, Md^Xm, Md^Xm, Md, Md, Uh, Uh, Zwsl, Zwsl^Vzps, Zwsl, Zvw, Zwsl, Zvw, Zwsl, Zwsl, Zvw, Zvw, Zvw, Zwsl, Zwsl, Uh, Zwsl, Zwsl, Zwsl, Zwsl, Zwsl, Zwsl, Zwsl, Zwsl, Zvw, Zvw, Zvw, Zvw, Zvw, Zvw, Zvw, Zwsl, Zgwl, Zwsl, Uh, Uh, Md, Md, Md^Xm
Xu, Xu, Xu, Xu, Xu, Xu, Uu, Ur, Xu, Xu, Md^Xm, Md^Xm, Md^Xm, Md^Xm, Md, Uh, Uh^Zewt, Zwsl, Zvw, Zvw, Uh, Uh, Uh^Zewt, Uh, Uh, Zwsl, Uh, Uh, Uh, Uh^Zewt, Uh, Uh, Uh, Uh, Uh^Zewt, Uh, Uh, Uh, Zwsl, Zvw, Zwsl, Zvw, Uh, Zvw, Zwsl, Zvw, Zvw, Zwsl, Zvw, Zwsl, Zwsl, Uh, Uh, Md
Xu, Xu, Xu, Xu, Uu, Ur^Zewe, Ur, Xu, Xu, Xu, Md^Xm, Md^Xm, Md^Xm, Md, Md, Uh, Uh, Zwsl, Zvw, Zvw, Uh, Uh, Md, Uh, Md, Uh, Uh, Uh, Md, Uh, Md, Uh, Md, Uh, Md, Uh, Md, Uh, Uh, Uh, Uh, Uh, Uh, Uh, Uh, Uh, Uh, Zwsl^Zewe, Zwsl, Zvw, Zvw, Zwsl, Zwsl, Uh
Xu, Xu, Uu^Uf, Ur^Vzps, Ur, Xu, Xu, Uh, Xu, Xu, Md^Xm, Md^Xm, Md^Xm, Md, Md, Uh, Uh, Zwsl, Zwsl, Uh, Uh, Md, Md^Xm, Md, Md^Xm, Md, Md, Md, Md, Md, Md^Xm, Md, Md, Md, Md, Md, Md, Uh, Uh, Uh, Md, Uh^Zewt, Md, Uh, Uh, Uh, Md, Uh, Uh, Zwsl, Uh, Zwsl, Zwsl, Zwsl
Xu, Xu, Uu^Uf, Uu^Uf, Ur, Xu, Xu, Uh, Xu, Xu, Md^Xm, Md^Xm, Md^Xm, Md^Xm, Md, Md, Uh, Uh, Uh, Uh, Md, Md, Md^Xm, Md^Xm, Md^Xm, Md^Xm, Md^Xm, Md^Xm, Md^Xm, Md^Xm, Md^Xm, Md^Xm, Md^Xm, Md, Md^Xm, Md, Md^Xm, Md, Md, Md, Md, Md, Md^Xm, Md, Md, Md, Md, Uh, Uh, Uh, Uh, Uh, Uh, Zwsl
Xu, Xu, Xu, Ur, Xu, Xu, Ur^Zewe, Ur, Xu, Xu, Md^Xm, Md^Xm, Md^Xm, Md^Xm, Md^Xm, Md, Md, Uh, Md, Uh, Md, Md^Xm, Md^Xm, Md^Xm, Md^Xm, Md^Xm, Md^Xm, Md^Xm, Md^Xm, Md^Xm, Md^Xm, Md^Xm, Md^Xm, Md^Xm, Md^Xm, Md^Xm, Md^Xm, Md^Xm, Md^Xm, Md^Xm, Md^Xm, Md^Xm, Md^Xm, Md^Xm, Md^Xm, Md, Md, Md, Md, Uh, Md, Uh, Uh, Zwsl
Xu, Xu, Xu, Uu, Uu, Uu, Ur^Zewt, Xu, Xu, Xu, Md^Xm, Md^Xm, Md^Xm, Md^Xm, Md^Xm, Md, Md, Md, Md, Md, Md^Xm, Md, Md^Xm, Md^Xm, Md^Xm, Md^Xm, Md^Xm, Md^Xm, Md^Xm, Md^Xm, Md^Xm, Md^Xm, Md^Xm, Md^Xm, Md^Xm, Md^Xm, Md^Xm, Md^Xm, Md^Xm, Md^Xm, Md^Xm, Md^Xm, Md^Xm, Md^Xm, Md^Xm, Md^Xm, Md^Xm, Md^Xm, Md^Xm, Md, Md, Md, Md, Uh
Xu, Xu, Ur^Ii, Qxu^Bs/, Xu, Xu, Xu, Xu, Xu, Xu, Md^Xm, Md^Xm, Md^Xm, Md^Xm, Md^Xm, Md^Xm, Md^Xm, Md, Md^Xm, Md^Xm, Md^Xm, Md^Xm, Md^Xm, Md^Xm, Md^Xm, Md^Xm, Md^Xm, Md^Xm, Md^Xm, Md^Xm, Md^Xm, Md^Xm, Md^Xm, Md^Xm, Md^Xm, Md^Xm, Md^Xm, Md^Xm, Md^Xm, Md^Xm, Md^Xm, Md^Xm, Md^Xm, Md^Xm, Md^Xm, Md^Xm, Md^Xm, Md^Xm, Md^Xm, Md^Xm, Md^Xm, Md, Md^Xm, Md
Xu, Xu, Xu, Xu, Xu, Xu, Xu, Xu, Xu, Xu, Md^Xm, Md^Xm, Md^Xm, Md^Xm, Md^Xm, Md^Xm, Md^Xm, Md^Xm, Zwsl, Md^Xm, Md^Xm, Md^Xm, Md^Xm, Md^Xm, Md^Xm, Md^Xm, Md^Xm, Md^Xm, Md^Xm, Md^Xm, Md^Xm, Md^Xm, Md^Xm, Md^Xm, Md^Xm, Md^Xm, Md^Xm, Md^Xm, Md^Xm, Md^Xm, Md^Xm, Md^Xm, Md^Xm, Md^Xm, Md^Xm, Md^Xm, Zwsl, Md^Xm, Zwsl, Md^Xm, Md^Xm, Md^Xm, Md^Xm, Md^Xm
