border_size=1
usage=map

Xu          , Xu          , Xu          , Xu          , Xu          , Xu          , Xu          , Xu          , Xu          , Xu          , Xu          , Xu          , Xu          , Xu          , Xu          , Xu          , Xu          , Xu          , Xu          , Xu          , Xu          , Xu          , Xu          , Xu          , Xu          , Xu          , Xu          , Xu          , Xu          , Xu          , Xu          , Xu          , Xu          , Xu          , Xu          , Xu          , Xu          , Xu          , Xu          , Xu          , Xu          , Xu          , Xu          , Xu          , Xu          , Xu          
Xu          , Xu          , Xu          , Xu          , Xu          , Xu          , Xu          , Xu          , Xu          , Xu          , Xu          , Xu          , Xu          , Xu          , Xu          , Xu          , Xu          , Xu          , Xu          , Xu          , Xu          , Xu          , Xu          , Xu          , Xu          , Xu          , Xu          , Xu          , Xu          , Xu          , Xu          , Xu          , Xu          , Xu          , Xu          , Xu          , Xu          , Xu          , Xu          , Xu          , Xu          , Xu          , Xu          , Xu          , Xu          , Xu          
Xu          , Xu          , Xu          , Xu          , Xu          , Xu          , Xu          , Xu          , Xu          , Xu          , Xu          , Xu          , Xu          , Xu          , Xu          , Xu          , Xu          , Xu          , Xu          , Xu          , Xu          , Xu          , Xu          , Xu          , Xu          , Xu          , Xu          , Xu          , Xu          , Xu          , Xu          , Xu          , Xu          , Xu          , Xu          , Xu          , Xu          , Xu          , Xu          , Xu          , Xu          , Xu          , Xu          , Xu          , Xu          , Xu          
Xu          , Xu          , Xu          , Xu          , Uh          , Xu          , Uh          , Xu          , Xu          , Xu          , Xu          , Xu          , Xu          , Xu          , Xu          , Xu          , Xu          , Xu          , Xu          , Xu          , Xu          , Xu          , Uh          , Xu          , Uh          , Uh          , Uh          , Xu          , Xu          , Xu          , Xu          , Xu          , Xu          , Xu          , Xu          , Xu          , Xu          , Xu          , Xu          , Xu          , Xu          , Xu          , Xu          , Xu          , Xu          , Xu          
Xu          , Xu          , Xu          , Xu          , Xu          , Uu          , Uu          , Uh          , Uh          , Xu          , Xu          , Xu          , Xu          , Xu          , Xu          , Xu          , Uh          , Uh          , Uh          , Xu          , Xu          , Xu          , Uh          , Uh          , Uu          , Uu          , Uu          , Uh          , Uh          , Uh          , Uh          , Xu          , Xu          , Xu          , Xu          , Xu          , Xu          , Xu          , Xu          , Xu          , Xu          , Xu          , Xu          , Xu          , Xu          , Xu          
Xu          , Xu          , Xu          , Xu          , Xu          , Uh          , Uh          , Uu          , Uu          , Uh          , Uh          , Xu          , Xu          , Xu          , Uh          , Uh          , Uu          , Uh          , Uh          , Xu          , Xu          , Uh          , Uh          , Uu          , Ur          , Ur          , Ur^Vzps      , Uu          , Ur          , Uu          , Ur          , Uh          , Uh          , Uh          , Uh          , Xu          , Uh          , Uh          , Uh          , Xu          , Xu          , Xu          , Xu          , Xu          , Xu          , Xu          
Xu          , Xu          , Xu          , Xu          , Xu          , Uh          , Uu          , Uu          , Uu          , Uh          , Uh          , Xu          , Xu          , Xu          , Uh          , Uh          , Uu          , Uu          , Uh          , Uh          , Xu          , Uh          , Uh          , Uu          , Ur          , Ur          , Ur          , Ur          , Ur          , Ur          , Uu          , Ur          , Uu          , Ur          , Ur^Vzps      , Uh          , Ur          , Uu          , Uh          , Xu          , Xu          , Xu          , Xu          , Xu          , Xu          , Xu          
Xu          , Xu          , Xu          , Xu          , Xu          , Uh          , Uu          , Uu          , Uu^Vzps      , Uh          , Xu          , Xu          , Xu          , Uh          , Uh          , Uu          , Uu          , Uu          , Uh          , Xu          , Xu          , Uh          , Uh          , Uu          , Uh          , Uu          , Uh          , Ur          , Cud         , Uu          , Uu          , Uu          , Uu          , Uu          , Uh          , Ur          , Uh          , Uu          , Uh          , Xu          , Xu          , Xu          , Xu          , Xu          , Xu          , Xu          
Xu          , Xu          , Xu          , Xu          , Uh          , Uh          , Uu          , Uu          , Uu          , Uu          , Uu          , Uh          , Uh          , Uh          , Ur          , Uu          , Uu^Vzps      , Uh          , Uh          , Xu          , Xu          , Xu          , Xu          , Uh          , Xu          , Uh          , Xu          , Cud         , 2 Kud       , Cud         , Xu          , Uh          , Uh          , Uh          , Xu          , Uh          , Uh          , Uh          , Uh          , Uh          , Xu          , Xu          , Xu          , Xu          , Xu          , Xu          
Xu          , Xu          , Xu          , Uh          , Uh          , Uu          , Uu^Uf       , Uu          , Uu^Uf       , Uu          , Uu          , Uh          , Uu          , Uu          , Uu          , Uu          , Uu          , Uh          , Uh          , Uh          , Uh          , Uh          , Uu          , Xu          , Uh          , Xu          , Xu          , Xu          , Cud         , Xu          , Xu          , Xu          , Xu          , Xu          , Xu          , Xu          , Xu          , Xu          , Xu          , Xu          , Xu          , Xu          , Xu          , Xu          , Xu          , Xu          
Xu          , Xu          , Xu          , Uh          , Uh          , Uh          , Uu^Uf       , Uu^Uf       , Uu^Uf       , Uu^Uf       , Uu          , Uu          , Ur          , Ur          , Ur          , Ur          , Uu          , Uu          , Uu          , Uh          , Uh          , Uh          , Uu          , Uh          , Uh          , Uh          , Uh          , Cud         , Cud         , Cud         , Uh          , Uh          , Uh          , Uh          , Uh          , Uh          , Uh          , Xu          , Uh          , Xu          , Uh          , Xu          , Xu          , Xu          , Xu          , Xu          
Xu          , Xu          , Xu          , Xu          , Xu          , Uh          , Uh          , Uu^Uf       , Uu^Uf       , Uu^Uf       , Ur          , Ur          , Ur          , Ur          , Ur          , Ur          , Ur          , Uu          , Uu          , Uu          , Uu          , Uu          , Uu          , Uu          , Uu          , Uu          , Uu          , Uu          , Ur          , Uu          , Ur          , Uh          , Uu          , Uu          , Uu          , Uu          , Uu          , Uh          , Uu          , Uh          , Uh          , Uh          , Xu          , Xu          , Xu          , Xu          
Xu          , Xu          , Xu          , Xu          , Xu          , Xu          , Xu          , Uh          , Uh          , Uu          , Uu          , Ur          , Ur          , Ur          , Uu          , Uu          , Uu          , Ur          , Ur          , Uu          , Ur          , Uu          , Ur^Vzps      , Ur          , Ur          , Uu          , Uu          , Ur          , Ur          , Ur          , Ur          , Ur          , Ur          , Ur          , Ur^Vzps      , Uu          , Uu          , Uu          , Uu          , Uh          , Xu          , Xu          , Xu          , Xu          , Xu          , Xu          
Xu          , Xu          , Xu          , Xu          , Xu          , Xu          , Xu          , Uh          , Uu          , Uu          , Ur          , Ur          , Ur          , Ur          , Uu          , Uh          , Uh          , Uu          , Ur          , Ur          , Ur          , Ur          , Ur          , Ur          , Ur          , Uu          , Uh          , Ur          , Ur          , Ur          , Ur          , Ur          , Uu          , Ur          , Ur          , Ur          , Uu          , Ur          , Ur          , Uh          , Xu          , Xu          , Xu          , Xu          , Xu          , Xu          
Xu          , Xu          , Xu          , Xu          , Xu          , Uh          , Uh          , Uh          , Uu          , Ur          , Ur          , Ur^Vzps      , Ur          , Uu          , Uu          , Xu          , Uh          , Uu          , Ur          , Ur          , Ur          , Ur          , Ur          , Ur          , Uu          , Uu          , Uh          , Uu          , Uu          , Ur          , Uu          , Uu          , Uh          , Uu          , Uu          , Uu          , Uh          , Ur          , Uh          , Uh          , Xu          , Xu          , Xu          , Xu          , Xu          , Xu          
Xu          , Xu          , Xu          , Xu          , Uh          , Uh          , Uu          , Uu          , Uu          , Uu          , Uu          , Ur          , Ur          , Uu          , Uu          , Uh          , Uu          , Uu          , Ur          , Ur          , Uu          , Ur          , Ur          , Ur          , Uu          , Uh          , Uh          , Ur          , Ur          , Ur          , Uu          , Uu          , Uh          , Uh          , Uh          , Uh          , Uh          , Uh          , Uh          , Uh          , Xu          , Xu          , Xu          , Xu          , Xu          , Xu          
Xu          , Xu          , Xu          , Uh          , Uh          , Uh          , Uh          , Uu          , Uh          , Uu          , Uu          , Ur          , Ur          , Ur          , Ur          , Uu          , Ur          , Ur          , Uu          , Uu          , Uh          , Uu          , Uu          , Ur          , Uu          , Uu          , Uu          , Ur          , Ur          , Ur          , Ur          , Uu          , Uh          , Uh          , Uh          , Uh          , Xu          , Xu          , Xu          , Xu          , Xu          , Xu          , Xu          , Xu          , Xu          , Xu          
Xu          , Xu          , Xu          , Xu          , Uh          , Uh          , Xu          , Uh          , Uh          , Uu          , Uu          , Ur          , Uu          , Ur          , Ur          , Ur          , Ur          , Uu          , Uh          , Uh          , Uh          , Uh          , Uu          , Ur          , Ur          , Ur          , Ur          , Ur          , Ur          , Ur          , Ur          , Uu          , Uu          , Uh          , Uu          , Uh          , Uh          , Xu          , Xu          , Xu          , Xu          , Xu          , Xu          , Xu          , Xu          , Xu          
Xu          , Xu          , Xu          , Xu          , Xu          , Xu          , Xu          , Xu          , Xu          , Uh          , Uh          , Uu          , Uu          , Ur          , Ur          , Ur          , Ur          , Uu          , Uh          , Uh          , Uu          , Uu          , Uu^Uf       , Ur          , Ur^Vzps      , Ur          , Ur          , Ur          , Uu          , Ur          , Uu          , Ur          , Ur          , Uu          , Ur          , Uh          , Uh          , Xu          , Uh          , Uh          , Uh          , Xu          , Xu          , Xu          , Xu          , Xu          
Xu          , Xu          , Xu          , Xu          , Uh          , Xu          , Xu          , Xu          , Xu          , Uh          , Uh          , Uu          , Uu          , Ur          , Ur          , Ur          , Ur          , Uu          , Uu          , Uu          , Uu^Uf       , Uu^Uf       , Uu^Uf       , Ur          , Ur          , Ur          , Uu          , Ur          , Uh          , Uu          , Uu          , Ur          , Ur^Vzps      , Ur          , Ur          , Uu          , Uu^Uf       , Uh          , Uh          , Uh          , Uu          , Uh          , Xu          , Xu          , Xu          , Xu          
Xu          , Xu          , Xu          , Uh          , Uh          , Uh          , Uh          , Uh          , Uh          , Uh          , Uu          , Uu          , Ur          , Ur          , Uu          , Uu          , Uu          , Uu          , Uh          , Uu^Uf       , Uu^Uf       , Uu^Uf       , Ur          , Ur          , Ur          , Uu          , Uh          , Uh          , Xu          , Uh          , Uu          , Ur          , Ur          , Ur          , Ur          , Uu^Uf       , Uu^Uf       , Uu          , Uu^Uf       , Uu^Uf       , Uu          , Uh          , Xu          , Xu          , Xu          , Xu          
Xu          , Xu          , Xu          , Xu          , Uh          , Uh          , Uu^Uf       , Uu^Uf       , Uu^Uf       , Uu          , Uu          , Ur^Vzps      , Ur          , Ur          , Uh          , Uh          , Xu          , Uh          , Uh          , Uu          , Uu^Uf       , Ur          , Ur          , Ur          , Uu          , Ur          , Uh          , Uh          , Uu          , Uh          , Ur          , Ur          , Ur          , Ur          , Ur          , Uu^Uf       , Uu^Uf       , Uu^Uf       , Uu          , Uu^Uf       , Uu          , Uh          , Xu          , Xu          , Xu          , Xu          
Xu          , Xu          , Xu          , Xu          , Uh          , Uh          , Uu^Uf       , Uu^Uf       , Uu^Uf       , Uu          , Uu          , Ur          , Ur          , Uu          , Uu          , Uh          , Uh          , Uh          , Uu          , Uu^Uf       , Ur          , Ur          , Ur          , Ur          , Ur          , Uu          , Uu          , Uh          , Uu          , Ur          , Ur          , Ur          , Ur          , Ur          , Uu          , Uu^Uf       , Uh          , Uu          , Uh          , Uu^Uf       , Uh          , Xu          , Xu          , Xu          , Xu          , Xu          
Xu          , Xu          , Xu          , Uh          , Uu^Uf       , Uu^Uf       , Uh          , Uh          , Uh          , Uh          , Uu          , Uu          , Ur          , Ur          , Uu          , Uu          , Uu          , Uu          , Ur          , Ur          , Ur          , Ur          , Ur          , Ur          , Ur          , Ur          , Ur          , Uu          , Uu          , Uu          , Ur          , Ur          , Uu          , Uu          , Uh          , Uh          , Xu          , Uh          , Uh          , Uh          , Uh          , Xu          , Xu          , Xu          , Xu          , Xu          
Xu          , Xu          , Xu          , Uh          , Uh          , Uu^Uf       , Uh          , Xu          , Uh          , Uh          , Uu          , Uu          , Uh          , Ur          , Ur          , Ur          , Ur          , Ur          , Uu          , Ur          , Ur          , Ur          , Ur          , Ur          , Ur^Vzps      , Ur          , Ur          , Ur          , Ur          , Ur          , Ur          , Ur          , Ur          , Uh          , Uh          , Uh          , Uh          , Xu          , Xu          , Uh          , Xu          , Xu          , Xu          , Xu          , Xu          , Xu          
Xu          , Xu          , Xu          , Xu          , Uh          , Uh          , Xu          , Xu          , Uh          , Uh          , Uu          , Uu          , Uh          , Ur          , Ur          , Uu          , Uh          , Uh          , Uh          , Uu          , Uh          , Uu          , Ur          , Ur          , Ur          , Ur          , Uu          , Ur          , Ur          , Ur          , Ur          , Ur          , Ur          , Ur          , Ur          , Uh          , Uu          , Uh          , Xu          , Xu          , Xu          , Xu          , Xu          , Xu          , Xu          , Xu          
Xu          , Xu          , Xu          , Xu          , Uh          , Xu          , Xu          , Uh          , Uh          , Uu          , Uu          , Ur          , Ur          , Ur          , Ur          , Uh          , Uh          , Xu          , Xu          , Uh          , Uh          , Uu          , Ur          , Ur          , Uu          , Uu          , Uh          , Uu          , Uu          , Ur          , Uu          , Ur          , Uh          , Uu          , Uu          , Ur          , Ur          , Uh          , Uh          , Xu          , Xu          , Xu          , Xu          , Xu          , Xu          , Xu          
Xu          , Xu          , Xu          , Uh          , Uh          , Uh          , Uh          , Uh          , Uu          , Uu          , Ur          , Ur          , Ur          , Ur          , Uu^Uf       , Uh          , Xu          , Xu          , Xu          , Uh          , Uu          , Uu          , Ur          , Uu          , Uh          , Xu          , Xu          , Uh          , Uu          , Ur^Vzps      , Uu^Uf       , Uh          , Xu          , Uh          , Uh          , Uu          , Uu^Uf       , Uu^Uf       , Uh          , Uh          , Xu          , Xu          , Xu          , Xu          , Xu          , Xu          
Xu          , Xu          , Uh          , Uh          , Uu          , Uu          , Uu          , Uu          , Ur          , Ur          , Ur          , Ur          , Uu          , Uu^Vzps      , Uu^Uf       , Uh          , Xu          , Xu          , Uh          , Uh          , Uu          , Ur          , Ur          , Uu          , Uh          , Xu          , Xu          , Uh          , Uu          , Uu          , Uh          , Uh          , Xu          , Uh          , Xu          , Uh          , Uh          , Uu^Uf       , Uu^Uf       , Uh          , Uh          , Xu          , Xu          , Xu          , Xu          , Xu          
Xu          , Xu          , Uh          , Uh          , Ur          , Ur          , Ur          , Ur          , Uh          , Uu          , Uu          , Uu          , Uu^Uf       , Uu^Uf       , Uh          , Xu          , Xu          , Xu          , Xu          , Uh          , Uh          , Uu          , Uh          , Uh          , Xu          , Xu          , Xu          , Xu          , Uh          , Uu          , Uu          , Uh          , Uh          , Xu          , Xu          , Uh          , Uh          , Uu          , Uu^Uf       , Ur          , Uh          , Uh          , Xu          , Xu          , Xu          , Xu          
Xu          , Xu          , Ur          , Ur          , Ur          , 1 Ur        , Ur          , Ur          , Xu          , Uh          , Uh          , Uu^Uf       , Uh          , Uh          , Xu          , Xu          , Xu          , Xu          , Xu          , Uh          , Xu          , Uh          , Uh          , Uh          , Xu          , Xu          , Xu          , Xu          , Uh          , Uu          , Uh          , Uh          , Xu          , Xu          , Xu          , Xu          , Xu          , Uh          , Uh          , Uh          , Uh          , Uh          , Xu          , Xu          , Xu          , Xu          
Ur          , Ur          , Ur          , Ur          , Ur          , Ur          , Ur          , Uh          , Xu          , Xu          , Xu          , Uh          , Uh          , Xu          , Xu          , Xu          , Xu          , Xu          , Xu          , Xu          , Xu          , Xu          , Xu          , Xu          , Xu          , Xu          , Xu          , Xu          , Xu          , Uh          , Xu          , Xu          , Xu          , Xu          , Xu          , Xu          , Xu          , Xu          , Xu          , Uh          , Xu          , Xu          , Xu          , Xu          , Xu          , Xu          
Ur          , Ur          , Xu          , Ur          , Uh          , Ur          , Uh          , Uh          , Xu          , Xu          , Xu          , Xu          , Xu          , Xu          , Xu          , Xu          , Xu          , Xu          , Xu          , Xu          , Xu          , Xu          , Xu          , Xu          , Xu          , Xu          , Xu          , Xu          , Xu          , Xu          , Xu          , Xu          , Xu          , Xu          , Xu          , Xu          , Xu          , Xu          , Xu          , Xu          , Xu          , Xu          , Xu          , Xu          , Xu          , Xu          
Xu          , Xu          , Xu          , Xu          , Xu          , Uh          , Xu          , Uh          , Xu          , Xu          , Xu          , Xu          , Xu          , Xu          , Xu          , Xu          , Xu          , Xu          , Xu          , Xu          , Xu          , Xu          , Xu          , Xu          , Xu          , Xu          , Xu          , Xu          , Xu          , Xu          , Xu          , Xu          , Xu          , Xu          , Xu          , Xu          , Xu          , Xu          , Xu          , Xu          , Xu          , Xu          , Xu          , Xu          , Xu          , Xu          
Xu          , Xu          , Xu          , Xu          , Xu          , Xu          , Xu          , Xu          , Xu          , Xu          , Xu          , Xu          , Xu          , Xu          , Xu          , Xu          , Xu          , Xu          , Xu          , Xu          , Xu          , Xu          , Xu          , Xu          , Xu          , Xu          , Xu          , Xu          , Xu          , Xu          , Xu          , Xu          , Xu          , Xu          , Xu          , Xu          , Xu          , Xu          , Xu          , Xu          , Xu          , Xu          , Xu          , Xu          , Xu          , Xu          
