border_size=1
usage=map

Md^Xm       , Md^Xm       , Md^Xm       , Md^Xm       , Md^Xm       , Md^Xm       , Md^Xm       , Md^Xm       , Md^Xm       , Md^Xm       , Md^Xm       , Zwsl        , Md^Xm       , Md^Xm       , Md^Xm       , Md^Xm       , Md^Xm       , Md^Xm       , Md^Xm       , Md^Xm       , Md^Xm       , Md^Xm       , Md^Xm       , Md^Xm       , Md^Xm       , Md^Xm       , Md^Xm       , Md^Xm       , Md^Xm       , Md^Xm       , Md^Xm       , Md^Xm       , Md^Xm       , Md^Xm       , Xu          , Xu          , Xu          , Xu          , Xu          , Xu          , Xu          , Xu          , Xu          , Xu          , Xu          , Xu          
Md^Xm       , Md^Xm       , Md^Xm       , Md^Xm       , Md^Xm       , Md^Xm       , Md          , Md^Xm       , Md          , Md^Xm       , Md^Xm       , Md^Xm       , Md^Xm       , Md^Xm       , Md^Xm       , Md^Xm       , Md^Xm       , Md^Xm       , Md^Xm       , Md^Xm       , Md^Xm       , Md^Xm       , Md^Xm       , Md^Xm       , Md^Xm       , Md^Xm       , Md^Xm       , Md^Xm       , Md^Xm       , Md^Xm       , Md^Xm       , Md^Xm       , Md^Xm       , Md^Xm       , Xu          , Zaw         , Uu          , Ur          , Xu          , Xu          , Ur          , Xu          , Uh          , Xu          , Xu          , Xu          
Md^Xm       , Md^Xm       , Md          , Md^Xm       , Md          , Md          , Md          , Md          , Md          , Md^Xm       , Md^Xm       , Md^Xm       , Md^Xm       , Md^Xm       , Md^Xm       , Md^Xm       , Md^Xm       , Md^Xm       , Md^Xm       , Md^Xm       , Md^Xm       , Md^Xm       , Md^Xm       , Md^Xm       , Md          , Md^Xm       , Md^Xm       , Md^Xm       , Md^Xm       , Md^Xm       , Md^Xm       , Md^Xm       , Md^Xm       , Md^Xm       , Xu          , Xu          , Ur          , Ur          , Ur          , Ur          , Xu          , Ur          , Ur          , Xu          , Xu          , Xu          
Md          , Md          , Md          , Md          , Uh          , Uh          , Uh          , Uh          , Md          , Md          , Md^Xm       , Md^Xm       , Md^Xm       , Md^Xm       , Md^Xm       , Md^Xm       , Md^Xm       , Md          , Md          , Md^Xm       , Md          , Md^Xm       , Md          , Md          , Md          , Md^Xm       , Md^Xm       , Md^Xm       , Md^Xm       , Md^Xm       , Md^Xm       , Md^Xm       , Md^Xm       , Md^Xm       , Xu          , Xu          , Uh          , Uu          , Ur          , Xu          , Xu          , Xu          , Xu          , Uu          , Xu          , Xu          
Ql          , Md          , Md          , Uh          , Uh          , Uu          , Uu          , Uh          , Md          , Md          , Md          , Md^Xm       , Md          , Md          , Md          , Md^Xm       , Md          , Md          , Md          , Md          , Md          , Md          , Md          , Md          , Md          , Md          , Md^Xm       , Md^Xm       , Md^Xm       , Md^Xm       , Md^Xm       , Md^Xm       , Md^Xm       , Md^Xm       , Xu          , Uh          , Xu          , Ur          , Uu^Uf       , Xu          , Ur          , Ur^Vzps      , Uu          , Ur          , Uh          , Xu          
Ql          , Ql          , Zvw         , Uh          , Uu          , Uu          , Uu          , Uh          , Uh          , Md          , Md          , Md          , Md          , Md          , Md          , Md          , Uh          , Uh          , Uh          , Md          , Uh          , Md          , Uh          , Uh          , Uh          , Md          , Md          , Md^Xm       , Md^Xm       , Md^Xm       , Md^Xm       , Md^Xm       , Md^Xm       , Md^Xm       , Xu          , Xu          , Uu          , Ur          , Xu          , Uu^Uf       , Xu          , Ur          , Uu          , Uh          , Uh          , Xu          
Zvw         , Ql^Bs/      , Ql          , Zvw         , Zwsl        , Zwsl        , Zwsl        , Uu          , Uu          , Uh          , Uh          , Uh          , Uh          , Uh          , Uh          , Uh          , Uh          , Uh          , Uu          , Uh          , Uu          , Uh          , Uh          , Uh          , Uh          , Md          , Md          , Md          , Md          , Md          , Md          , Md^Xm       , Md^Xm       , Md^Xm       , Xu          , Xu          , Ur          , Xu          , Uu          , Xu          , Xu          , Xu          , Ur          , Uu          , Xu          , Xu          
Ql          , Ql          , Ql          , Zvw         , Zvw         , Zwsl        , Zwsl        , Zwsl        , Uu          , Uu          , Uu          , Uh          , Uu          , Uh          , Uh          , Uh          , Uu          , Uu          , Uu          , Uu          , Uu          , Uu          , Chr         , Chr         , 3 Khr       , Uh          , Uh          , Md          , Md          , Md          , Md          , Md          , Md          , Md^Xm       , Xu          , Xu          , Ur          , Ur          , Uu          , Xu          , Ur          , Uu          , Uh          , Xu          , Xu          , Xu          
Ql          , Ql          , Ql          , Ql          , Ql^Bs/      , Zvw         , Zvw         , Zwsl        , Zwsl^Vzps    , Uu          , Zwsl        , Uu          , Zwsl        , Uu          , Uu          , Uu          , Uu          , Uu          , Zwsl^Ziff   , Zwsl^Ziff   , Zwsl^Ziff   , Uu^Ziff     , Zwsl        , Chr         , Chr         , Uh          , Uh          , Uh          , Uh          , Uh          , Uh          , Uh          , Md          , Md^Xm       , Uu          , Uu          , Xu          , Xu          , Xu          , Ur          , Xu          , Uh          , Xu          , Xu          , Xu          , Xu          
Ql^Bs/      , Zvw         , Zvw         , Zvw         , Ql          , Ql          , Ql          , Zvw         , Zvw         , Zwsl        , Zwsl        , Zwsl        , Zwsl        , Zwsl        , Zvw         , Zwsl        , Zvw         , Zwsl        , Zwsl        , Zwsl^Ziff   , Zwsl        , Zwsl^Ziff   , Zwsl^Ziff   , Chr         , Zwsl        , Uu          , Uu          , Uh          , Uu          , Uu          , Uu          , Uh          , Zwsl        , Zwsl        , Xu          , Xu          , Xu          , Xu          , Xu          , Xu          , Xu          , Xu          , Xu          , Xu          , Xu          , Xu          
Ql          , Zvw         , Zvw         , Zvw         , Ql          , Ql          , Ql          , Zvw         , Zvw         , Zwsl        , Zwsl        , Zwsl        , Zwsl        , Zvw         , Zwsl        , Zvw         , Zwsl        , Zvw         , Zwsl        , Zwsl        , Zwsl        , Zwsl        , Zwsl^Vzps    , Zwsl        , Zwsl        , Zwsl        , Zwsl        , Uu          , Zwsl        , Zwsl        , Zwsl        , Zwsl        , Md          , Md^Xm       , Md^Xm       , Md^Xm       , Md^Xm       , Md^Xm       , Md^Xm       , Md^Xm       , Md^Xm       , Md^Xm       , Md^Xm       , Md^Xm       , Md^Xm       , Md^Xm       
Ql          , Ql          , Zvw         , Ql^Bs\      , Zvw         , Ql          , Zvw         , Zvw         , Zwsl        , Zwsl        , Zwsl^Ziff   , Uu^Ziff     , Uu          , Zwsl        , Uu          , Zwsl        , Uu          , Zwsl        , Zwsl        , Zwsl        , Zvw         , Zwsl        , Zvw         , Zvw         , Zvw         , Zwsl        , Zwsl        , Zwsl        , Zwsl        , Zwsl        , Uu          , Uh          , Uh          , Md          , Md          , Md^Xm       , Md^Xm       , Md^Xm       , Md^Xm       , Md^Xm       , Md^Xm       , Md^Xm       , Md^Xm       , Md^Xm       , Md^Xm       , Md^Xm       
Ql          , Ql          , Ql          , Ql          , Ql          , Ql^Bs\      , Zvw         , Zvw         , Zwsl        , Zwsl^Ziff   , Zwsl^Ziff   , Zwsl^Ziff   , Uu^Ziff     , Uu          , Uh          , Uu          , Uu          , Uu          , Uu          , Zwsl        , Zwsl        , Zvw         , Zwsl        , Zwsl        , Zwsl        , Zvw         , Zvw         , Zwsl        , Zwsl        , Zwsl        , Uu          , Uu          , Uu          , Uh          , Uh          , Md          , Md          , Md          , Md          , Md^Xm       , Md^Xm       , Md^Xm       , Md^Xm       , Md^Xm       , Md^Xm       , Md^Xm       
Zvw         , Ql          , Ql          , Ql          , Zvw         , Zvw         , Zvw         , Zvw         , Zwsl        , Zwsl        , Zvw         , Zwsl^Ziff   , Zwsl^Ziff   , Uu          , Uu          , Uh          , Uh          , Uu          , Uu          , Uu          , Zwsl        , Zvw         , Zvw         , Uu          , Uu          , Zwsl        , Zwsl        , Zvw         , Zwsl        , Zwsl        , Zwsl        , Uu          , Uu          , Uh          , Uh          , Uh          , Md          , Md          , Md          , Md          , Md^Xm       , Md^Xm       , Md^Xm       , Md^Xm       , Md^Xm       , Md^Xm       
Ql          , Ql^Bs\      , Zvw         , Ql^Bs/      , Ql          , Zvw^Vzps     , Zvw         , Zvw         , Zvw         , Zwsl        , Zvw         , Zwsl        , Zwsl        , Uu          , Uu          , Uh          , Uh          , Uh^Ziff     , Uh^Ziff     , Uu^Ziff     , Uu^Ziff     , Zwsl^Ziff   , Zwsl^Ziff   , Uu^Ziff     , Uu^Ziff     , Uu          , Uu          , Zwsl        , Zwsl        , Zwsl        , Zwsl^Vzps    , Zwsl        , Zwsl        , Uu          , Uu          , Uh          , Md          , Md          , Md          , Md          , Md^Xm       , Md^Xm       , Md^Xm       , Md^Xm       , Md^Xm       , Md^Xm       
Ql          , Zvw         , Zvw         , Ql          , Ql          , Ql          , Ql^Bs/      , Zvw         , Zvw         , Zwsl        , Zwsl        , Zwsl        , Zwsl        , Zwsl        , Zwsl        , Uu          , Uu          , Uh          , Uh          , Uu^Ziff     , Uu          , Zwsl        , Zwsl        , Zwsl^Ziff   , Uu^Ziff     , Uh          , Uh          , Uu          , Zwsl        , Zvw         , Zvw         , Zwsl        , Zwsl        , Zwsl        , Uu          , Uh          , Uh          , Uh          , Md          , Md          , Md^Xm       , Md^Xm       , Md^Xm       , Md^Xm       , Md^Xm       , Md^Xm       
Ql          , Ql          , Ql^Bs|      , Ql          , Ql^Bs/      , Zvw         , Ql          , Zvw         , Zvw         , Zwsl        , Zwsl        , Zwsl        , Zwsl        , Zwsl        , Zwsl        , Zwsl        , Zwsl        , Uu          , Uu          , Uh          , Uu          , Zwsl        , Zwsl        , Zwsl        , Uu          , Uu^Ziff     , Uh^Ziff     , Uu          , Uu          , Zwsl        , Zwsl        , Zvw         , Zwsl        , Zwsl        , Uu          , Uh          , Uh          , Uh          , Md          , Md          , Md^Xm       , Md^Xm       , Md^Xm       , Md^Xm       , Md^Xm       , Md^Xm       
Ql          , Ql          , Zvw         , Zvw         , Ql          , Ql          , Ql          , Ql          , Zvw         , Zvw         , Zwsl        , Uu^Ziff     , Uu^Ziff     , Uu^Ziff     , Uu^Ziff     , Uu          , Uu          , Zwsl        , Zwsl        , Uu          , Zvw         , Uu          , Zwsl        , Zwsl        , Zwsl        , Uu          , Uu          , Uh^Ziff     , Uh^Ziff     , Uu          , Zwsl        , Zwsl        , Zwsl        , Uu          , Uu          , Uu          , Uh          , Uh          , Md          , Md          , Md^Xm       , Md^Xm       , Md^Xm       , Md^Xm       , Md^Xm       , Md^Xm       
Ql          , Ql          , Zvw         , Zvw         , Zvw         , Ql          , Ql          , Ql          , Zvw         , Zvw         , Zwsl        , Zwsl        , Uu^Ziff     , Uu^Ziff     , Uu^Ziff     , Uh          , Uh          , Uu          , Zwsl        , Zwsl        , Zwsl        , Zvw         , Zvw         , Zwsl        , Zwsl        , Zwsl        , Zwsl        , Uu          , Uu          , Uu^Ziff     , Uu^Ziff     , Zwsl        , Zwsl        , Zwsl        , Uu          , Uh          , Uh          , Uh          , Md          , Md          , Md^Xm       , Md^Xm       , Md^Xm       , Md^Xm       , Md^Xm       , Md^Xm       
Ql          , Ql          , Ql          , Zvw         , Ql^Bs\      , Ql          , Zvw         , Zvw         , Zvw         , Zvw         , Zwsl        , Zwsl        , Zwsl        , Uu^Ziff     , Uu^Ziff     , Uu          , Uu          , Uh          , Uu          , Uu          , Uu          , Zwsl        , Zwsl        , Zvw         , Zvw         , Zwsl^Vzps    , Zwsl        , Zwsl        , Uu          , Uu^Ziff     , Uu^Ziff     , Zwsl        , Zwsl        , Zwsl        , Uu          , Uh          , Uh          , Md          , Md          , Md          , Md^Xm       , Md^Xm       , Md^Xm       , Md^Xm       , Md^Xm       , Md^Xm       
Ql          , Ql          , Ql          , Ql          , Ql          , Zvw         , Zvw         , Zwsl        , Zvw         , Zwsl^Vzps    , Zvw         , Zwsl        , Zwsl        , Zwsl        , Zwsl        , Uu          , Uu          , Uh          , Uh          , Uu          , Uu          , Zwsl        , Zwsl        , Zvw         , Zvw         , Zwsl        , Zwsl        , Zwsl        , Zwsl^Ziff   , Uu^Ziff     , Zwsl        , Zwsl        , Zwsl        , Zwsl        , Uu          , Uh          , Uh          , Md          , Md          , Md          , Md^Xm       , Md^Xm       , Md^Xm       , Md^Xm       , Md^Xm       , Md^Xm       
Ql          , Ql          , Zvw         , Ql          , Ql^Bs/      , Zvw         , Zvw         , Zvw         , Zvw         , Zwsl        , Zwsl        , Zvw         , Zvw         , Zwsl        , Zwsl        , Zwsl        , Zwsl        , Uu          , Uu          , Uh          , Uu          , Zwsl        , Zwsl        , Uu          , Uu          , Zwsl        , Uu          , Zwsl^Ziff   , Zwsl^Ziff   , Zwsl        , Zwsl        , Zwsl        , Zwsl        , Zwsl        , Uu          , Uu          , Uh          , Md          , Md          , Md^Xm       , Md^Xm       , Md^Xm       , Md^Xm       , Md^Xm       , Md^Xm       , Md^Xm       
Zvw         , Zvw         , Zvw         , Zvw         , Ql          , Ql          , Ql          , Zvw         , Zvw         , Zvw         , Zwsl        , Zwsl        , Zwsl        , Zvw         , Zvw         , Zwsl        , Zwsl        , Zwsl        , Zwsl        , Uu          , Zwsl        , Zwsl        , Zwsl        , Zwsl        , Uu          , Uu          , Uh^Ziff     , Uu^Ziff     , Uu^Ziff     , Zwsl        , Zwsl        , Zvw         , Zwsl        , Zwsl        , Zwsl        , Uu          , Uh          , Md          , Md          , Md^Xm       , Md          , Md^Xm       , Md^Xm       , Md^Xm       , Md^Xm       , Md^Xm       
Zvw         , Zvw         , Zvw         , Zvw         , Zvw         , Ql          , Ql          , Ql          , Zvw         , Zvw         , Zvw         , Zwsl        , Zwsl        , Zwsl        , Zwsl        , Zvw         , Zvw         , Zvw         , Zvw         , Zwsl        , Zwsl        , Zwsl        , Zwsl        , Zwsl        , Uu          , Uu          , Uh          , Uh^Ziff     , Uh^Ziff     , Uu          , Uu          , Zvw         , Zvw         , Zwsl        , Zwsl        , Uu          , Uu          , Uh          , Uh          , Md          , Uh          , Md          , Md          , Md^Xm       , Md^Xm       , Md^Xm       
Zvw         , Zvw         , Zvw         , Zvw         , Ql          , Ql          , Ql^Bs/      , Zvw         , Zvw         , Zvw         , Zvw         , Zwsl        , Zwsl        , Zwsl        , Uu          , Uu          , Uu          , Zwsl        , Zwsl        , Zwsl        , Zvw         , Zwsl        , Zwsl        , Zwsl        , Zwsl        , Uu          , Uu          , Uh^Ziff     , Uh^Ziff     , Uh^Ziff     , Uh          , Uu          , Zwsl        , Zwsl        , Zwsl        , Uu          , Uh          , Uu          , Uh          , Uh          , Md          , Md          , Md          , Md^Xm       , Md^Xm       , Md^Xm       
Ql          , Zvw         , Zvw         , Zvw         , Ql^Bs\      , Zvw         , Ql          , Zvw         , Zvw         , Zvw         , Zvw         , Zvw         , Zwsl        , Zwsl        , Uu          , Uu          , Uh^Ziff     , Uu          , Uu          , Zwsl        , Zwsl        , Zvw         , Zvw         , Zvw         , Zvw^Vzps     , Zwsl        , Zvw         , Uu          , Uu          , Uu          , Uu          , Uu          , Uu          , Zwsl        , Zwsl        , Uu          , Uh          , Uh          , Md          , Md          , Md^Xm       , Md^Xm       , Md^Xm       , Md^Xm       , Md^Xm       , Md^Xm       
Ql          , Ql          , Ql          , Ql          , Ql^Bs/      , Zvw         , Ql          , Ql          , Ql          , Zvw         , Zvw         , Zvw^Vzps     , Zvw         , Zwsl        , Zwsl        , Uu          , Uu          , Uh^Ziff     , Uh^Ziff     , Uu          , Uu^Ziff     , Zwsl        , Zwsl        , Zvw         , Zwsl        , Zvw         , Zvw         , Zvw         , Zvw         , Uu          , Zvw         , Zwsl        , Zwsl        , Zwsl        , Uu          , Uu          , Uh          , Md          , Md          , Md          , Md^Xm       , Md^Xm       , Md^Xm       , Md^Xm       , Md^Xm       , Md^Xm       
Ql          , Ql          , Zvw         , Zvw         , Zvw         , Ql          , Ql          , Ql          , Zvw         , Zvw         , Zvw         , Zwsl        , Zwsl        , Zvw         , Zvw         , Zwsl        , Zwsl        , Uu          , Chr         , Uu^Ziff     , Uu^Ziff     , Uu^Ziff     , Uu^Ziff     , Zwsl^Ziff   , Zwsl^Ziff   , Uu          , Uu          , Zwsl        , Zwsl        , Zvw         , Zvw         , Zvw         , Zvw         , Zwsl        , Uu          , Uh          , Uh          , Md          , Md          , Md          , Md^Xm       , Md^Xm       , Md^Xm       , Md^Xm       , Md^Xm       , Md^Xm       
Ql          , Ql          , Zvw         , Zvw         , Zvw^Vzps     , Ql          , Ql          , Zvw         , Zvw         , Zvw         , Zwsl        , Zwsl        , Uu^Ziff     , Uu          , Uu          , Zvw         , Zvw         , Chr         , 2 Khr       , Chr         , Chr         , Uu          , Uu          , Zwsl^Ziff   , Uu^Ziff     , Uu^Ziff     , Uu^Ziff     , Uu^Ziff     , Uu^Ziff     , Uu          , Uu          , Zwsl        , Zwsl        , Zwsl        , Zwsl        , Uu          , Uh          , Md          , Md          , Md^Xm       , Md^Xm       , Md^Xm       , Md^Xm       , Md^Xm       , Md^Xm       , Md^Xm       
Ql          , Ql          , Zvw         , Zvw         , Ql          , Ql          , Ql          , Ql          , Zvw         , Zvw         , Zwsl        , Zwsl        , Uu^Ziff     , Uu^Ziff     , Uu^Ziff     , Uu          , Uu          , Chr         , Chr         , Chr         , Zwsl        , Uu          , Zwsl        , Zwsl        , Zwsl        , Uu          , Uu          , Uh^Ziff     , Uh^Ziff     , Uh^Ziff     , Uh          , Uu          , Uu          , Zwsl        , Zwsl        , Uu          , Uu          , Uh          , Uu          , Md          , Md          , Md^Xm       , Md^Xm       , Md^Xm       , Md^Xm       , Md^Xm       
Ql          , Ql          , Zvw         , Zvw         , Ql          , Ql          , Qlf         , Qlf         , Zvw         , Zvw         , Zvw         , Zwsl        , Zwsl        , Uu^Ziff     , Uu^Ziff     , Uh          , Uh          , Uu          , Uu          , Zwsl        , Zwsl        , Zvw         , Zvw         , Zwsl        , Zwsl        , Zwsl        , Zwsl        , Uu          , Uu^Ziff     , Uh^Ziff     , Uh          , Uh          , Uu          , Zwsl        , Zwsl        , Zwsl        , Zwsl        , Uu          , Uu          , Uh          , Md          , Md^Xm       , Md^Xm       , Md^Xm       , Md^Xm       , Md^Xm       
Ql          , Ql          , Ql^Bs/      , Zvw         , Ql^Bs\      , Zvw         , Qlf         , Qlf         , Zvw         , Zvw         , Zvw         , Zwsl        , Zwsl        , Uu^Ziff     , Uu          , Uu^Ziff     , Uh          , Uu          , Uu          , Zwsl        , Zwsl        , Zwsl        , Zwsl        , Zvw^Vzps     , Zvw         , Zwsl        , Zvw         , Uu          , Uu^Ziff     , Uu^Ziff     , Uu          , Uh          , Uh          , Uu          , Zwsl        , Zwsl        , Zwsl        , Uu          , Uh          , Uh          , Md          , Md          , Md^Xm       , Md^Xm       , Md^Xm       , Md^Xm       
Ql          , Zvw         , Ql          , Ql          , Ql          , Zvw         , Qlf         , Qlf         , Zvw         , Zvw         , Zvw         , Zvw         , Zvw         , Zwsl        , Uu          , Uh          , Uh          , Uh          , Uh          , Uu          , Zwsl        , Zwsl        , Zvw         , Zwsl        , Zwsl        , Zvw         , Zwsl^Ziff   , Zvw^Ziff    , Zwsl^Ziff   , Uu^Ziff     , Zwsl        , Uu          , Uu          , Uu          , Uu          , Zwsl        , Uu          , Uu          , Uh          , Uh          , Md          , Md          , Md^Xm       , Md^Xm       , Md^Xm       , Md^Xm       
Zvw         , Ql          , Ql          , Ql          , Zvw         , Ql          , Qlf         , Qlf         , Qlf         , Zvw         , Zvw         , Zvw         , Zwsl        , Zvw         , Zwsl        , Uu          , Uu          , Uh          , Uu          , Uu          , Uu          , Zwsl        , Zvw         , Zwsl        , Uu          , Zwsl        , Zwsl^Ziff   , Zwsl^Ziff   , Zwsl        , Zwsl        , Zwsl        , Zwsl        , Zwsl        , Uu          , Zwsl^Vzps    , Zwsl        , Uu          , Uh          , Uh          , Md          , Md          , Md          , Md^Xm       , Md^Xm       , Md^Xm       , Md^Xm       
Zvw         , Ql          , Ql          , Ql          , Zvw         , Zvw         , Zvw         , Qlf         , Qlf         , Qlf         , Zvw         , Zvw         , Zwsl        , Zvw         , Zvw         , Zwsl        , Zwsl        , Uu          , Uu          , Uu          , Uu          , Zwsl        , Zvw         , Zwsl        , Uu          , Uu^Ziff     , Uu^Ziff     , Zwsl        , Zwsl        , Zvw         , Zvw         , Zwsl        , Zvw         , Zwsl        , Zwsl        , Uu          , Uu          , Uh          , Md          , Md          , Md^Xm       , Md^Xm       , Md^Xm       , Md^Xm       , Md^Xm       , Md^Xm       
Ql          , Ql          , Zvw         , Ql^Bs/      , Ql          , Zvw         , Qlf^Bs\     , Qlf         , Qlf         , Qlf         , Zvw         , Zvw         , Zvw         , Zwsl        , Zvw         , Zwsl        , Zvw         , Zwsl        , Zwsl        , Uu          , Zwsl        , Zvw         , Zvw         , Zwsl        , Uu          , Uu          , Uh^Ziff     , Uu^Ziff     , Uu^Ziff     , Zwsl        , Zwsl        , Zvw         , Zvw         , Zvw         , Zwsl        , Uu          , Uu          , Uh          , Md          , Md^Xm       , Md^Xm       , Md^Xm       , Md^Xm       , Md^Xm       , Md^Xm       , Md^Xm       
Ql          , Ql          , Ql          , Zvw         , Zvw         , Ql          , Ql          , Zvw         , Zvw         , Qlf^Bs/     , Qlf         , Zvw         , Zvw         , Zvw         , Zwsl        , Zvw         , Zvw         , Zvw         , Zvw         , Zwsl        , Zwsl        , Zvw         , Zwsl        , Zwsl        , Zwsl        , Uu          , Uh          , Uh^Ziff     , Uu^Ziff     , Uu^Ziff     , Uu          , Zwsl        , Zwsl        , Zvw         , Zwsl        , Zwsl        , Uu          , Uh          , Md          , Md^Xm       , Xol         , Xol         , Xol         , Xol         , Xol         , Xol         
Ql          , Ql          , Ql          , Ql          , Ql^Bs/      , Zvw         , Ql          , Ql          , Zvw         , Qlf^Bs\     , Zvw         , Qlf^Bs/     , Qlf         , Qlf         , Zvw         , Zvw         , Zvw         , Zwsl        , Zvw^Vzps     , Zwsl        , Zwsl        , Zwsl        , Zwsl        , Zwsl        , Zwsl        , Uu          , Uu          , Uh^Ziff     , Uh^Ziff     , Uh^Ziff     , Uu^Ziff     , Zwsl        , Zwsl        , Zvw         , Zvw         , Zwsl        , Zwsl        , Uu          , Uh          , Cud         , Urb         , Urb         , Urb         , Urb         , Urb         , Urb         
Ql          , Ql          , Ql          , Zvw         , Ql          , Ql          , Zvw         , Ql^Bs/      , Ql          , Qlf         , Qlf^Bs|     , Qlf         , Qlf         , Qlf         , Zvw         , Zvw         , Zvw         , Zvw         , Zvw         , Zvw         , Zvw         , Zwsl        , Zvw         , Zwsl        , Zwsl        , Zwsl        , Zwsl        , Uu          , Uu          , Uh^Ziff     , Uh          , Uu          , Zwsl        , Zvw         , Zvw         , Zwsl        , Zwsl        , Zwsl        , Cud         , Cud         , Urb         , Urb         , Urb         , Urb         , Urb         , Urb         
Ql          , Ql          , Ql          , Zvw         , Zvw         , Ql^Bs/      , Ql          , Ql          , Ql          , Ql          , Zvw         , Zvw         , Zvw         , Qlf         , Qlf^Bs/     , Zvw         , Qlf^Bs|     , Zvw         , Zvw         , Zvw         , Zvw         , Zvw         , Zvw         , Zwsl        , Zwsl        , Zvw         , Zvw         , Zwsl        , Zwsl        , Uu          , Uu          , Uu          , Zwsl        , Zwsl        , Zwsl        , Zwsl        , Zwsl        , Zwsl        , Cud         , 1 Kud       , Urb         , Urb         , Urb         , Urb         , Urb         , Urb         
Ql          , Ql          , Zvw         , Ql          , Zvw         , Zvw         , Zvw         , Ql          , Ql          , Ql          , Ql^Bs|      , Ql          , Ql          , Zvw         , Zvw         , Qlf         , Zvw         , Qlf         , Qlf         , Qlf         , Qlf^Bs/     , Zvw         , Zvw         , Zvw         , Zvw         , Zwsl        , Zwsl        , Zwsl        , Zwsl        , Zwsl        , Zwsl        , Uu          , Zwsl        , Zwsl        , Zwsl        , Uu          , Uu          , Uu          , Uh          , Cud         , Urb         , Urb         , Urb         , Urb         , Urb         , Urb         
Ql          , Ql          , Zvw         , Ql^Bs/      , Ql          , Zvw^Vzps     , Zvw         , Zvw         , Ql^Bs\      , Zvw         , Zvw         , Ql          , Ql          , Ql          , Ql          , Ql          , Qlf^Bs/     , Zvw         , Qlf^Bs\     , Zvw         , Zvw         , Qlf         , Qlf         , Zvw         , Zvw         , Zvw         , Zvw         , Zwsl^Vzps    , Zwsl        , Zwsl        , Zwsl        , Zwsl        , Uu          , Uu          , Uu          , Uu          , Uh          , Uh          , Md          , Cud         , Xol         , Xol         , Xol         , Xol         , Xol         , Xol         
Ql          , Ql          , Zvw         , Ql          , Ql          , Ql          , Ql          , Zvw         , Ql          , Zvw         , Zvw         , Zvw         , Zvw         , Ql          , Zvw         , Zvw         , Zvw         , Ql          , Zvw         , Zvw         , Zvw         , Qlf         , Qlf         , Qlf         , Qlf         , Zvw         , Zvw         , Zvw         , Zvw         , Zwsl        , Uu          , Uu          , Uh          , Uh          , Uh          , Uh          , Md          , Md          , Md^Xm       , Md^Xm       , Md^Xm       , Md^Xm       , Md^Xm       , Md^Xm       , Md^Xm       , Md^Xm       
Ql          , Ql          , Ql          , Zvw         , Ql          , Ql          , Ql          , Ql          , Ql          , Ql^Bs|      , Ql          , Ql          , Ql          , Ql^Bs\      , Zvw         , Zvw         , Zvw         , Ql          , Ql          , Qlf         , Qlf         , Zvw         , Qlf^Bs\     , Qlf         , Zvw         , Qlf         , Qlf^Bs/     , Zvw         , Zvw         , Zwsl        , Uu          , Uu          , Uh          , Uh          , Md          , Md          , Md          , Md          , Md^Xm       , Md^Xm       , Md^Xm       , Md^Xm       , Md^Xm       , Md^Xm       , Md^Xm       , Md^Xm       
Ql          , Ql          , Ql          , Ql          , Ql          , Ql          , Ql          , Zvw         , Zvw         , Zvw         , Ql          , Ql          , Ql          , Ql          , Ql          , Ql          , Ql          , Ql          , Ql          , Qlf         , Qlf         , Qlf         , Zvw         , Zvw         , Qlf         , Zvw         , Zvw         , Qlf         , Qlf         , Uu          , Uh          , Uh          , Md          , Md          , Md          , Md          , Md^Xm       , Md^Xm       , Md^Xm       , Md^Xm       , Md^Xm       , Md^Xm       , Md^Xm       , Md^Xm       , Md^Xm       , Md^Xm       
Ql          , Ql          , Ql          , Ql          , Ql          , Ql          , Ql          , Zvw         , Ql          , Ql          , Ql          , Ql          , Ql          , Ql          , Ql          , Ql          , Ql          , Ql          , Ql          , Ql          , Ql          , Ql          , Ql          , Ql          , Ql          , Qlf         , Qlf         , Qlf         , Qlf         , Qlf         , Md          , Md          , Md          , Md          , Md^Xm       , Md^Xm       , Md^Xm       , Md^Xm       , Md^Xm       , Md^Xm       , Md^Xm       , Md^Xm       , Md^Xm       , Md^Xm       , Md^Xm       , Md^Xm       
