border_size=1
usage=map

Md^Xm       , Md^Xm       , Md^Xm       , Md^Xm       , Md^Xm       , Md^Xm       , Md^Xm       , Md^Xm       , Md^Xm       , Md^Xm       , Md^Xm       , Md^Xm       , Md^Xm       , Md^Xm       , Md^Xm       , Md^Xm       , Md^Xm       , Md^Xm       , Md^Xm       , Md^Xm       , Md^Xm       , Md^Xm       , Md^Xm       , Md^Xm       , Md^Xm       , Zwsl        , Md^Xm       , Md^Xm       , Md^Xm       , Md^Xm       , Md^Xm       , Md^Xm       , Md^Xm       , Md^Xm       , Md^Xm       , Md^Xm       , Md^Xm       , Md^Xm       , Md^Xm       , Md^Xm       , Md^Xm       , Md^Xm       , Md^Xm       , Md^Xm       , Md^Xm       , Md^Xm       
Md^Xm       , Md^Xm       , Md^Xm       , Md^Xm       , Md^Xm       , Md^Xm       , Md^Xm       , Md^Xm       , Md          , Md^Xm       , Md^Xm       , Md^Xm       , Md^Xm       , Md^Xm       , Md^Xm       , Md^Xm       , Md          , Md^Xm       , Md          , Md          , Md          , Md^Xm       , Md          , Md^Xm       , Md^Xm       , Md^Xm       , Md^Xm       , Md^Xm       , Md^Xm       , Md^Xm       , Md^Xm       , Md^Xm       , Md          , Md^Xm       , Md^Xm       , Md^Xm       , Md^Xm       , Md^Xm       , Md^Xm       , Md^Xm       , Md^Xm       , Md^Xm       , Md^Xm       , Md^Xm       , Md^Xm       , Md^Xm       
Md^Xm       , Md^Xm       , Md^Xm       , Md^Xm       , Md^Xm       , Md^Xm       , Md          , Md          , Md          , Md          , Md          , Md^Xm       , Md          , Md^Xm       , Md          , Md          , Md          , Md          , Uh          , Uh          , Md          , Md          , Uh          , Md          , Md          , Md^Xm       , Md^Xm       , Md^Xm       , Md          , Md^Xm       , Md          , Md          , Md          , Md          , Md^Xm       , Md^Xm       , Md^Xm       , Md^Xm       , Md^Xm       , Md^Xm       , Md^Xm       , Md^Xm       , Md^Xm       , Md^Xm       , Md^Xm       , Md^Xm       
Md^Xm       , Md^Xm       , Md          , Md          , Md          , Md          , Md          , Md          , Uh          , Md          , Md          , Md          , Md          , Md          , Uh          , Uh          , Uh          , Md          , Uh          , Uh          , Uh          , Uh          , 6 Khr       , Uh          , Uh          , Md          , Md          , Md          , Uh          , Md          , Uh          , Md          , Uh          , Md          , Md          , Md          , Md          , Md^Xm       , Md^Xm       , Md^Xm       , Md^Xm       , Md^Xm       , Md^Xm       , Md^Xm       , Md^Xm       , Md^Xm       
Md          , Md          , Uh          , Uh          , Uh          , Uh          , Uh          , Uh          , Uh          , Uh          , Uh          , Md          , Uh          , Uh          , Zwsl        , Uu          , Zwsl        , Uh          , Uu          , Chr         , Chr         , Chr         , Chr         , Uh          , Uh          , Uh          , Uh          , Md          , Uh          , Uh          , Uu          , Uh          , Uu          , Uh          , Uh          , Uh          , Uh          , Md          , Md          , Md^Xm       , Md^Xm       , Md^Xm       , Md^Xm       , Md^Xm       , Md^Xm       , Md^Xm       
Ql          , Uh          , Ql          , Zwsl        , Ql          , Zwsl        , Zwsl        , Zwsl        , Zwsl        , Zwsl        , Zwsl        , Uh          , Zwsl        , Zwsl        , Zwsl        , Zwsl        , Zwsl        , Uu          , Uu          , Uu          , Uu          , Chr         , Zwsl        , Zwsl        , Zwsl        , Zwsl        , Zwsl        , Uh          , Zwsl        , Zwsl        , Zwsl        , Uu          , Zwsl        , Zwsl        , Zwsl        , Uu          , Uh          , Uh          , Md          , Md^Xm       , Md          , Md^Xm       , Md^Xm       , Md^Xm       , Md^Xm       , Md^Xm       
Ql          , Ql          , Ql          , Ql          , Ql          , Ql          , Ql          , Ql          , Ql          , Zwsl        , Zwsl        , Zwsl        , Zwsl^Vzps    , Zwsl        , Zwsl        , Zwsl        , Zwsl        , Zwsl        , Zwsl        , Uu          , Uu          , Zwsl        , Zwsl        , Zwsl        , Ql          , Zwsl        , Zwsl        , Zwsl        , Ql          , Zwsl        , Ql          , Zwsl        , Zwsl        , Zwsl^Vzps    , Zwsl        , Zwsl        , Zwsl        , Uh          , Zwsl        , Md          , Md          , Md          , Md          , Md^Xm       , Md^Xm       , Md^Xm       
Zwsl        , Ql          , Zwsl        , Ql          , Ql          , Ql          , Ql          , Zwsl        , Zwsl        , Ql          , Ql^Bs/      , Zwsl        , Zwsl        , Zwsl        , Ql          , Zwsl        , Ql          , Ql          , Zwsl        , Zwsl        , Zwsl        , Zwsl        , Zwsl        , Ql          , Ql          , Ql^Bs|      , Ql          , Ql          , Ql          , Ql          , Ql          , Ql          , Ql          , Ql          , Ql          , Ql          , Ql          , Zwsl        , Ql          , Zwsl        , Uh          , Md          , Md^Xm       , Md^Xm       , Md^Xm       , Md^Xm       
Zwsl        , Zwsl        , Zwsl        , Zwsl        , Zwsl        , Zwsl        , Zwsl        , Ql^Bs/      , Ql          , Zwsl        , Ql          , Ql          , Ql          , Ql          , Ql          , Ql^Bs|      , Ql          , Ql          , Ql          , Ql          , Ql          , Zwsl        , Ql          , Ql          , Ql          , Zwsl        , Zwsl        , Ql          , Ql          , Ql          , Ql          , Ql          , Zwsl        , Ql          , Ql          , Zwsl        , Ql          , Ql          , Ql^Bs/      , Zwsl        , Zwsl        , Uh          , Uh          , Md^Xm       , Md^Xm       , Md^Xm       
Zwsl        , Zwsl        , Zwsl        , Zwsl        , 1 Zwsl      , Zwsl        , Zwsl        , Zwsl        , Ql          , Ql          , Ql          , Ql          , Ql          , Ql          , Zwsl        , Zwsl        , Ql          , Ql          , Ql          , Ql          , Ql          , Ql          , Ql          , Ql          , Ql          , Zwsl        , Ql^Bs|      , Zwsl        , Ql          , Ql          , Ql          , Ql          , Ql          , Zwsl        , Zwsl        , Ql          , Zwsl        , Zwsl        , Zwsl        , Ql          , Ql          , Ql          , Ql          , Md^Xm       , Ql          , Md^Xm       
Md          , Zwsl        , Zwsl        , Zwsl        , Zwsl        , Zwsl        , Zwsl        , Zwsl        , Zwsl        , Ql          , Zwsl        , Ql          , Zwsl        , Ql^Bs/      , Ql          , Ql          , Zwsl        , Zwsl        , Zwsl        , Ql          , Ql          , Ql          , Chr         , 4 Khr       , Chr         , Ql          , Zwsl        , Ql          , Zwsl        , Ql          , Zwsl        , Ql          , Ql          , Ql          , Ql^Bs/      , Zwsl        , Ql          , Ql          , Ql          , Ql^Bs\      , Zwsl        , Ql          , Zwsl        , Ql          , Ql          , Md^Xm       
Md^Xm       , Md          , Md          , Uh          , Uh          , Zwsl        , Zwsl        , Zwsl        , Zwsl        , Zwsl        , Zwsl        , Zwsl        , Zwsl        , Zwsl        , Zwsl        , Zwsl        , Zwsl        , Zwsl        , Zwsl        , Zwsl        , Zwsl        , Chr         , Chr         , Chr         , Zwsl        , Zwsl        , Zwsl        , Zwsl        , Zwsl        , Zwsl        , Zwsl        , Zwsl        , Zwsl        , Zwsl        , Zwsl        , Ql          , Zwsl        , Ql          , Ql          , Zwsl        , Ql^Bs|      , Ql          , Ql          , Ql          , Ql          , Ql          
Md^Xm       , Md          , Md          , Md          , Uh          , Uh          , Uu          , Zwsl        , Zwsl        , Zwsl        , Zwsl        , Zwsl        , Zwsl        , Zwsl        , Zwsl        , Zwsl        , Uu          , Uu          , Uu          , Zwsl        , Zwsl        , Zwsl        , Zwsl        , Zwsl        , Zwsl        , Zwsl        , Zwsl        , Zwsl        , Uu          , Zwsl        , Uu          , Zwsl        , Zwsl        , Zwsl        , Zwsl^Vzps    , Zwsl        , Zwsl        , Ql          , Ql          , Ql          , Zwsl        , Ql          , Zwsl        , Ql          , Zwsl        , Ql          
Md^Xm       , Md^Xm       , Md^Xm       , Md          , Md          , Uh          , Uh          , Zwsl        , Zwsl        , Zwsl^Vzps    , Zwsl        , Zwsl        , Zwsl        , Zwsl        , Zwsl        , Zwsl        , Zwsl        , Uu          , Zwsl        , Zwsl        , Zwsl        , Zwsl        , Zwsl        , Zwsl^Vzps    , Zwsl        , Zwsl        , Uu          , Zwsl        , Uu          , Uu          , Uu          , Zwsl        , Zwsl        , Zwsl        , Zwsl        , Zwsl        , Zwsl        , Ql          , Ql          , Zwsl        , Zwsl        , Ql^Bs/      , Zwsl        , Zwsl        , Zwsl        , Zwsl        
Md^Xm       , Md^Xm       , Md^Xm       , Md          , Md          , Uh          , Uh          , Uu          , Uu          , Zwsl        , Zwsl        , Zwsl        , Zwsl        , Zwsl        , Zwsl        , Zwsl        , Zwsl        , Zwsl        , Zwsl        , Zwsl        , Zwsl        , Zwsl        , Zwsl        , Zwsl        , Zwsl        , Zwsl        , Uu          , Uu          , Uu          , Uu          , Zwsl        , Zwsl        , Zwsl        , Zwsl        , Zwsl        , Zwsl        , Zwsl        , Ql          , Ql          , Ql          , Ql          , Ql          , Zwsl^Vzps    , Zwsl        , Zwsl        , Zwsl        
Md^Xm       , Md^Xm       , Md^Xm       , Md^Xm       , Md          , Md          , Uh          , Uh          , Uu          , Zwsl        , Zwsl        , Zwsl        , Zwsl        , Zwsl        , Chr         , Chr         , Zwsl        , Zwsl        , Zwsl        , Zwsl        , Zwsl        , Zwsl        , Zwsl        , Zwsl        , Zwsl        , Zwsl        , Zwsl        , Zwsl        , Uu          , Uu          , Zwsl        , Zwsl        , Zwsl        , Zwsl        , Zwsl        , Zwsl        , Zwsl        , Ql          , Ql          , Zwsl        , Zwsl        , Ql^Bs/      , Ql          , Zwsl        , Zwsl        , Zwsl        
Md^Xm       , Md^Xm       , Md^Xm       , Md^Xm       , Md^Xm       , Md          , Md          , Uh          , Uu          , Zwsl        , Zwsl        , Zwsl        , Chr         , Chr         , 5 Khr       , Chr         , Chr         , Zwsl        , Zwsl        , Zwsl        , Zwsl        , Zwsl        , Zwsl        , Zwsl        , Zwsl        , Zwsl        , Zwsl        , Zwsl        , Zwsl        , Zwsl        , Zwsl        , Zwsl        , Zwsl        , Zwsl        , Zwsl        , Zwsl        , Ql^Bs\      , Ql          , Zwsl        , Ql^Bs/      , Ql          , Ql          , Zwsl        , Ql          , Ql^Bs/      , Zwsl        
Md^Xm       , Md^Xm       , Md^Xm       , Md^Xm       , Md^Xm       , Md          , Md          , Uh          , Uu          , Uu          , Zwsl        , Zwsl        , Zwsl        , Chr         , Chr         , Chr         , Zwsl        , Zwsl        , Zwsl^Vzps    , Zwsl        , Uu          , Uu          , Uu          , Zwsl        , Zwsl        , Zwsl        , Zwsl        , Zwsl        , Zwsl        , Zwsl        , Zwsl        , Zwsl        , Zwsl        , Zwsl        , Zwsl        , Zwsl        , Ql          , Zwsl        , Zwsl        , Zwsl        , Ql          , Ql          , Ql^Bs/      , Zwsl        , Ql          , Ql          
Md^Xm       , Md^Xm       , Md^Xm       , Md^Xm       , Md          , Md          , Md          , Uh          , Uh          , Zwsl        , Zwsl        , Zwsl        , Zwsl        , Zwsl        , Zwsl        , Zwsl        , Zwsl        , Zwsl        , Zwsl        , Zwsl        , Zwsl        , Uu          , Uu          , Uu          , Zwsl        , Zwsl        , Zwsl        , Zwsl        , Zwsl        , Zwsl        , Zwsl        , Zwsl        , Zwsl        , Zwsl        , Zwsl        , Zwsl        , Ql          , Zwsl        , Ql          , Ql^Bs\      , Zwsl        , Zwsl        , Ql          , Zwsl        , Ql          , Zwsl        
Md^Xm       , Md^Xm       , Md^Xm       , Md^Xm       , Md^Xm       , Md          , Md          , Uh          , Uu          , Zwsl        , Zwsl        , Zwsl        , Zwsl        , Zwsl        , Zwsl        , Zwsl        , Zwsl        , Zwsl        , Zwsl        , Zwsl        , Zwsl        , Uu          , Zwsl        , Uu          , Zwsl        , Zwsl        , Zwsl        , Zwsl        , Zwsl        , Zwsl        , Uu          , Uu          , Uu          , Zwsl^Vzps    , Zwsl        , Zwsl        , Ql^Bs/      , Zwsl        , Ql          , Zwsl        , Zwsl        , Ql          , Ql          , Ql          , Ql^Bs/      , Zwsl        
Md^Xm       , Md^Xm       , Md^Xm       , Md^Xm       , Md          , Md          , Md          , Uh          , Zwsl        , Zwsl        , Zwsl        , Zwsl        , Zwsl        , Zwsl        , Zwsl        , Zwsl        , Zwsl        , Zwsl        , Zwsl        , Zwsl        , Zwsl        , Zwsl        , Zwsl        , Zwsl        , Zwsl        , Uu          , Zwsl        , Zwsl        , Chr         , Chr         , Uu          , Uu          , Uu          , Zwsl        , Zwsl        , Zwsl        , Zwsl        , Ql          , Zwsl        , Ql^Bs/      , Zwsl        , Ql          , Zwsl        , Zwsl        , Zwsl        , Ql          
Md^Xm       , Md^Xm       , Md^Xm       , Md^Xm       , Md          , Md          , Uh          , Uh          , Zwsl        , Zwsl        , Zwsl^Vzps    , Zwsl        , Zwsl        , Zwsl        , Zwsl        , Zwsl        , Zwsl        , Chr         , Chr         , Chr         , Chr         , Zwsl        , Zwsl        , Zwsl        , Uu          , Uu          , Zwsl        , Zwsl        , Chr         , Chr         , Chr         , Uu          , Zwsl        , Zwsl        , Zwsl        , Zwsl        , Zwsl        , Ql^Bs/      , Ql          , Ql          , Zwsl        , Ql          , Zwsl        , Zwsl        , Zwsl        , Zwsl        
Md^Xm       , Md^Xm       , Md^Xm       , Md^Xm       , Md          , Uh          , Uu          , Uu          , Zwsl        , Zwsl        , Zwsl        , Zwsl        , Zwsl        , Zwsl        , Zwsl        , Zwsl        , Chr         , Chr         , Chr         , 2 Khr       , Chr         , Zwsl        , Zwsl        , Zwsl        , Uu          , Uu          , Zwsl        , Zwsl        , Chr         , 3 Khr       , Chr         , Zwsl        , Zwsl        , Zwsl        , Zwsl        , Zwsl        , Zwsl        , Ql          , Zwsl        , Ql^Bs/      , Ql          , Ql          , Ql          , Zwsl        , Zwsl        , Zwsl        
Md^Xm       , Md^Xm       , Md^Xm       , Md          , Md          , Uh          , Zwsl        , Zwsl        , Zwsl        , Zwsl        , Zwsl        , Zwsl        , Zwsl        , Zwsl        , Zwsl        , Zwsl        , Zwsl        , Zwsl        , Zwsl        , Chr         , Zwsl        , Zwsl        , Zwsl        , Zwsl        , Zwsl        , Zwsl        , Zwsl        , Zwsl        , Zwsl        , Chr         , Zwsl        , Chr         , Zwsl        , Zwsl        , Zwsl        , Zwsl        , Zwsl        , Ql          , Ql^Bs/      , Zwsl        , Ql^Bs\      , Ql          , Zwsl        , Ql^Bs/      , Ql          , Zwsl        
Md^Xm       , Md^Xm       , Md          , Md          , Md          , Uh          , Zwsl        , Zwsl        , Zwsl        , Zwsl        , Zwsl        , Zwsl        , Zwsl        , Zwsl        , Zwsl        , Zwsl        , Zwsl        , Zwsl        , Zwsl        , Zwsl        , Zwsl        , Zwsl        , Zwsl        , Zwsl        , Zwsl        , Zwsl        , Zwsl        , Zwsl        , Zwsl        , Zwsl        , Zwsl        , Zwsl        , Zwsl        , Zwsl        , Zwsl        , Zwsl        , Zwsl        , Zwsl        , Zwsl        , Ql          , Ql          , Zwsl        , Zwsl        , Zwsl        , Ql          , Zwsl        
Md^Xm       , Md^Xm       , Md^Xm       , Md          , Md          , Zwsl        , Zwsl        , Uh          , Uh          , Zwsl        , Uh          , Zwsl        , Zwsl        , Zwsl        , Zwsl        , Zwsl        , Zwsl        , Zwsl        , Zwsl        , Zwsl        , Zwsl        , Zwsl        , Zwsl        , Zwsl^Vzps    , Zwsl        , Zwsl        , Zwsl        , Zwsl        , Zwsl        , Zwsl        , Zwsl        , Zwsl        , Zwsl        , Zwsl        , Zwsl        , Zwsl        , Zwsl        , Zwsl        , Zwsl        , Ql^Bs\      , Zwsl        , Ql^Bs/      , Ql          , Ql^Bs|      , Ql          , Zwsl        
Md^Xm       , Md^Xm       , Md^Xm       , Md^Xm       , Md^Xm       , Zwsl        , Md^Xm       , Md          , Md          , Uh          , Uh          , Uh          , Zwsl        , Zwsl        , Zwsl        , Zwsl        , Zwsl        , Zwsl        , Zwsl        , Zwsl        , Zwsl        , Zwsl        , Zwsl        , Zwsl        , Zwsl        , Zwsl        , Zwsl        , Zwsl        , Zwsl        , Zwsl        , Zwsl        , Zwsl        , Zwsl        , Zwsl        , Zwsl        , Zwsl        , Zwsl        , Zwsl        , Ql^Bs\      , Ql          , Ql          , Zwsl        , Ql          , Zwsl        , Zwsl        , Zwsl        
Xol         , Xol         , Xol         , Xol         , Xol         , Urb         , Xol         , Md^Xm       , Md          , Md          , Uh          , Uh          , Zwsl        , Zwsl^Vzps    , Zwsl        , Zwsl        , Zwsl        , Zwsl        , Zwsl        , Zwsl        , Uu          , Zwsl        , Uh          , Zwsl        , Uu          , Zwsl        , Uu          , Zwsl        , Zwsl        , Zwsl        , Uu          , Uu          , Uu          , Zwsl        , Zwsl        , Zwsl        , Zwsl^Vzps    , Zwsl        , Ql          , Zwsl        , Zwsl        , Ql^Bs|      , Zwsl        , Ql          , Ql          , Zwsl        
Xol         , Xol         , Urb         , Xol         , Urb         , Urb         , Xol         , Md^Xm       , Md^Xm       , Md          , Md          , Uh          , Uh          , Zwsl        , Zwsl        , Zwsl        , Zwsl        , Zwsl        , Zwsl        , Uu          , Uh          , Uh          , Uh          , Uh          , Uh          , Uh          , Uh          , Uh          , Uh          , Uu          , Uu          , Uu          , Uh          , Uu          , Zwsl        , Zwsl        , Zwsl        , Zwsl        , Zwsl        , Ql          , Zwsl        , Zwsl        , Ql          , Ql^Bs\      , Zwsl        , Ql^Bs/      
Xol         , Urb         , Xol         , Urb         , Xol         , Urb         , Xol         , Md^Xm       , Md^Xm       , Md          , Md          , Md          , Uh          , Zwsl        , Zwsl        , Zwsl        , Zwsl        , Zwsl        , Uh          , Uh          , Md          , Md          , Md          , Md          , Md          , Uh          , Md          , Uh          , Uh          , Uh          , Uh          , Uh          , Md          , Uh          , Uh          , Zwsl        , Zwsl        , Zwsl        , Zwsl        , Ql^Bs\      , Zwsl        , Zwsl        , Ql^Bs\      , Ql          , Zwsl        , Ql          
Xol         , Urb         , Xol         , Xol         , Xol         , Urb         , Xol         , Md^Xm       , Md^Xm       , Md^Xm       , Md^Xm       , Md          , Md^Xm       , Chr         , Chr         , Chr         , Chr         , Chr         , Md^Xm       , Md          , Md^Xm       , Md          , Md          , Md          , Md          , Md          , Md          , Md          , Md          , Uh          , Md          , Md          , Md          , Uh          , Md          , Uh          , Uh          , Zwsl        , Zwsl        , Ql          , Ql          , Ql^Bs|      , Zwsl        , Zwsl        , Zwsl        , Zwsl        
Xol         , Urb         , Urb         , Urb         , Urb         , Urb         , Xol         , Md^Xm       , Md^Xm       , Md^Xm       , Md^Xm       , Md^Xm       , Xol         , Urb         , Urb         , Khr         , Urb         , Urb         , Xol         , Md^Xm       , Md^Xm       , Md          , Md^Xm       , Md          , Md^Xm       , Md          , Md^Xm       , Md          , Md          , Md          , Md^Xm       , Md          , Md^Xm       , Md          , Md          , Md          , Uh          , Zwsl        , Ql          , Ql          , Ql          , Zwsl        , Zwsl        , Zwsl        , Zwsl        , Zwsl        
Xol         , Xol         , Urb         , Xol         , Xol         , Xol         , Xol         , Md^Xm       , Md^Xm       , Md^Xm       , Md^Xm       , Md^Xm       , Xol         , Urb         , Urb         , Urb         , Urb         , Urb         , Xol         , Md^Xm       , Md^Xm       , Md^Xm       , Md^Xm       , Md^Xm       , Md^Xm       , Md^Xm       , Md^Xm       , Md^Xm       , Md^Xm       , Md^Xm       , Md^Xm       , Md^Xm       , Md^Xm       , Md^Xm       , Md^Xm       , Md          , Md          , Zwsl        , Ql^Bs\      , Zwsl        , Zwsl        , Ql          , Ql^Bs/      , Zwsl        , Zwsl        , Zwsl        
Xol         , Urb^Vzps     , Urb         , Urb         , Urb         , Urb         , Xol         , Md^Xm       , Md^Xm       , Md^Xm       , Md^Xm       , Md^Xm       , Xol         , Urb         , Urb         , Urb         , Urb         , Urb         , Xol         , Md^Xm       , Md^Xm       , Md^Xm       , Md^Xm       , Md^Xm       , Md^Xm       , Md^Xm       , Md^Xm       , Md^Xm       , Md^Xm       , Md^Xm       , Md^Xm       , Md^Xm       , Md^Xm       , Md^Xm       , Md^Xm       , Md^Xm       , Md^Xm       , Ql          , Ql          , Zwsl        , Zwsl        , Zwsl        , Ql          , Ql          , Zwsl        , Zwsl        
Xol         , Xol         , Xol         , Xol         , Xol         , Xol         , Xol         , Md^Xm       , Md^Xm       , Md^Xm       , Md^Xm       , Md^Xm       , Xol         , Urb         , Urb         , Urb         , Urb         , Urb         , Xol         , Md^Xm       , Md^Xm       , Md^Xm       , Md^Xm       , Md^Xm       , Md^Xm       , Md^Xm       , Md^Xm       , Md^Xm       , Md^Xm       , Md^Xm       , Md^Xm       , Md^Xm       , Md^Xm       , Md^Xm       , Md^Xm       , Md^Xm       , Md^Xm       , Ql          , Ql          , Ql          , Ql          , Ql          , Ql          , Ql          , Ql          , Zwsl        
