border_size=1
usage=map

Md^Xm, Md^Xm, Md^Xm, Md^Xm, Md^Xm, Md^Xm, Md^Xm, Md^Xm, Md^Xm, Md^Xm, Md^Xm, Md^Xm, Md^Xm, Md^Xm, Md^Xm, Md^Xm, Md^Xm, Md^Xm, Md^Xm, Md^Xm, Md^Xm, Md^Xm, Md^Xm, Md^Xm, Md^Xm, Md^Xm, Md^Xm, Md^Xm, Xol, Urb, Urb, Urb, Urb, Urb, Xol, Md^Xm, Ql, Ql, Md^Xm, Md^Xm, Md^Xm, Md^Xm, Md^Xm, Md^Xm, Md^Xm, Md^Xm, Md^Xm, Md^Xm, Md^Xm, Md^Xm, Md^Xm, Md^Xm, Md^Xm, Md^Xm, Md^Xm, Md^Xm, Md^Xm, Md^Xm, Md^Xm
Md^Xm, Md^Xm, Md^Xm, Md^Xm, Md^Xm, Md^Xm, Md^Xm, Md^Xm, Md^Xm, Md^Xm, Md^Xm, Md^Xm, Md^Xm, Md^Xm, Md^Xm, Md^Xm, Md^Xm, Md, Md^Xm, Md^Xm, Md, Md^Xm, Md^Xm, Md^Xm, Md^Xm, Md^Xm, Md^Xm, Md^Xm, Xol, Urb, Urb, Urb, Urb, Urb, Xol, Md^Xm, Ql, Ql, Ql, Md^Xm, Md^Xm, Md^Xm, Md, Md^Xm, Md^Xm, Md^Xm, Md^Xm, Md^Xm, Md, Md^Xm, Md, Md, Md, Md, Md, Md^Xm, Md^Xm, Md^Xm, Md^Xm
Md^Xm, Md^Xm, Md^Xm, Md^Xm, Md^Xm, Md^Xm, Md^Xm, Md^Xm, Md^Xm, Md^Xm, Md^Xm, Md^Xm, Md, Md^Xm, Md, Md^Xm, Md, Md, Md, Md, Md, Md, Md^Xm, Md^Xm, Md^Xm, Md^Xm, Md^Xm, Md^Xm, Xol, Urb, Urb, Urb, Urb, Urb, Xol, Md^Xm, Md^Xm, Ql, Ql, Ql, Ql, Uu, Uu, Uu, Uu^Zewt, Uu, Uu, Uu^Zews, Zwsl, Md, Md, Md, Uh, Md, Md, Md^Xm, Md^Xm, Md^Xm, Md^Xm
Md^Xm, Md^Xm, Md^Xm, Md^Xm, Md^Xm, Md^Xm, Md^Xm, Md^Xm, Md, Md, Md, Md, Md, Md, Md, Md, Uh, Md, Md, Md, Md, Md, Md, Md, Md, Md^Xm, Md^Xm, Md^Xm, Xol, Urb, Urb, Urb, Urb, Urb, Xol, Md^Xm, Md^Xm, Md^Xm, Md, Ql, Ql, Ql, Ql^Bs|, Ql, Ql, Ql, Ql, Ql, Ql, Zgwl, Zwsl^Zewt, Uh, Chr, Uh, Md, Md, Md^Xm, Md^Xm, Md^Xm
Md^Xm, Md^Xm, Md^Xm, Md^Xm, Md^Xm, Md^Xm, Md^Xm, Md^Xm, Md, Md, Uh, Uh, Uh, Md, Md, Uh, Uh, Uh, Uh, Uh, Uh, Md, Md, Md, Md, Md, Md, Md^Xm, Md^Xm, Cud, Cud, 9 Kud, Cud, Cud, Md^Xm, Md^Xm, Md, Md, Md, Uh, Zwsl, Ql, Zwsl, Ql, Ql, Ql, Ql^Bs/, Zgwl, Zwsl, Ql^Bs/, Ql, Zgwl, Chr, 6 Khr, Chr, Md, Md^Xm, Md^Xm, Md^Xm
Md^Xm, Md^Xm, Md^Xm, Md^Xm, Md^Xm, Md^Xm, Md, Md, Md, Md, Uh, Uh, Uh, Md, Uh, Uh, Uh, Uu, Uu, Uh, Uh, Uh, Uh^Zewt, Uh, Uh, Md, Uh, Md, Md, Uh, Uu, Cud, Uu, Uh, Uh, Md, Md, Md, Uh, Uh, Uu, Zwsl, Zwsl^Zewe, Zwsl, Zwsl, Zwsl, Zwsl, Ql, Ql, Zwsl^Zewc, Ql, Zwsl^Zewc, Ql, Chr, Chr, Md, Md^Xm, Md^Xm, Md^Xm
Md^Xm, Md^Xm, Md^Xm, Md^Xm, Md, Md, Md, Md, Md, Md, Uh, Uh, Uh, Uh, Uh, Uh, Uh, Uu^Zewt, Uu, Uu^Zews, Uu, Uu, Uu, Uh, Uh, Uh, Uh, Uh, Uh, Uh, Uu, Zgwl, Zwsl, Uu, Uu, Uh, Uh, Uh, Uu, Uu, Zwsl, Zwsl, Zwsl, Zwsl, Zwsl, Zgwl, Zwsl, Zwsl, Chr, Ql, Ql, Ql, Ql, Ql, Ql, Md, Md, Md^Xm, Md^Xm
Md^Xm, Md^Xm, Md^Xm, Md^Xm, Md, Md, Uh, Uh, Uh, Uh, Uh, Uh, Uu, Uu^Zewc, Uu, Uu, Uu, Uu, Zgwl, Zwsl, Zgwl, Zwsl, Zwsl^Zewe, Uu, Uu^Zewc, Uh, Uu, Uh, Uu, Uu^Zewt, Zwsl^Zews, Zwsl, Zwsl^Zewe, Zwsl, Uu, Uu, Uu, Uu, Zwsl, Uu, Zwsl, Zwsl^Zewt, Uu, Uu, Zwsl, Zwsl, Chr, Chr, Chr, Zwsl, Zwsl, Ql, Ql, Ql, Ql, Ql, Md, Md^Xm, Md^Xm
Md^Xm, Md^Xm, Md^Xm, Md^Xm, Md, Md, Uh, Uh, Uu, Uh, Uu, Uh, Zgwl, Zwsl, Zwsl^Zewe, Zwsl, Zwsl, Zwsl, Zwsl^Zewe, Zwsl, Zwsl^Vzps, Zwsl, Zgwl, Zwsl, Uu, Uu^Zewt, Chr, Uu^Zewc, Uu, Zwsl, Uu, Zwsl, Zwsl, Zgwl, Zwsl, Zwsl, Zwsl^Zewc, Chr, Zwsl, Zgwl, Zwsl, Zwsl^Vzps, Zwsl, Zwsl, Zwsl, Chr, Chr, Khr, Chr, Zwsl, Zgwl, Zwsl, Zwsl, Zwsl^Zewc, Ql, Ql, Ql, Md^Xm, Md^Xm
Md^Xm, Md^Xm, Md^Xm, Md, Md, Md, Uh, Uu, Uu, Uu^Zewt, Uu, Uu, Zwsl, Zwsl, Zwsl^Zewc, Chr, Chr, Zwsl, Chr, Zwsl, Zgwl, Zwsl, Zwsl, Zwsl^Zewc, Zwsl, Uu, Chr, Chr, Zwsl, Zwsl, Zwsl, Uu^Zewe, Uu, Zgwl, Zwsl^Vzps, Zwsl, Chr, Chr, Chr, Zwsl, Zwsl^Zewt, Zwsl, Zwsl, Zwsl^Zewc, Zwsl, Chr, Chr, Chr, Zwsl, Zwsl, Zwsl^Zews, Zwsl, Zwsl^Zewc, Zwsl, Zwsl, Ql, Ql, Md^Xm, Md^Xm
Md^Xm, Md^Xm, Md^Xm, Md, Md, Md, Uh, Uh, Uh, Uu, Uu^Zews, Zwsl, Zwsl, Zwsl, Chr, Chr, Khr, Chr, Chr, Chr, Zwsl, Zwsl, Zgwl, Zwsl, Zwsl^Zewc, Zwsl^Zewt, Chr, Chr, Chr, Zwsl^Zewc, Zwsl, Uu, Uu, Zwsl, Zwsl, Zwsl, Chr, 8 Khr, Zwsl, Zwsl, Uu, Uu, Zwsl, Zgwl, Zwsl, Zwsl, Zwsl, Zwsl, Zwsl^Zewt, Zwsl, Zwsl^Zewt, Zwsl, Zgwl^Zewc, Zwsl, Zwsl, Ql, Ql, Ql, Ql
Md^Xm, Md^Xm, Md^Xm, Md, Md, Md, Uh, Uh, Uu, Uu, Zwsl, Zwsl, Zwsl, Chr, Chr, Chr, Chr, Chr, Chr, Chr, Zwsl, Zwsl, Zwsl, Zwsl, Zwsl, Zwsl, Zwsl, 7 Khr, Chr, Zwsl, Zgwl, Zwsl, Zwsl, Zwsl^Zewc, Zwsl^Zewt, Zwsl, Chr, Chr, Zgwl, Zwsl, Uu, Zwsl, Zgwl, Zwsl, Chr, Zwsl, Zwsl^Zewt, Zwsl, Zwsl, Zwsl^Zewt, Uu, Uu, Zwsl, Zwsl, Zwsl^Zewc, Zwsl, Ql, Ql, Ql
Md^Xm, Md^Xm, Md^Xm, Md^Xm, Md, Md, Md, Uh, Uh, Uu^Zews, Uu, Zwsl^Zewt, Zwsl, Zwsl, Zwsl, Zwsl, Zwsl, Zwsl, Zwsl, Zwsl, Zwsl, Zwsl^Zewc, Uu, Zwsl^Vzps, Uu, Zgwl^Zewt, Zwsl, Chr, Chr, Zwsl, Chr, Zwsl, Zwsl^Zewt, Zwsl^Zewt, Chr, Chr, Chr, Zwsl, Zwsl, Uu, Uh, Zwsl, Zwsl, Chr, Chr, Chr, Chr, Zwsl, Zwsl^Zewt, Uu, Uh, Uu, Uu, Zwsl, Zwsl, Zwsl, Zwsl, Ql, Ql
Md^Xm, Md^Xm, Md^Xm, Md^Xm, Md^Xm, Md, Md, Uh, Uh, Uu, Uu, Uu, Zwsl, Zgwl, Zwsl, Zwsl^Zewt, Uu, Zgwl, Zwsl, Zwsl^Vzps, Zwsl^Zewc, Zgwl, Uu, Uh, Uu^Zews, Zwsl, Zwsl^Zewe, Zwsl, Zgwl, Chr, Chr, Chr, Zwsl, Zwsl, Zwsl, Chr, Zwsl, Zgwl, Zwsl, Uu, Zwsl^Zewt, Zwsl, Zwsl, Zwsl, Chr, Khr, Chr, Zwsl, Zwsl, Zwsl, Uh, Uu, Uu^Zews, Zwsl, Zwsl^Zews, Zwsl^Zewt, Zwsl, Zwsl, Zwsl
Md^Xm, Md^Xm, Md^Xm, Md^Xm, Md^Xm, Md, Md, Md, Uh, Uh, Uu, Zgwl, Uu, Zwsl, Uu, Uu^Zewt, Uu, Zwsl, Zwsl^Zewc, Zwsl, Zwsl, Zwsl^Zewt, Uu, Uh, Uh, Uu, Uu, Zwsl^Zewt, Zwsl, Zwsl, Zwsl, Zwsl, Zwsl^Zewc, Zwsl^Zews, Zwsl, Zwsl, Zwsl, Zwsl, Zwsl^Zewe, Zwsl, Uh, Zwsl^Vzps, Zwsl, Zwsl, Zwsl, Chr, Zgwl, Zwsl^Zewc, Zwsl, Zwsl^Zewc, Uu^Zewe, Uu, Uu, Zwsl, Zgwl, Zwsl, Zwsl^Zewc, Zwsl, Zwsl
Md^Xm, Md^Xm, Md^Xm, Md^Xm, Md^Xm, Md, Md, Md, Uh, Uh, Uu, Uu, Zwsl, Zwsl^Zewc, Uu, Zwsl, Zwsl^Zews, Zwsl, Zgwl, Chr, Chr, Zwsl, Zwsl, Uu, Uu, Zgwl, Zwsl, Zwsl, Zwsl^Vzps, Zgwl, Zwsl, Zwsl^Zewc, Zwsl, Zwsl, Zgwl, Zwsl^Vzps, Zwsl, Zwsl^Zewt, Uu, Uh, Uh, Uh, Zwsl, Zgwl, Zwsl, Zwsl, Zwsl, Zwsl, Zgwl, Zwsl, Zwsl, Zgwl, Zwsl, Zwsl, Zwsl, Zwsl, Zwsl, Zwsl, Zwsl
Md^Xm, Md^Xm, Md^Xm, Md^Xm, Md^Xm, Md, Md, Uh, Uh, Uu, Zgwl, Zgwl, Zwsl^Zewt, Zwsl^Zewc, Zwsl, Zwsl, Zwsl, Zwsl, Zwsl, Chr, Chr, Khr, Chr, Zwsl, Zwsl^Zews, Zwsl, Zwsl^Zewe, Zwsl, Zwsl, Zwsl, Chr, Zwsl, Chr, Zwsl, Zwsl, Zwsl, Zwsl, Zwsl, Uu^Zewt, Uh, Zwsl^Zewt, Uu, Zwsl, Zwsl, Zwsl, Zwsl^Zewt, Zwsl, Uu, Uu, Zwsl, Zwsl^Zewt, Zwsl, Uu^Vzps, Zwsl, Zwsl^Zewc, Zwsl, Uu, Uu, Zwsl
Md^Xm, Md^Xm, Md^Xm, Md^Xm, Md, Md, Md, Uh, Uu, Uu^Zewc, Zwsl, Zwsl, Zwsl, Zwsl, Zgwl, Uu, Uu, Uu^Zewe, Zwsl, Zwsl, Zwsl, Chr, Zwsl^Zewc, Zwsl, Zwsl, Zgwl, Zwsl, Zwsl, Zwsl, Chr, Chr, Chr, Chr, Chr, Zgwl, Zwsl, Zwsl^Zewt, Zwsl, Zwsl, Uu, Zwsl, Zwsl, Chr, Chr, Chr, Zwsl, Uu, Uu^Zewt, Zwsl, Zwsl, Zwsl^Zewc, Zwsl, Uu, Zwsl, Uu, Uu, Uh, Uh, Uh
Md^Xm, Md^Xm, Md^Xm, Md^Xm, Md, Md, Uh, Uh, Uu^Zewt, Zwsl, Zwsl, Zwsl^Vzps, Zwsl^Zewe, Zwsl^Zewe, Zwsl, Zwsl, Uu^Zews, Uh, Uh, Zgwl, Zwsl, Zwsl, Zwsl, Zwsl, Zwsl, Zgwl, Zwsl, Chr, Chr, Chr, Chr, Khr, Chr, Chr, Zwsl, Zwsl, Zwsl^Vzps, Zwsl, Zgwl, Zwsl, Zwsl, Chr, 5 Khr, Chr, Chr, Zwsl, Zwsl^Zews, Zwsl, Zgwl, Zwsl, Uu, Uu, Uu, Uu, Uu, Uh, Md, Md, Md
Md^Xm, Md^Xm, Md^Xm, Md, Md, Md, Uh, Uh, Uu, Zwsl, Zwsl, Zgwl, Zwsl, Zwsl, Chr, Chr, Zwsl, Uh, Zwsl^Zewc, Uh, Uh, Zwsl, Uu, Zwsl, Zwsl^Vzps, Zwsl^Zewt, Zwsl, Zwsl^Zews, Zwsl, Zwsl, Zwsl, Chr, Zwsl, Chr, Zwsl, Zwsl, Zwsl, Zwsl, Zwsl, Zwsl, Zgwl, Chr, Chr, Chr, Zwsl, Zwsl, Zwsl, Zwsl, Uu, Uu, Uu^Zewc, Uu^Zewe, Uh, Uh, Md, Md, Md, Md^Xm, Md^Xm
Md^Xm, Md^Xm, Md^Xm, Md, Md, Uh, Uh, Uu, Uu^Zewe, Zgwl, Uu, Zwsl, Zwsl, Chr, 4 Khr, Chr, Zwsl, Zwsl, Zwsl, Uu, Uu, Uu^Zews, Uu, Uu, Zwsl, Zwsl, Zwsl, Zwsl^Zewe, Zwsl, Zwsl^Zewe, Zwsl^Zewc, Zwsl, Zgwl, Zwsl, Zwsl, Zwsl^Zewc, Zwsl, Uu, Uu, Zwsl, Zgwl, Zwsl, Zwsl, Chr, Zwsl, Zwsl^Zewt, Zwsl^Vzps, Zwsl, Uu^Zewc, Uu, Uu, Uh, Uh^Zewe, Uh, Md, Md, Md^Xm, Md^Xm, Md^Xm
Md^Xm, Md^Xm, Md^Xm, Md, Md, Uh, Uh, Uh, Uh, Uu, Uu^Zewc, Zwsl, Zwsl^Zewt, Chr, Chr, Chr, Zwsl, Zgwl, Zwsl, Zwsl, Zwsl, Zwsl, Zwsl, Zwsl^Zews, Zwsl, Zwsl^Zewc, Zwsl, Zwsl, Zgwl, Zwsl, Uu, Uu, Uu, Zwsl, Zwsl^Zewt, Zwsl, Zwsl^Zewt, Zwsl, Zwsl, Zwsl, Zwsl^Zews, Zwsl, Zwsl^Zewt, Zwsl, Zwsl, Zwsl, Zwsl, Zwsl, Zwsl, Uu, Uu, Uh, Uh, Md, Md, Md, Md^Xm, Md^Xm, Md^Xm
Md^Xm, Md^Xm, Md^Xm, Md, Md, Md, Uh, Uh, Uh, Uu, Uu^Zewe, Zgwl, Zwsl, Chr, Chr, Zwsl, Zwsl^Zewc, Zwsl^Zewe, Zwsl, Zwsl^Zewc, Zwsl, Zwsl^Zewt, Zwsl, Zwsl, Zwsl, Zgwl, Zwsl, Zwsl, Uu, Uu, Uh, Uu^Zewe, Uu^Zewe, Zwsl, Zwsl, Zwsl, Zwsl, Zwsl, Chr, Zwsl, Zgwl, Zwsl, Zwsl, Zwsl, Chr, Chr, Chr, Zwsl^Zewt, Zwsl, Uu^Zews, Uu, Uh^Zewt, Uh, Md, Md, Md, Md^Xm, Md^Xm, Md^Xm
Md^Xm, Md^Xm, Md, Md, Md, Md, Uh, Uh, Uu, Uu, Zwsl, Zwsl, Zwsl^Zewc, Zwsl, Zwsl, Zwsl, Zgwl, Zwsl, Uu, Zwsl^Zewe, Zwsl^Zewc, Zwsl, Zwsl, Zwsl^Zews, Zwsl, Zwsl, Zwsl, Zwsl^Zewe, Zwsl, Zwsl^Zewc, Uu^Zewc, Uu, Zwsl, Zwsl, Zwsl, Chr, Chr, Zwsl, Chr, Chr, Zwsl, Zwsl, Zwsl, Chr, Chr, Khr, Chr, Chr, Uu, Uu, Uh, Uh, Md, Md, Md, Md, Md^Xm, Md^Xm, Md^Xm
Md^Xm, Md^Xm, Md, Md, Md, Uh, Uh, Uh, Uu, Zgwl, Zwsl, Zwsl, Zwsl, Zwsl, Zgwl, Zwsl, Uu, Uu, Uu^Zewc, Zwsl^Zewt, Zwsl, Zwsl, Chr, Chr, Chr, Chr, Chr, Zwsl, Zwsl^Zewt, Zwsl, Uu^Vzps, Zwsl, Zwsl^Zewt, Zwsl, Zwsl^Zewt, Chr, Chr, Khr, Chr, Chr, Zwsl, Zgwl, Zwsl, Chr, Chr, Chr, Chr, Chr, Uu, Uu, Uh, Uh, Md, Md, Md, Md, Md^Xm, Md^Xm, Md^Xm
Md^Xm, Md^Xm, Md, Md, Md, Md, Uh, Uh^Zewt, Uh, Uu, Uu, Chr, Chr, Zwsl, Zwsl, Zwsl, Uu, Uu^Vzps, Uh, Zwsl, Chr, Chr, Chr, Khr, Chr, Chr, Zwsl, Zwsl, Zgwl, Zwsl, Uu, Zwsl, Zwsl, Zwsl, Zwsl, Chr, Chr, Chr, Chr, Zwsl, Zwsl, Zwsl^Zewe, Zwsl, Zwsl^Zewt, Zwsl, Zwsl, Zwsl, Zwsl, Zwsl, Uu, Uu, Uh, Uh, Md, Md, Md, Md^Xm, Md^Xm, Md^Xm
Md^Xm, Md^Xm, Md^Xm, Md, Md, Md, Uh, Uh, Uu, Uu^Zews, Uu, Chr, Chr, Chr, Chr, Zwsl^Zewc, Zwsl, Uh, Uh^Zewc, Zwsl, Zwsl, Chr, Zwsl, Chr, Chr, Chr, Zwsl, Zwsl, Uu, Uu, Uu, Zwsl^Zews, Zwsl^Zewt, Zgwl, Zwsl, Zwsl, Zwsl^Zewc, Chr, Zwsl, Zwsl, Uu, Zwsl^Zews, Zwsl, Zgwl, Zwsl, Zwsl, Zwsl, Zwsl^Zewc, Zwsl^Vzps, Uu, Uu, Uh, Uh, Md, Md, Md, Md^Xm, Md^Xm, Md^Xm
Md^Xm, Md^Xm, Md^Xm, Md^Xm, Md, Md, Uh, Uh, Uu^Zewe, Uu, Zwsl^Zewt, Chr, Chr, Khr, Chr, Zwsl, Zwsl, Uh, Uh, Zwsl, Zwsl, Zgwl, Zwsl^Zewe, Zwsl, Zwsl^Zewc, Zwsl, Zwsl^Zewe, Uu, Zwsl, Uu^Zewe, Uu, Zwsl, Zwsl, Zwsl, Zwsl^Vzps, Zwsl, Zwsl, Zwsl, Zwsl, Uu, Zwsl^Zewt, Zwsl, Zwsl^Zewc, Zwsl, Chr, Chr, Zwsl, Zwsl, Uu, Uu, Uu, Uh, Uh, Md, Md, Md, Md^Xm, Md^Xm, Md^Xm
Md^Xm, Md^Xm, Md^Xm, Md^Xm, Md, Md, Uh, Uh, Uh, Uu, Zwsl, Zwsl, Zgwl, Chr, Zwsl, Chr, Zwsl, Zwsl^Zewc, Uh, Uh, Uu, Zwsl^Zewc, Zwsl, Zwsl, Zwsl, Zwsl^Zews, Zwsl, Zwsl, Uu^Zewc, Uu, Zwsl, Zwsl, Chr, Zwsl, Chr, Zwsl, Zwsl, Zgwl, Uu, Uu, Uu^Zews, Zwsl, Zwsl, Chr, Khr, Chr, Chr, Zwsl, Uu^Zewc, Uu^Zewt, Uu, Uh, Uh, Md, Md, Md^Xm, Md^Xm, Md^Xm, Md^Xm
Md^Xm, Md^Xm, Md^Xm, Md^Xm, Md, Md, Md, Uh, Uh, Uu, Uu, Uu^Zewe, Zwsl, Zwsl^Zewc, Zwsl^Zewe, Zwsl, Zwsl^Zewt, Zwsl, Uu, Uu^Zewe, Zwsl, Zwsl, Zwsl^Zewt, Chr, Zwsl, Zwsl, Zgwl, Zwsl, Zwsl, Zwsl, Zwsl, Zwsl^Zews, Chr, Chr, Chr, Chr, Zwsl^Zews, Zwsl, Uu^Zewt, Uu, Uu, Zwsl^Zewt, Zgwl, Chr, Chr, Chr, Zwsl, Uu, Uu, Uu, Uu^Zewt, Uh, Md, Md, Md, Md^Xm, Md^Xm, Md^Xm, Md^Xm
Md^Xm, Md^Xm, Md^Xm, Md^Xm, Md, Md, Uh, Uh, Uh, Uh, Uh, Uu, Uu^Vzps, Zwsl, Zwsl, Zwsl, Zwsl, Uu, Uu, Zwsl, Zwsl, Zwsl, Chr, Chr, Chr, Zwsl, Chr, Zwsl, Zwsl^Vzps, Zwsl, Zgwl^Zewt, Zwsl, Chr, Khr, Chr, Chr, Zwsl, Zwsl, Uu, Uh, Uu^Zewc, Zwsl, Zwsl^Zews, Chr, Zwsl, Zwsl, Zwsl, Zwsl^Zewc, Uu, Uh, Uh, Uh, Md, Md, Md, Md^Xm, Md^Xm, Md^Xm, Md^Xm
Md^Xm, Md^Xm, Md, Md, Md, Md, Uh, Uh, Uh^Zewt, Uh, Uu, Uu, Uu, Uu, Zgwl, Zgwl, Zwsl, Zgwl, Zwsl, Zgwl, Zwsl, Chr, Chr, 3 Khr, Chr, Chr, Chr, Zwsl, Zwsl, Zwsl, Zwsl^Zewt, Zwsl, Zwsl, Chr, Zwsl, Zwsl, Zwsl^Zewc, Zwsl, Zwsl, Uu, Zwsl, Uu, Zwsl, Zwsl, Zwsl, Zgwl, Zwsl, Zwsl, Uu^Zewt, Uu, Uh, Uh, Md, Md, Md^Xm, Md^Xm, Md^Xm, Md^Xm, Md^Xm
Md^Xm, Md^Xm, Md^Xm, Md, Md, Md, Md, Uh, Uh, Uh, Uu, Zgwl, Uu, Uu, Zwsl, Zwsl, Zwsl, Zwsl, Zwsl, Zwsl, Zwsl, Chr, Zwsl, Chr, Zwsl, Chr, Zwsl^Zewt, Zwsl, Zwsl, Zwsl, Zwsl, Zwsl, Zwsl, Zwsl, Zwsl^Zews, Zwsl, Zwsl, Zgwl, Zwsl, Zwsl^Vzps, Zwsl, Zwsl^Zewc, Zwsl^Zewc, Zwsl, Zgwl, Uu, Uu, Zgwl, Uu, Uu, Uh, Uh, Uh, Md, Md, Md^Xm, Md^Xm, Md^Xm, Md^Xm
Md^Xm, Md^Xm, Md^Xm, Md^Xm, Md, Md, Uh, Uh, Uh, Uu, Uu^Zewt, Uu, Chr, Uu^Zews, Chr, Zwsl^Zewc, Chr, Zwsl^Zewt, Zwsl, Zwsl^Zews, Zwsl, Zwsl^Zewc, Zwsl^Zews, Zwsl, Zwsl^Zews, Zwsl, Zwsl, Zwsl, Zwsl, Zgwl, Zwsl, Uu, Uu, Zwsl, Uu, Uu, Uu, Zwsl, Zwsl^Zewc, Zwsl^Zewt, Zwsl^Zewt, Zwsl, Zwsl, Zwsl^Zewe, Zwsl, Uu, Uu, Uu, Uu^Zews, Uu, Uh, Uh, Md, Md, Md^Xm, Md^Xm, Md^Xm, Md^Xm, Md^Xm
Md^Xm, Md^Xm, Md^Xm, Md^Xm, Md, Md, Uh, Uh, Uu, Uu, Uu, Uu, Chr, Chr, Chr, Chr, Chr, Chr, Zwsl, Zwsl, Zwsl, Zwsl, Uu, Uu, Uu, Zwsl, Zgwl, Zwsl, Zwsl, Zwsl, Zwsl, Uu, Uu, Uu, Uh, Uu, Zwsl, Zwsl, Zwsl, Zwsl, Zwsl, Zwsl, Zgwl^Zewt, Zwsl^Zewt, Zwsl, Uu^Zewe, Uu^Zewt, Uu, Uu^Zewc, Uu, Uh, Md, Md, Md, Md^Xm, Md^Xm, Md^Xm, Md^Xm, Md^Xm
Md^Xm, Md^Xm, Md^Xm, Md, Md, Md, Md, Uh, Uh, Uu^Zewt, Zwsl, Zwsl, Zwsl, Chr, Chr, Khr, Chr, Chr, Chr, Chr, Zwsl, Zwsl^Zewc, Uh, Uu^Vzps, Zgwl^Zewt, Zwsl, Zwsl, Zwsl, Chr, Zwsl, Zwsl^Zewe, Zwsl^Zewc, Zwsl, Uu, Uu, Uu, Zwsl, Zwsl, Chr, Chr, Chr, Zwsl, Zwsl, Zwsl^Zewc, Zwsl, Zwsl, Zwsl, Uu, Uu^Zewc, Uu, Uh, Md, Md, Md, Md, Md, Md^Xm, Md^Xm, Md^Xm
Md^Xm, Md^Xm, Md^Xm, Md, Md, Md, Uh, Uh, Uh, Uu, Zwsl, Zwsl^Zewc, Zwsl, Zgwl, Zwsl, Chr, Chr, Chr, Chr, Chr, Zwsl, Uu, Uu, Uu, Zwsl, Zwsl^Zews, Zwsl, Chr, Chr, Chr, Chr, Zwsl, Zwsl^Zewt, Zwsl, Zgwl, Zwsl^Vzps, Zwsl, Chr, Chr, 2 Khr, Chr, Chr, Zwsl, Zwsl, Zwsl^Zews, Zgwl, Zwsl, Zwsl, Uu, Uu, Uh, Uh, Md, Md, Md, Md, Md^Xm, Md^Xm, Md^Xm
Md^Xm, Md^Xm, Md^Xm, Md, Md, Md, Uh, Uh, Uu, Uu^Zewc, Zgwl, Zwsl, Zgwl, Zwsl, Zwsl^Zewc, Zwsl, Zgwl, Zwsl, Zwsl, Zwsl, Zgwl, Zwsl, Zwsl, Uu, Zwsl, Zwsl, Chr, Chr, Khr, Chr, Chr, Zwsl, Zwsl, Zwsl, Zwsl, Zwsl, Zwsl, Zwsl, Chr, Chr, Chr, Zwsl, Zwsl, Zwsl^Zewc, Zwsl, Zwsl, Uu, Uu, Uu^Zewt, Uu, Uu, Uh, Uh, Md, Md, Md, Md, Md^Xm, Md^Xm
Md^Xm, Md^Xm, Md^Xm, Md, Md, Md, Uh, Uh, Uu, Zwsl, Zwsl^Zewc, Zwsl, Zwsl^Zewe, Zwsl, Zwsl, Zwsl, Zwsl, Zwsl^Zewt, Zwsl, Zwsl, Zwsl, Zwsl, Zwsl^Zewc, Zwsl^Zewt, Zwsl, Zwsl, Chr, Chr, Chr, Chr, Zwsl^Zewt, Zwsl, Zwsl^Zewc, Zwsl^Zewt, Zwsl, Zgwl, Zwsl, Zwsl, Chr, Chr, Zwsl, Zwsl, Zwsl^Zewe, Zwsl, Zwsl^Zewt, Zwsl^Vzps, Zwsl, Uu^Zewt, Uu, Uu, Uu^Zewt, Uu, Uh, Uh, Md^Zewe, Md, Md, Md^Xm, Md^Xm
Md^Xm, Md^Xm, Md, Md, Md, Uh, Uh, Uh, Uu^Zewt, Uu, Zwsl, Zwsl, Zwsl, Zwsl^Zewt, Zwsl^Vzps, Zgwl, Zwsl, Zwsl, Zwsl, Zwsl^Zews, Zwsl^Zewt, Zwsl, Zwsl, Zwsl, Zgwl, Zwsl, Chr, Chr, Zwsl, Zwsl, Zwsl, Zwsl, Zgwl, Zwsl, Zwsl, Zwsl^Zewc, Zwsl, Zwsl, Zwsl, Zwsl, Zwsl, Zwsl, Zwsl^Zewe, Zwsl, Zwsl, Zwsl, Zwsl^Zewc, Uu, Uu, Uu^Zewc, Uu, Uu, Uh, Uh, Md, Md, Md, Md^Xm, Md^Xm
Md^Xm, Md^Xm, Md, Md, Md, Uh, Uh, Uu, Uu, Zwsl, Zwsl, Zwsl^Zewe, Zwsl^Zewt, Zwsl, Zwsl, Zwsl, Zwsl^Zewc, Zgwl, Zwsl, Zwsl, Zwsl, Zwsl^Zewe, Zwsl, Zwsl, Zwsl, Zwsl, Zwsl, Zwsl^Zewe, Zwsl, Zwsl^Zewe, Zwsl^Zewc, Zwsl, Zwsl, Zwsl, Zwsl^Zews, Zwsl, Zwsl^Zewt, Zwsl, Zwsl, Zwsl^Zewt, Zgwl^Zewt, Zwsl, Zwsl, Zwsl, Chr, Zwsl, Zwsl^Zewt, Zwsl, Zgwl, Uu, Uu, Uh, Uh, Md, Md, Md, Md, Md^Xm, Md^Xm
Md^Xm, Md^Xm, Md^Xm, Md, Uh, Uh, Uh, Uh, Uh, Zwsl, Zgwl, Zwsl, Zgwl, Zwsl, Zwsl^Zewe, Zwsl, Zwsl, Zwsl, Zwsl, Zwsl^Zewc, Zwsl, Zwsl, Zwsl^Zewt, Zwsl, Zwsl, Zwsl, Zwsl, Zwsl, Zwsl^Zewt, Zwsl, Zwsl, Zwsl, Uu, Uu, Uu, Zwsl, Zwsl, Zwsl, Zgwl, Zwsl, Zwsl, Zwsl, Zwsl, Zwsl^Zewc, Chr, Chr, Chr, Zwsl, Uu, Uu, Uh, Uh, Md, Md, Md, Md, Md^Xm, Md^Xm, Md^Xm
Md^Xm, Md^Xm, Md^Xm, Md, Md, Uh, Uh, Uh, Zwsl^Zewe, Zwsl, Zwsl, Zwsl, Zwsl^Zews, Zwsl, Zwsl, Zwsl^Zewt, Uu, Zwsl, Zwsl^Zewt, Zwsl, Uu^Zewc, Zwsl, Zwsl, Zwsl^Zewc, Zwsl, Zgwl, Zwsl^Zewt, Zwsl, Zwsl, Zwsl, Zwsl^Zews, Uu^Vzps, Uu, Uu, Uu^Zewe, Uu, Uu, Zwsl, Zwsl, Zwsl, Zwsl, Zwsl^Zewc, Zwsl, Zwsl, Chr, Khr, Chr, Zwsl, Uu, Uu, Uh, Uh, Uh, Md, Md, Md^Xm, Md^Xm, Md^Xm, Md^Xm
Md, Md^Xm, Md, Md, Uh, Uh, Zwsl, Zwsl, Zwsl, Zwsl^Zewt, Zwsl, Zwsl, Zwsl, Zwsl, Uu, Uu, Uu, Uu, Uu, Uu, Uu, Zwsl, Uu, Zwsl, Zwsl^Zewe, Zwsl, Uu, Zwsl, Uu, Zwsl, Uu, Uu, Uh, Uh, Uh, Uu, Uu, Uu^Zews, Zwsl, Zwsl, Uu, Uu, Zwsl, Zwsl^Zewt, Zgwl, Chr, Uu, Uu, Uu^Zewe, Uu^Zews, Uh, Uh, Uh, Md, Md, Md, Md^Xm, Md^Xm, Md^Xm
Uh, Md, Uh, Uh, Uh, Uh, Zwsl, Zgwl, Zwsl, Zwsl, Zwsl, Zgwl, Uu, Uu, Uh, Uh, Uh, Uh, Uh, Uh, Uh, Uu, Uu, Uu, Uu, Uu, Uu, Uu^Zewt, Uu, Uu, Uu, Uu, Uh, Uh, Uh, Uh, Uh, Uu, Uu, Uu^Zewe, Uu, Uu^Vzps, Uu, Zwsl, Uu, Zwsl, Uu, Uu, Uh, Uu, Uh, Uh, Md, Md, Md, Md^Xm, Md, Md^Xm, Md^Xm
Zwsl, Uh, Zwsl^Zewe, Uh, 1 Zwsl, Zwsl, Zwsl, Zwsl, Zwsl, Zwsl, Uh, Uu, Uh, Uh, Md, Uh, Md, Uh, Md, Uh, Uh, Uh, Uh, Uu, Uu, Uu, Uh, Uu, Uh, Uh, Uh, Uh, Uh, Md, Md, Uh, Uh, Uh, Uh, Uh, Uh, Uu, Uh, Uu, Uu, Uu, Uh, Uh, Uh, Uh, Uh, Md, Md, Md, Md, Md, Md, Md^Xm, Md^Xm
Uh, Zwsl, Zwsl, Zwsl, Zwsl, Zwsl, Uh, Uh, Uh, Uh, Uh, Uh, Uh, Md, Md, Md, Md, Md, Md, Md, Md, Uh, Uh, Uh, Uh, Uh, Uh, Uh, Uh, Uh, Uh, Uh, Md, Md, Md, Md, Md, Uh, Md, Uh, Uh, Uh, Uh, Uh, Uh, Uh, Uh, Uh, Md, Uh, Md, Uh, Md, Md, Md, Md, Md, Md^Xm, Md^Xm
Uh, Zwsl, Uh, Zwsl, Uh, Uh, Md, Uh, Md, Md, Md, Md, Md, Md, Md, Md, Md, Md, Md, Md, Md, Md, Md, Uh, Uh, Uh, Md, Uh, Md, Md, Md, Md, Md^Xm, Md^Xm, Md^Xm, Md, Md, Md, Md, Md, Md, Uh, Md, Md, Md, Md, Md, Md, Md, Md, Md, Md, Md, Md, Md, Md, Md, Md^Xm, Md^Xm
Md^Xm, Uh, Md, Uh, Md, Md, Md, Md, Md, Md, Md, Md, Md, Md, Md, Md^Xm, Md^Xm, Md, Md^Xm, Md^Xm, Md^Xm, Md, Md, Md, Md, Md, Md, Md, Md, Md, Md^Xm, Md^Xm, Md^Xm, Md^Xm, Md^Xm, Md^Xm, Md^Xm, Md^Xm, Md^Xm, Md, Md, Md, Md, Md, Md^Xm, Md, Md, Md, Md^Xm, Md^Xm, Md^Xm, Md, Md, Md, Md^Xm, Zwsl, Md, Md^Xm, Md^Xm
Md^Xm, Md^Xm, Md^Xm, Md, Md, Md, Md^Xm, Md^Xm, Md^Xm, Md, Md^Xm, Md^Xm, Md^Xm, Md^Xm, Md^Xm, Md^Xm, Md^Xm, Md^Xm, Md^Xm, Md^Xm, Md^Xm, Md^Xm, Md^Xm, Md^Xm, Md^Xm, Md, Md^Xm, Md, Md^Xm, Md^Xm, Md^Xm, Md^Xm, Md^Xm, Md^Xm, Md^Xm, Md^Xm, Md^Xm, Md^Xm, Md^Xm, Md^Xm, Md^Xm, Md, Md, Md, Md^Xm, Md^Xm, Md^Xm, Md^Xm, Md^Xm, Md^Xm, Md^Xm, Md, Md^Xm, Md^Xm, Md^Xm, Md^Xm, Md^Xm, Md^Xm, Md^Xm
Zwsl, Md^Xm, Md^Xm, Md^Xm, Md^Xm, Md, Md^Xm, Md^Xm, Md^Xm, Md^Xm, Md^Xm, Md^Xm, Md^Xm, Md^Xm, Md^Xm, Md^Xm, Md^Xm, Md^Xm, Md^Xm, Md^Xm, Md^Xm, Md^Xm, Md^Xm, Md^Xm, Md^Xm, Md^Xm, Md^Xm, Md^Xm, Md^Xm, Md^Xm, Md^Xm, Md^Xm, Md^Xm, Md^Xm, Md^Xm, Md^Xm, Md^Xm, Md^Xm, Md^Xm, Md^Xm, Md^Xm, Md^Xm, Md^Xm, Md^Xm, Md^Xm, Md^Xm, Md^Xm, Md^Xm, Md^Xm, Md^Xm, Md^Xm, Md^Xm, Md^Xm, Md^Xm, Md^Xm, Md^Xm, Md^Xm, Md^Xm, Md^Xm
