border_size=1
usage=map

Xol, Xol, Xol, Xol, Xol, Xol, Xol, Xol, Xol, Xol, Xol, Xol, Xol, Xol, Xol, Xol, Xol, Xol, Xol, Xol, Xol, Urb, Urb, Urb, Urb, Urb, Urb, Urb, Urb, Urb, Xol, Xol, Xol, Xol, Xol, Xol, Xol, Xol, Xol, Xol, Xol, Xol, Xol, Xol, Xol, Xol, Xol, Xol, Xol, Xol, Xol, Xol
Xol, Xol, Xol, Xol, Xol, Xol, Xol, Xol, Xol, Xol, Xol, Xol, Xol, Xol, Xol, Xol, Xol, Xol, Urb, Xol, Xol, Urb, Urb, Urb, Urb, Urb, Urb, Urb, Urb, Urb, Xol, Xol, Xol, Xol, Xol, Xol, Urb, Urb, Urb, Xol, Xol, Xol, Xol, Xol, Xol, Xol, Xol, Xol, Urb, Xol, Xol, Xol
Xol, Xol, Xol, Xol, Xol, Xol, Xol, Xol, Xol, Xol, Xol, Xol, Urb, Xol, Xol, Xol, Xol, Urb, Urb, Xol, Xol, Urb, Urb, Urb, Urb, Urb, Urb, Urb, Urb, Urb, Xol, Xol, Urb, Urb, Urb, Urb, Urb, Urb, Urb, Xol, Xol, Xol, Xol, Xol, Xol, Xol, Urb, Urb, Urb, Xol, Xol, Xol
Xol, Xol, Xol, Xol, Xol, Xol, Urb, Urb, Urb, Xol, Urb, Urb, Urb, Urb, Urb, Xol, Xol, Xol, Urb, Urb, Urb, Xol, Xol, Urb, Urb, Urb, Urb, Urb, Xol, Xol, Urb, Urb, Urb^Vzps, Urb, Urb, Urb, Urb, Urb, Xol, Xol, Urb, Urb, Urb, Xol, Urb, Urb, Xol, Urb, Xol, Xol, Xol, Xol
Xol, Xol, Xol, Xol, Urb, Urb, Urb, Urb, Urb, Urb, Urb, Urb, Urb, Urb, Urb, Urb, Urb, Xol, Urb, Urb, Urb, Urb, Xol, Urb, Urb, Urb, Urb, Urb, Xol, Urb, Urb, Urb, Urb, Urb, Urb, Xol, Xol, Xol, Urb, Urb, Urb, Urb, Urb, Xol, Urb, Urb, Urb, Urb, Urb, Xol, Xol, Xol
Xol, Xol, Xol, Xol, Xol, Urb, Urb, Urb, Xol, Xol, Xol, Urb, Urb, Urb, Xol, Urb, Xol, Xol, Urb, Urb^Vzps, Urb, Urb, Xol, Urb, Urb, Urb, Urb, Urb, Xol, Urb, Urb, Urb, Urb, Urb, Urb, Urb, Urb, Urb, Urb, Urb, Urb^Vzps, Urb, Urb, Urb, Xol, Xol, Xol, Urb, Xol, Urb, Xol, Xol
Xol, Xol, Urb, Urb, Urb, Urb, Urb, Xol, Urb, Urb, Urb, Urb, Urb, Xol, Xol, Urb, Urb, Urb, Urb, Urb, Urb, Urb, Xol, Urb, Urb, Urb, Urb, Urb, Xol, Urb, Xol, Xol, Urb, Urb, Urb, Urb, Urb, Urb, Urb, Urb, Urb, Urb, Urb, Urb, Xol, Xol, Xol, Urb, Xol, Urb, Urb, Xol
Xol, Xol, Urb, Urb, Urb^Vzps, Urb, Xol, Xol, Urb, Urb, Urb, Urb, Urb, Xol, Xol, Xol, Xol, Urb, Urb, Urb, Urb, Xol, Xol, Urb, Urb, Urb, Urb, Urb, Xol, Xol, Urb, Urb, Urb, Urb, Urb, Urb, Urb, Xol, Urb, Urb, Urb, Urb, Urb, Urb, Xol, Xol, Xol, Xol, Urb, Urb, Xol, Xol
Xol, Xol, Urb, Urb, Urb, Urb, Xol, Xol, Urb, Urb, Urb, Urb, Urb, Urb, Urb, Xol, Xol, Urb, Urb, Urb, Urb, Urb, Xol, Xol, Urb, Urb, Urb, Xol, Xol, Urb, Urb, Urb, Urb, Urb, Xol, Urb, Urb, Xol, Xol, Urb, Urb, Urb, Urb, Urb, Xol, Xol, Xol, Xol, Xol, Xol, Xol, Xol
Xol, Xol, Urb, Urb, Urb, Urb, Xol, Urb, Urb, Urb, Xol, Urb, Urb, Urb, Urb, Urb, Urb, Xol, Xol, Urb, Urb, Xol, Urb, Urb, Urb, Urb, Urb, Xol, Xol, Xol, Xol, Urb, Urb, Xol, Xol, Urb, Urb, Urb, Urb, Xol, Urb, Urb, Urb, Urb, Xol, Xol, Xol, Xol, Urb, Xol, Urb, Xol
Xol, Xol, Xol, Urb, Urb, Urb, Urb, Urb, Urb, Urb, Xol, Xol, Urb, Urb, Urb, Urb, Urb, Urb, Xol, Xol, Urb, Urb, Urb, Xol, Urb, Urb, Urb, Xol, Urb, Xol, Xol, Urb, Urb, Urb, Xol, Urb, Urb, Urb, Xol, Xol, Xol, Urb, Xol, Xol, Urb, Urb, Urb, Urb, Urb, Urb, Urb, Urb
Xol, Xol, Xol, Urb, Urb, Urb, Urb, Urb, Xol, Xol, Xol, Xol, Urb, Urb, Urb, Urb, Urb, Urb, Urb, Urb, Urb, Urb, Urb, Urb, Urb, Urb, Urb, Urb, Urb, Urb, Xol, Urb, Urb, Urb, Urb, Xol, Urb, Xol, Urb, Xol, Xol, Xol, Xol, Urb, Urb, Urb, Urb, Urb, Urb, Urb, Urb, Urb
Xol, Xol, Xol, Xol, Xol, Urb, Urb, Urb, Xol, Xol, Xol, Xol, Xol, Urb, Xol, Xol, Urb, Urb, Urb, Urb, Urb, Urb, Xol, Xol, Urb, Urb, Urb, Xol, Urb, Urb, Urb, Xol, Xol, Urb, Urb, Urb, Urb, Urb, Urb, Urb, Urb, Urb, Xol, Urb, Urb, Urb, Urb, Urb, Urb, Urb, Urb, Urb
Xol, Xol, Xol, Xol, Xol, Xol, Urb, Urb, Urb, Xol, Xol, Xol, Urb, Xol, Urb, Urb, Urb, Urb, Urb, Urb, Urb, Xol, Urb, Urb, Urb, Urb^Vzps, Urb, Urb, Urb, Urb, Urb, Urb, Xol, Urb, Urb, Urb^Vzps, Urb, Urb, Urb, Urb, Urb, Xol, Urb, Urb, Urb, Urb, Urb, Urb, Urb, Urb, Urb, Urb
Xol, Xol, Xol, Xol, Xol, Xol, Xol, Urb, Xol, Urb, Urb, Urb, Urb, Urb, Urb, Xol, Urb, Urb, Xol, Xol, Urb, Urb, Urb, Xol, Urb, Urb, Urb, Xol, Urb, Urb, Urb, Urb, Urb, Urb, Urb, Urb, Urb, Urb, Xol, Urb, Xol, Xol, Urb, Urb, Urb, Urb, Urb, Urb, Urb, Urb, Urb, Urb
Xol, Xol, Xol, Xol, Xol, Xol, Xol, Xol, Urb, Urb, Urb, Urb, Urb, Urb, Urb, Urb, Urb, Xol, Xol, Xol, Urb^Vzps, Urb, Urb, Xol, Urb, Urb, Urb, Xol, Urb, Urb, Urb, Urb, Xol, Xol, Urb, Urb, Urb, Xol, Xol, Xol, Urb, Xol, Xol, Urb, Urb, Urb, Urb, Urb, Urb, Urb, Urb, Urb
Xol, Xol, Xol, Xol, Xol, Xol, Xol, Urb, Urb, Urb, Urb, Urb, Urb, Urb, Xv, Urb, Urb, Xol, Xol, Urb, Urb, Urb, Urb, Xol, Urb, Urb, Urb, Xol, Urb, Urb, Urb, Urb, Urb, Urb, Urb, Urb, Xol, Xol, Urb, Xol, Urb, Urb, Urb, Xol, Xol, Xol, Xol, Urb, Xol, Xol, Xol, Xol
Xol, Xol, Xol, Xol, Xol, Xol, Xol, Urb, Urb, Urb, Urb, Urb, Urb^Vzps, Urb, Urb, Urb, Urb, Xol, Xol, Urb, Urb, Urb, Xol, Xol, Urb, Urb, Urb, Xol, Xol, Urb, Urb, Urb, Urb, Urb, Xol, Xol, Urb, Urb, Urb, Urb, Urb, Urb, Xol, Xol, Xol, Xol, Xol, Xol, Xol, Xol, Xol, Xol
Xol, Xol, Xol, Xol, Xol, Xol, Xol, Urb, Urb, Urb, Urb, Urb, Urb, Urb, Urb, Urb, Urb, Urb, Urb, Xol, Xol, Xol, Xol, Xol, Urb, Urb, Urb, Urb, Urb, Xol, Xol, Urb, Xol, Xol, Urb, Urb, Urb, Urb, Urb, Urb, Xol, Xol, Xol, Urb, Urb, Urb, Xol, Xol, Xol, Xol, Xol, Xol
Urb, Xol, Urb, Urb, Urb, Xol, Xol, Urb, Urb, Urb, Urb, Urb, Urb, Urb, Urb, Urb, Xol, Urb, Urb, Urb, Urb, Xol, Urb, Urb, Urb, Urb, Urb, Urb, Urb, Urb, Urb, Xol, Xol, Urb, Urb, Urb, Xol, Xol, Xol, Urb, Urb, Xol, Xol, Xol, Urb, Urb, Urb, Xol, Urb, Xol, Xol, Xol
Urb, Urb, Urb, Urb, Urb, Urb, Urb, Xol, Xol, Urb, Urb, Urb, Urb, Urb, Xol, Xol, Urb, Xol, Xol, Urb, Urb, Urb, Urb^Vzps, Urb, Urb, Urb, Urb, Urb, Urb, Urb, Urb^Vzps, Urb, Xol, Urb, Urb, Urb, Urb, Urb, Urb^Vzps, Urb, Urb, Urb, Xol, Xol, Urb, Urb, Urb, Urb, Urb, Urb, Xol, Xol
Urb, Urb, Urb, Urb, Urb, Urb, Urb, Urb, Urb, Xol, Xol, Urb, Xol, Urb, Urb, Urb, Urb^Vzps, Urb, Urb, Xol, Xol, Urb, Urb, Xol, Urb, Urb, Urb, Urb, Urb, Xol, Urb, Urb, Xol, Urb, Urb, Urb, Urb, Urb, Urb, Urb, Urb, Urb, Urb, Urb, Xol, Urb, Xol, Urb, Urb, Xol, Xol, Xol
Urb, Urb, Urb, Urb, Urb, Urb, Urb, Urb, Urb, Urb, Xol, Xol, Urb, Urb, Urb, Urb, Urb, Urb, Urb, Xol, Xol, Urb, Urb, Urb, Cud, Cud, Cud, Cud, Cud, Urb, Urb, Urb, Xol, Urb, Urb, Urb, Urb, Urb, Urb, Urb, Urb, Urb, Xol, Xol, Xol, Xol, Urb, Urb, Urb, Urb, Xol, Xol
Urb, Urb, Urb, Urb, Urb, Urb, Urb, Urb, Urb, Urb, Urb, Xol, Urb, Urb, Urb, Urb, Urb, Urb, Urb, Xol, Xol, Urb, Urb, Cud, Cud, Kud, Cud, 2 Kud, Cud, Cud, Urb, Urb, Xol, Urb, Xol, Xol, Xol, Xol, Xol, Urb, Xol, Xol, Xol, Xol, Xol, Xol, Xol, Urb, Urb, Xol, Xol, Xol
Urb, Urb, Urb, Urb, Urb, Urb, Urb, Urb, Urb, Urb, Urb, Xol, Urb, Urb, Xol, Xol, Xol, Urb, Urb, Xol, Xol, Urb, Urb, Urb, Urb, Cud, Urb, Cud, Urb, Urb, Urb, Urb, Urb, Urb, Urb, Xol, Xol, Xol, Xol, Xol, Xol, Xol, Xol, Xol, Xol, Xol, Xol, Urb, Urb, Xol, Xol, Xol
Urb, Urb, Urb, Urb, Urb, Urb, Urb, Urb, Urb, Urb, Urb, Xol, Xol, Xol, Xol, Xol, Xol, Xol, Xol, Xol, Xol, Urb, Urb^Vzps, Xol, Urb, Urb, Urb, Urb, Urb, Xol, Urb^Vzps, Urb, Xol, Urb, Xol, Urb, Urb, Xol, Urb, Urb, Urb, Urb, Urb, Urb, Xol, Xol, Xol, Xol, Urb, Xol, Xol, Xol
Xol, Urb, Xol, Xol, Xol, Xol, Xol, Urb, Urb, Urb, Xol, Xol, Urb, Xol, Xol, Urb, Urb, Urb, Urb, Xol, Xol, Urb, Urb, Urb, Urb, Urb, Urb, Urb, Urb, Urb, Urb, Urb, Urb, Xol, Urb, Xol, Xol, Urb, Urb, Urb, Urb, Urb, Urb, Xol, Urb, Xol, Urb, Xol, Xol, Xol, Xol, Xol
Xol, Xol, Xol, Xol, Urb, Xol, Xol, Xol, Xol, Xol, Urb, Urb, Urb, Urb, Urb, Xol, Xol, Urb, Urb, Urb, Xol, Xol, Xol, Urb, Urb, Urb, Urb, Urb, Urb, Urb, Xol, Xol, Urb, Urb, Urb, Urb, Urb, Urb, Xol, Urb, Urb, Urb, Urb, Urb, Urb, Urb, Urb, Xol, Xol, Xol, Xol, Xol
Xol, Xol, Urb, Urb, Urb, Urb, Urb, Urb, Urb, Urb, Urb, Urb, Urb, Urb, Urb, Xol, Xol, Xol, Urb, Urb, Urb, Xol, Xol, Xol, Urb, Urb, Urb, Urb, Urb, Xol, Urb, Urb, Urb, Urb, Urb, Urb, Urb, Xol, Xol, Urb, Urb, Urb^Vzps, Urb, Urb, Xol, Urb, Urb, Xol, Xol, Xol, Xol, Xol
Xol, Xol, Urb, Urb, Urb, Urb, Urb, Urb^Vzps, Urb, Urb, Urb, Urb, Xol, Urb, Urb, Urb, Urb, Urb, Urb, Xol, Xol, Urb, Urb, Xol, Urb, Urb, Urb, Urb, Urb, Xol, Xol, Urb, Urb, Urb, Urb, Urb, Xol, Urb, Xol, Urb, Urb, Urb, Urb, Urb, Xol, Urb, Urb, Xol, Xol, Xol, Xol, Xol
Xol, Xol, Urb, Urb, Xol, Xol, Urb, Urb, Urb, Xol, Xol, Xol, Urb, Urb, Urb, Urb, Urb, Urb, Urb, Urb, Urb, Xol, Xol, Xol, Urb, Urb, Urb, Urb, Urb, Urb, Urb, Xol, Xol, Urb, Urb, Xol, Urb, Xol, Xol, Urb, Urb, Urb, Xol, Xol, Xol, Urb, Urb, Xol, Xol, Xol, Xol, Xol
Xol, Xol, Urb, Urb, Urb, Xol, Xol, Urb, Xol, Xol, Urb, Urb, Urb, Urb, Urb, Urb, Urb, Urb^Vzps, Urb, Urb, Urb, Urb, Urb, Xol, Xol, Urb, Urb, Urb, Urb^Vzps, Urb, Urb, Urb, Xol, Urb, Urb, Urb, Urb, Urb, Urb, Xol, Xol, Urb, Xol, Xol, Xol, Xol, Xol, Xol, Xol, Xol, Xol, Xol
Xol, Xol, Urb, Urb, Urb, Urb, Xol, Xol, Xol, Urb, Urb, Urb, Urb, Urb, Urb, Urb, Urb, Urb, Xol, Xol, Xol, Xol, Xol, Xol, Urb, Urb, Urb, Urb, Urb, Urb, Urb, Urb, Urb, Xol, Urb, Urb, Urb, Urb^Vzps, Urb, Urb, Urb, Xol, Xol, Xol, Xol, Xol, Xol, Xol, Xol, Xol, Xol, Xol
Xol, Xol, Urb, Urb, Urb, Urb, Urb, Xol, Urb, Urb, Urb, Urb, Urb, Xol, Urb, Urb, Urb, Urb, Urb, Xol, Urb, Urb, Urb, Urb, Urb, Xol, Urb, Urb, Urb, Urb, Urb, Urb, Urb, Xol, Urb, Urb, Urb, Urb, Urb, Urb, Urb, Xol, Xol, Xol, Xol, Xol, Xol, Xol, Xol, Xol, Xol, Xol
Xol, Xol, Urb, Urb, Urb, Urb, Urb, Xol, Urb, Urb, Urb, Urb, Urb, Xol, Xol, Urb, Urb, Urb, Urb, Urb, Urb, Urb, Urb, Urb, Xol, Urb, Urb, Urb, Urb, Urb, Urb, Urb, Urb, Xol, Urb, Urb, Urb, Urb, Urb, Urb, Urb, Urb, Xol, Xol, Xol, Xol, Xol, Xol, Xol, Xol, Xol, Xol
Xol, Xol, Urb, Urb, Urb, Urb, Urb, Urb, Urb, Urb, Urb, Urb, Urb, Xol, Xol, Xol, Xol, Urb, Urb, Urb, Urb, Urb, Xol, Xol, Xol, Xol, Urb, Urb, Urb, Urb, Urb, Urb, Urb, Xol, Xol, Xol, Urb, Urb, Xol, Xol, Xol, Xol, Urb, Urb, Urb, Urb, Urb, Xol, Xol, Xol, Xol, Xol
Xol, Xol, Xol, Urb, Urb, Urb, Urb^Vzps, Urb, Xol, Urb, Urb, Urb, Urb, Urb, Urb, Xol, Xol, Xol, Xol, Xol, Xol, Xol, Urb, Xol, Urb, Xol, Urb, Urb, Urb, Urb, Urb, Urb, Urb, Xol, Xol, Urb, Urb, Urb, Urb, Xol, Urb, Urb, Urb, Urb, Urb, Urb, Urb, Urb, Urb, Xol, Xol, Xol
Xol, Xol, Xol, Urb, Urb, Urb, Urb, Urb, Xol, Urb, Urb, Urb^Vzps, Urb, Urb, Urb, Urb, Urb, Urb, Urb, Urb, Urb, Urb, Urb, Urb, Urb, Xol, Urb, Urb, Urb, Urb, Urb, Urb, Urb, Urb, Urb, Xol, Xol, Urb, Urb, Urb, Xol, Urb, Urb, Urb, Xol, Xol, Urb, Urb, Urb, Xol, Xol, Xol
Xol, Xol, Urb, Urb, Xol, Urb, Urb, Urb, Urb, Xol, Xol, Urb, Urb, Urb, Xol, Urb, Urb, Urb, Urb, Urb, Urb^Vzps, Urb, Urb, Urb, Urb, Xol, Urb, Urb, Urb, Urb, Urb^Vzps, Urb, Urb, Urb, Urb, Urb, Urb, Xol, Urb, Xol, Xol, Urb, Urb, Xol, Urb, Xol, Urb, Urb, Urb, Urb, Xol, Xol
Xol, Xol, Urb, Xol, Urb, Xol, Urb, Urb, Urb, Xol, Xol, Urb, Urb, Urb, Urb, Urb, Urb, Urb, Xol, Urb, Urb, Urb, Urb, Urb, Xol, Xol, Urb, Urb, Urb, Urb, Urb, Urb, Urb, Xol, Xol, Urb, Urb, Urb, Xol, Xol, Urb, Urb, Urb, Urb, Urb, Urb, Urb, Urb, Urb, Urb, Xol, Xol
Xol, Xol, Urb, Urb, Urb, Xol, Xol, Urb, Urb, Urb, Xol, Xol, Urb, Urb, Urb, Urb, Urb, Xol, Xol, Urb, Urb, Urb, Urb, Xol, Xol, Xol, Urb, Urb, Urb, Urb, Urb, Urb, Urb, Xol, Xol, Xol, Urb, Urb, Xol, Xol, Urb, Urb, Xol, Urb, Xol, Urb, Urb, Urb, Urb, Urb, Xol, Xol
Xol, Xol, Urb, Urb, Urb, Xol, Urb, Urb, Urb, Urb, Urb, Xol, Urb, Urb, Urb, Urb, Urb, Xol, Xol, Urb, Urb, Urb, Xol, Xol, Xol, Xol, Urb, Urb, Urb, 1 Urb, Urb, Urb, Urb, Xol, Xol, Xol, Xol, Urb, Urb, Urb, Urb, Urb, Xol, Xol, Xol, Xol, Xol, Urb, Xol, Xol, Xol, Xol
Xol, Xol, Xol, Urb, Urb, Urb, Urb, Urb, Urb, Urb, Xol, Xol, Urb, Urb, Urb, Urb, Xol, Urb, Xol, Urb, Xol, Xol, Xol, Xol, Xol, Xol, Urb, Urb, Urb, Urb, Urb, Urb, Urb, Xol, Xol, Xol, Xol, Xol, Xol, Urb, Xol, Urb, Xol, Xol, Xol, Xol, Xol, Xol, Xol, Xol, Xol, Xol
Xol, Xol, Xol, Xol, Xol, Xol, Xol, Xol, Xol, Xol, Xol, Xol, Xol, Xol, Xol, Xol, Xol, Xol, Xol, Xol, Xol, Xol, Xol, Xol, Xol, Xol, Urb, Urb, Urb, Urb, Urb, Urb, Urb, Xol, Xol, Xol, Xol, Xol, Xol, Xol, Xol, Xol, Xol, Xol, Xol, Xol, Xol, Xol, Xol, Xol, Xol, Xol
