border_size=1
usage=map

Xol, Xol, Xol, Xol, Xol, Xol, Xol, Xol, Xol, Xol, Xol, Xol, Xol, Xol, Xol, Xol, Xol, Xol, Xol, Xol, Xol, Xol, Xol, Xol, Xol, Xol, Xol, Xol, Xol, Xol, Xol, Xol, Xol, Xol, Urb, Urb, Urb, Urb, Urb, Urb, Urb, Urb, Xol, Xol, Xol, Xol, Xol, Xol, Xol, Xol, Xol, Xol
Xol, Xol, Xol, Xol, Xol, Xol, Xol, Xol, Urb, Urb, Urb, Xol, Xol, Xol, Xol, Xol, Xol, Xol, Xol, Xol, Xol, Xol, Xol, Xol, Xol, Xol, Xol, Xol, Xol, Xol, Xol, Xol, Urb, Xol, Urb, Urb, Urb, Urb, Urb, Urb, Urb, Urb, Xol, Xol, Xol, Xol, Xol, Xol, Xol, Xol, Xol, Xol
Urb, Xol, Xol, Xol, Xol, Xol, Urb, Urb, Urb, Urb, Urb, Urb, Urb, Xol, Xol, Xol, Xol, Xol, Xol, Xol, Xol, Xol, Xol, Xol, Xol, Xol, Xol, Xol, Xol, Xol, Urb, Urb, Urb, Xol, Urb, Urb, Urb, Urb, Urb, Urb, Urb, Urb, Xol, Xol, Xol, Xol, Xol, Xol, Xol, Xol, Xol, Xol
Urb, Urb, Urb, Xol, Xol, Urb, Urb, Urb, Urb, Urb, Urb, Urb, Urb, Urb, Urb, Xol, Xol, Xol, Xol, Xol, Xol, Xol, Xol, Xol, Xol, Xol, Xol, Xol, Urb, Urb, Urb, Urb, Urb, Xol, Urb, Urb, Urb, Urb, Urb, Urb, Urb, Urb, Xol, Xol, Xol, Xol, Xol, Xol, Xol, Xol, Xol, Xol
Urb, Urb, Urb, Urb, Urb, Xol, Xol, Urb, Urb, Urb, Urb, Urb, Urb, Urb, Urb, Urb, Urb, Xol, Xol, Xol, Xol, Xol, Xol, Xol, Xol, Xol, Xol, Urb, Urb, Urb, Urb, Urb, Urb, Xol, Urb, Urb, Urb, Urb, Urb, Urb, Urb, Urb, Xol, Xol, Xol, Xol, Xol, Xol, Xol, Xol, Xol, Xol
Urb, Urb, Urb, Urb, Urb, Urb, Urb, Xol, Xol, Urb, Urb, Urb, Urb, Urb^Vzps, Urb, Urb, Urb, Urb, Urb, Xol, Xol, Xol, Xol, Xol, Xol, Xol, Xol, Urb, Urb, Urb^Vzps, Urb, Urb, Urb, Xol, Xol, Urb, Urb, Urb, Urb, Urb, Urb, Urb, Xol, Xol, Xol, Xol, Xol, Xol, Xol, Xol, Xol, Xol
Urb, Urb, Urb, Urb, Urb, Urb, Urb, Urb, Urb, Xol, Xol, Urb, Urb, Urb, Urb, Urb, Urb, Urb, Urb, Urb, Urb, Xol, Xol, Xol, Urb, Xol, Xol, Urb, Urb, Urb, Urb, Urb, Xol, Xol, Xol, Xol, Xol, Urb, Urb, Urb, Xol, Xol, Urb, Xol, Xol, Xol, Xol, Xol, Xol, Xol, Xol, Xol
Urb, Urb, Urb, Urb, Urb, Urb, Urb, Urb, Xol, Xol, Xol, Xol, Xol, Urb, Urb, Urb, Urb, Urb, Urb, Urb, Xol, Urb, Urb, Urb, Urb, Urb, Xol, Urb, Urb, Urb, Xol, Urb, Xol, Xol, Xol, Xol, Xol, Xol, Xol, Xol, Urb, Urb, Urb, Urb, Urb, Xol, Xol, Xol, Xol, Xol, Xol, Xol
Urb, Urb, Urb, Urb, Urb, Urb, Xol, Xol, Urb, Urb, Xol, Xol, Xol, Xol, Xol, Urb, Urb, Urb, Xol, Urb, Urb, Urb, Urb, Urb, Urb, Urb, Xol, Urb, Xol, Urb, Urb, Urb, Xol, Xol, Xol, Xol, Xol, Xol, Urb, Urb, Urb, Urb, Urb, Urb, Urb, Urb, Urb, Xol, Xol, Xol, Xol, Xol
Urb, Urb, Urb, Urb, Xol, Xol, Urb, Urb, Urb, Urb, Xol, Xol, Xol, Xol, Xol, Xol, Xol, Urb, Urb, Urb, Urb, Urb^Vzps, Urb, Urb, Urb, Urb, Xol, Urb, Urb, Urb, Urb, Urb, Xol, Xol, Xol, Xol, Urb, Urb, Urb, Urb, Urb, Urb, Urb, Urb^Vzps, Urb, Urb, Urb, Urb, Urb, Xol, Xol, Xol
Urb, Urb, Xol, Xol, Urb, Urb, Urb, Urb, Urb, Urb, Xol, Xol, Xol, Xol, Xol, Xol, Xol, Xol, Urb, Urb, Urb, Urb, Urb, Urb, Xol, Urb, Urb, Urb, Urb, Urb, Urb, Urb, Xol, Xol, Urb, Urb, Urb, Urb, Urb, Urb, Urb, Urb, Urb, Urb, Urb, Urb, Urb, Urb, Urb, Xol, Xol, Xol
Xol, Xol, Xol, Xol, Urb, Urb, Urb, Urb, Urb, Urb, Xol, Xol, Xol, Xol, Xol, Xol, Xol, Urb, Urb, Urb, Urb, Urb, Xol, Urb, Urb, Urb, Urb, Urb^Vzps, Urb, Urb, Xol, Xol, Urb, Urb, Urb^Vzps, Urb, Urb, Urb, Xol, Xol, Xol, Urb, Urb, Urb, Urb, Urb, Urb, Urb, Xol, Xol, Urb, Urb
Xol, Xol, Xol, Xol, Urb, Urb, Urb, Urb, Urb, Urb, Xol, Xol, Xol, Xol, Xol, Xol, Xol, Urb, Urb, Urb, Xol, Urb, Urb, Urb, Urb, Urb, Urb, Urb, Xol, Xol, Urb, Urb, Urb, Urb, Urb, Urb, Xol, Xol, Xol, Xol, Xol, Xol, Xol, Urb, Urb, Urb, Xol, Xol, Urb, Urb, Urb, Urb
Xol, Xol, Xol, Xol, Urb, Urb, Urb, Urb, Urb, Urb, Xol, Xol, Xol, Xol, Xol, Xol, Urb, Xol, Xol, Xol, Xol, Urb, Urb, Urb, Urb, Urb, Xol, Urb, Urb, Urb, Urb, Urb, Urb, Urb, Xol, Xol, Xol, Xol, Urb, Xol, Xol, Xol, Xol, Xol, Xol, Xol, Urb, Urb, Urb, Urb, Urb, Urb
Xol, Xol, Xol, Xol, Urb, Urb, Urb, Urb, Urb, Urb, Xol, Xol, Xol, Xol, Urb, Urb, Urb, Urb, Urb, Xol, Xol, Xol, Xol, Urb, Xol, Urb, Urb, Urb, Urb, Urb, Urb, Urb, Xol, Xol, Xol, Xol, Urb, Urb, Urb, Urb, Urb, Xol, Xol, Xol, Xol, Urb, Urb, Urb, Urb, Urb, Urb, Urb
Xol, Xol, Xol, Xol, Urb, Urb, Urb, Urb^Vzps, Urb, Urb, Xol, Xol, Urb, Urb, Urb, Urb, Urb, Urb, Urb, Urb, Urb, Xol, Xol, Urb, Urb, Urb, Urb, Urb, Urb, Urb, Xol, Xol, Xol, Xol, Urb, Urb, Urb, Urb, Xv, Urb, Urb, Urb, Xol, Xol, Xol, Urb, Urb, Urb, Urb, Urb, Urb, Urb
Xol, Xol, Xol, Xol, Urb, Urb, Urb, Urb, Urb, Urb, Urb, Urb, Urb, Urb, Urb, Urb, Urb, Urb^Vzps, Urb, Urb, Urb, Urb, Urb, Urb, Urb, Urb, Urb, Urb, Xol, Xol, Xol, Xol, Urb, Urb, Urb, Urb, Urb^Vzps, Urb, Urb, Urb, Urb, Xol, Xol, Xol, Xol, Urb, Urb, Urb, Urb, Urb, Urb, Urb
Xol, Xol, Xol, Xol, Urb, Urb, Urb, Urb, Urb, Urb, Xol, Xol, Urb, Urb, Urb, Urb, Urb, Urb, Urb, Urb, Urb, Urb, Xol, Urb, Urb, Urb, Xol, Xol, Xol, Xol, Xol, Urb, Urb, Urb, Urb, Urb, Urb, Urb, Urb, Urb, Xol, Urb, Urb, Urb, Urb, Xol, Xol, Urb, Urb, Urb, Urb, Urb
Xol, Xol, Xol, Xol, Urb, Urb, Urb, Urb, Urb, Urb, Urb, Urb, Urb, Xol, Urb, Urb, Urb, Urb, Urb, Urb, Xol, Urb, Urb, Urb, Urb, Urb, Xol, Xol, Urb, Xol, Urb, Urb, Urb, Urb, Urb, Urb, Xol, Xol, Xol, Urb, Urb, Urb, Urb, Urb, Urb, Urb, Urb, Xol, Xol, Urb, Urb, Urb
Xol, Xol, Xol, Xol, Urb, Urb, Urb, Urb, Urb, Urb, Urb, Xol, Urb, Urb, Xol, Xol, Xol, Urb, Xol, Urb, Urb, Urb, Urb, Xol, Urb, Xol, Urb, Urb, Urb, Urb, Urb, Xol, Urb, Urb, Xol, Xol, Xol, Xol, Xol, Urb, Xol, Urb, Urb, Urb^Vzps, Urb, Urb, Urb, Urb, Xol, Xol, Xol, Urb
Xol, Xol, Xol, Xol, Urb, Urb, Urb, Urb, Urb, Urb, Urb, Urb, Xol, Xol, Xol, Xol, Urb, Urb, Urb, Urb, Urb, Urb, Urb, Urb, Urb, Xol, Urb, Urb, Urb, Urb, Urb, Urb, Urb, Xol, Xol, Xol, Xol, Xol, Urb, Urb, Urb, Urb, Xol, Urb, Urb, Urb, Xol, Xol, Xol, Xol, Xol, Xol
Xol, Xol, Xol, Xol, Urb, Urb, Urb, Urb, Urb, Urb, Xol, Xol, Xol, Xol, Xol, Xol, Urb, Xol, Urb, Urb, Urb, Urb, Urb, Urb, Urb, Urb, Urb, Urb, Urb, Urb, Urb, Xol, Urb, Urb, Urb, Xol, Urb, Urb, Urb, Urb, Urb, Urb, Urb, Urb, Xol, Xol, Xol, Xol, Xol, Xol, Xol, Xol
Xol, Xol, Xol, Xol, Urb, Urb, Urb, Urb, Xol, Xol, Xol, Xol, Xol, Xol, Urb, Urb, Urb, Urb, Urb, Urb, Cud, Cud, Cud, Urb, Urb, Xol, Urb, Urb, Urb^Vzps, Urb, Urb, Urb, Urb, Urb, Urb, Urb, Urb, Urb, Urb, Urb, Urb, Urb, Urb, Xol, Xol, Xol, Xol, Xol, Urb, Xol, Xol, Xol
Xol, Xol, Xol, Xol, Urb, Urb, Xol, Xol, Xol, Xol, Xol, Xol, Urb, Urb, Urb, Urb, Urb, Xol, Urb, Urb, Cud, 2 Kud, Cud, Urb, Urb, Urb, Urb, Urb, Urb, Urb, Urb, Xol, Urb, Urb, Urb, Urb, Urb, Urb, Urb, Urb, Urb, Urb, Urb, Xol, Xol, Xol, Urb, Urb, Urb, Xol, Xol, Xol
Xol, Xol, Xol, Xol, Xol, Xol, Xol, Xol, Xol, Xol, Urb, Urb, Urb, Urb, Urb, Urb, Xol, Urb, Urb, Urb, Urb, Cud, Urb, Urb, Urb, Urb, Urb, Urb, Urb, Urb, Urb, Urb, Urb, Urb, Urb, Urb, Urb, Urb, Urb, Urb^Vzps, Urb, Urb, Urb, Urb, Urb, Urb, Urb, Urb, Urb, Xol, Xol, Xol
Xol, Xol, Urb, Xol, Xol, Xol, Xol, Xol, Urb, Urb, Urb, Urb^Vzps, Urb, Urb, Xol, Xol, Xol, Xol, Urb, Urb, Urb, Urb, Urb, Urb, Urb, Xol, Urb, Urb, Urb, Urb, Urb, Xol, Xol, Urb, Urb, Urb, Urb, Urb, Urb, Urb, Urb, Urb, Urb, Xol, Urb, Urb, Urb, Urb^Vzps, Urb, Xol, Xol, Xol
Urb, Urb, Urb, Urb, Urb, Xol, Xol, Urb, Urb, Urb, Urb, Urb, Xol, Xol, Xol, Xol, Xol, Xol, Urb, Urb, Urb, Urb, Urb, Urb, Urb, Urb, Urb, Xol, Urb, Xol, Urb, Xol, Xol, Xol, Xol, Urb, Urb, Urb, Urb, Urb, Urb, Urb, Urb, Urb, Urb, Urb, Urb, Urb, Urb, Xol, Xol, Xol
Urb, Urb, Urb, Urb, Urb, Urb, Urb, Xol, Urb, Urb, Xol, Xol, Urb, Xol, Xol, Xol, Xol, Xol, Xol, Urb, Urb, Urb, Urb, Urb, Xol, Xol, Urb, Urb, Urb, Urb, Urb, Xol, Xol, Xol, Xol, Xol, Urb, Urb, Urb, Urb, Urb, Urb, Urb, Xol, Urb, Urb, Urb, Urb, Urb, Xol, Xol, Xol
Urb, Urb, Urb, Urb, Urb, Urb, Urb, Xol, Xol, Xol, Urb, Urb, Urb, Urb, Urb, Xol, Xol, Xol, Xol, Xol, Xol, Urb, Xol, Xol, Urb, Urb, Urb, Urb, Urb, Urb, Urb, Urb, Urb, Xol, Xol, Xol, Xol, Urb, Urb, Urb, Urb, Urb, Xol, Urb, Urb, Xol, Urb, Urb, Urb, Xol, Xol, Xol
Urb, Urb, Urb, Urb, Urb, Urb, Xol, Xol, Urb, Urb, Urb, Urb, Urb, Urb, Urb, Xol, Xol, Xol, Xol, Xol, Xol, Xol, Xol, Xol, Urb, Urb, Urb, Urb, Urb, Urb, Urb, Urb, Urb, Xol, Xol, Xol, Xol, Xol, Xol, Urb, Xol, Xol, Xol, Xol, Xol, Urb, Urb, Xol, Urb, Xol, Xol, Xol
Urb, Urb, Urb, Urb, Xol, Xol, Urb, Urb, Urb, Urb, Urb^Vzps, Urb, Urb, Urb, Urb, Xol, Xol, Xol, Xol, Xol, Xol, Xol, Xol, Xol, Urb, Urb, Urb, Urb, Urb, Urb, Urb, Urb, Urb, Xol, Xol, Xol, Xol, Xol, Xol, Xol, Xol, Xol, Xol, Xol, Xol, Urb, Urb, Urb, Urb, Xol, Xol, Xol
Urb, Urb, Xol, Xol, Urb, Urb, Urb, Urb, Urb, Urb, Urb, Urb, Urb, Urb, Urb, Urb, Urb, Xol, Xol, Xol, Xol, Xol, Urb, Urb, Urb, Urb, Urb, Urb, Urb, Urb, Urb, Urb, Urb, Urb, Urb, Xol, Xol, Xol, Xol, Xol, Xol, Xol, Xol, Xol, Xol, Urb, Urb, Urb, Urb, Urb, Xol, Xol
Xol, Xol, Urb, Urb, Urb, Xol, Urb, Urb, Urb, Urb, Urb, Urb, Xol, Urb, Urb, Urb, Urb, Urb, Urb, Xol, Urb, Urb, Urb, Xol, Urb, Urb, Urb, Urb, Urb, Urb, Urb, Urb, Urb, Xol, Urb, Urb, Urb, Xol, Xol, Xol, Xol, Xol, Xol, Xol, Xol, Urb, Urb, Urb, Urb, Urb, Xol, Xol
Xol, Xol, Urb, Urb, Urb, Urb, Urb, Urb, Urb, Urb, Xol, Xol, Xol, Xol, Xol, Urb, Urb, Xol, Urb, Urb, Urb, Urb, Urb, Urb, Urb, Urb, Urb, Urb, Urb^Vzps, Urb, Urb, Urb, Urb, Urb, Urb, Urb, Urb, Urb, Urb, Xol, Xol, Xol, Xol, Xol, Xol, Urb, Urb, Urb^Vzps, Urb, Urb, Xol, Xol
Xol, Xol, Urb, Urb, Urb, Xol, Urb, Urb, Xol, Xol, Urb, Urb, Urb, Xol, Xol, Xol, Urb, Urb, Urb, Urb, Urb, Urb, Urb, Xol, Urb, Urb, Urb, Urb, Urb, Urb, Urb, Urb, Urb, Xol, Urb, Urb, Urb, Urb, Urb, Urb, Urb, Xol, Xol, Xol, Xol, Urb, Urb, Urb, Urb, Urb, Xol, Xol
Xol, Xol, Urb, Urb^Vzps, Urb, Urb, Xol, Xol, Urb, Urb, Urb, Urb, Urb, Urb, Urb, Urb, Urb, Urb, Urb, Urb^Vzps, Urb, Urb, Urb, Urb, Urb, Urb, Urb, Urb, Urb, Urb, Urb, Urb, Urb, Urb, Urb, Urb, Urb, Urb, Urb^Vzps, Urb, Urb, Urb, Urb, Xol, Xol, Urb, Urb, Urb, Urb, Urb, Xol, Xol
Xol, Xol, Urb, Urb, Urb, Xol, Xol, Xol, Urb, Urb, Urb, Urb, Urb, Urb, Urb, Xol, Urb, Urb, Urb, Urb, Urb, Urb, Xol, Xol, Urb, Urb, Urb, Urb, Urb, Urb, Urb, Urb, Urb, Xol, Xol, Urb, Urb, Urb, Urb, Urb, Urb, Urb, Urb, Urb, Xol, Xol, Xol, Urb, Urb, Urb, Xol, Xol
Xol, Xol, Urb, Urb, Urb, Xol, Xol, Xol, Urb, Urb, Urb, Urb^Vzps, Urb, Urb, Urb, Urb, Urb, Urb, Urb, Urb, Xol, Xol, Xol, Xol, Urb, Urb, Urb, Urb, Urb, Urb, Urb, Urb, Urb, Xol, Xol, Xol, Xol, Urb, Urb, Urb, Urb, Urb, Urb, Urb, Xol, Urb, Urb, Xol, Xol, Urb, Xol, Xol
Xol, Xol, Xol, Urb, Urb, Urb, Urb, Xol, Urb, Urb, Urb, Urb, Urb, Urb, Urb, Xol, Urb, Urb, Xol, Xol, Xol, Xol, Xol, Xol, Xol, Urb, Urb, Urb, Urb, Urb, Urb, Urb, Xol, Xol, Xol, Xol, Xol, Xol, Xol, Urb, Urb, Urb, Urb, Urb, Xol, Urb, Urb, Urb, Urb, Xol, Xol, Xol
Xol, Xol, Xol, Xol, Urb, Urb, Urb, Xol, Urb, Urb, Xol, Xol, Xol, Urb, Urb, Urb, Xol, Xol, Xol, Xol, Xol, Xol, Xol, Xol, Xol, Xol, Xol, Urb, Urb, Urb, Xol, Xol, Xol, Xol, Xol, Xol, Xol, Xol, Xol, Xol, Xol, Urb, Urb, Urb, Xol, Urb, Urb, Urb, Urb, Urb, Urb, Xol
Xol, Xol, Xol, Xol, Urb, Urb, Urb, Xol, Xol, Xol, Urb, Urb, Urb, Xol, Xol, Xol, Xol, Xol, Xol, Xol, Xol, Xol, Xol, Xol, Xol, Xol, Xol, Xol, Xol, Xol, Xol, Xol, Xol, Xol, Xol, Xol, Xol, Xol, Xol, Xol, Xol, Xol, Xol, Urb, Xol, Urb, Urb, Urb, Urb, Urb, Urb, Urb
Xol, Xol, Xol, Xol, Urb, Urb^Vzps, Urb, Xol, Urb, Urb, Urb, Urb, Urb, Urb, Urb, Xol, Xol, Xol, Xol, Xol, Xol, Xol, Xol, Xol, Xol, Xol, Xol, Xol, Xol, Xol, Xol, Xol, Xol, Xol, Xol, Xol, Xol, Xol, Xol, Xol, Xol, Xol, Xol, Xol, Xol, Urb, Urb, Urb, Urb, Urb, Urb, Urb
Xol, Xol, Xol, Xol, Urb, Urb, Urb, Xol, Urb, Urb, Urb, Urb, Urb, Urb, Urb, Xol, Xol, Xol, Xol, Xol, Xol, Xol, Xol, Xol, Xol, Xol, Xol, Xol, Xol, Xol, Xol, Xol, Xol, Xol, Xol, Xol, Xol, Xol, Xol, Xol, Xol, Xol, Xol, Xol, Xol, Xol, Xol, Urb, Urb, Urb, Urb, Urb
Xol, Xol, Xol, Xol, Urb, Urb, Urb, Xol, Urb, Urb, Urb, 1 Urb, Urb, Urb, Urb, Xol, Xol, Xol, Xol, Xol, Xol, Xol, Xol, Xol, Xol, Xol, Xol, Xol, Xol, Xol, Xol, Xol, Xol, Xol, Xol, Xol, Xol, Xol, Xol, Xol, Xol, Xol, Xol, Xol, Xol, Xol, Xol, Xol, Xol, Urb, Urb, Urb
Xol, Xol, Xol, Xol, Urb, Urb, Urb, Xol, Urb, Urb, Urb, Urb, Urb, Urb, Urb, Xol, Xol, Xol, Xol, Xol, Xol, Xol, Xol, Xol, Xol, Xol, Xol, Xol, Xol, Xol, Xol, Xol, Xol, Xol, Xol, Xol, Xol, Xol, Xol, Xol, Xol, Xol, Xol, Xol, Xol, Xol, Xol, Xol, Xol, Xol, Xol, Urb
Xol, Xol, Xol, Xol, Xol, Xol, Xol, Xol, Urb, Urb, Urb, Urb, Urb, Urb, Urb, Xol, Xol, Xol, Xol, Xol, Xol, Xol, Xol, Xol, Xol, Xol, Xol, Xol, Xol, Xol, Xol, Xol, Xol, Xol, Xol, Xol, Xol, Xol, Xol, Xol, Xol, Xol, Xol, Xol, Xol, Xol, Xol, Xol, Xol, Xol, Xol, Xol
Xol, Xol, Xol, Xol, Xol, Xol, Xol, Xol, Urb, Urb, Urb, Urb, Urb, Urb, Urb, Xol, Xol, Xol, Xol, Xol, Xol, Xol, Xol, Xol, Xol, Xol, Xol, Xol, Xol, Xol, Xol, Xol, Xol, Xol, Xol, Xol, Xol, Xol, Xol, Xol, Xol, Xol, Xol, Xol, Xol, Xol, Xol, Xol, Xol, Xol, Xol, Xol
