border_size=1
usage=map

Xuc, Xuc, Xuc, Xuc, Xuc, Xuc, Qlf, Qlf, Qlf, Uu, Xuc, Xuc, Xuc, Xuc, Xuc, Ur, Ur, Ur, Ur, Ur, Ur, Xuc, Xuc, Xuc, Xuc, Xuc, Xuc, Xuc, Xuc, Ur, Ur, Ur, Ur, Ur, Ur, Ur, Xuc, Xuc, Xuc, Xuc, Xuc, Xuc, Xuc, Xuc, Ur, Ur, Ur, Ur, Ur, Ur, Ur, Xuc, Xuc, Xuc, Xuc
Xuc, Xuc, Xuc, Xuc, Uu, Qlf, Qlf, Qlf, Uu, Uu, Xuc, Xuc, Xuc, Xuc, Ur, Ur, Ur, Ur, Ur, Ur, Ur, Xuc, Xuc, Xuc, Xuc, Xuc, Xuc, Xuc, Xuc, Ur, Ur, Ur, Ur, Ur, Ur, Ur, Xuc, Xuc, Xuc, Uh, Zvw, Xuc, Zvw, Xuc, Xuc, Ur, Ur, Ur, Ur, Ur, Ur, Ur, Ur, Xuc, Xuc
Xuc, Xuc, Xuc, Xuc, Uu, Qlf, Qlf, Uu, Xuc, Xuc, Xuc, Xuc, Xuc, Xuc, Ur, Ur, Ur, Ur, Ur, Ur, Ur, Xuc, Xuc, Xuc, Xuc, Xuc, Xuc, Xuc, Xuc, Ur, Ur, Ur, Ur, Ur, Ur, Ur, Xuc, Xuc, Uu, Uh, Zvw, Uu, Zvw, Zvw, Xuc, Ur, Ur, Ur, Ur, Ur, Ur, Ur, Ur, Xuc, Xuc
Xuc, Xuc, Xuc, Uu, Uu, Qlf, Qlf, Uu, Uu, Xuc, Xuc, Xuc, Xuc, Ur, Ur, Ur, Ur, Ur, Ur, Ur, Ur, Xuc, Xuc, Xuc, Xuc, Xuc, Xuc, Xuc, Xuc, Xuc, Ur, Ur, Ur, Ur, Ur, Ur, Xuc, Xuc, Zvw, Zvw, Zvw, Zvw, Uu, Zvw, Xuc, Ur, Ur, Ur, Ur, Ur, Ur, Ur, Xuc, Xuc, Xuc
Xuc, Xuc, Xuc, Xuc, Qlf, Qlf, Uu, Uu, Uh, Xuc, Uu, Zvw, Uu, Xuc, Xuc, Ur, Ur, Ur, Ur, Ur, Ur, Xuc, Xuc, Xuc, Xuc, Xuc, Xuc, Uh, Uu, Xuc, Xuc, Ur, Xuc, Ur, Xuc, Xuc, Uu, Zvw, Zvw, Zvw, Zvw, Zvw, Xuc, Xuc, Xuc, Xuc, Xuc, Ur, Ur, Ur, Xuc, Xuc, Zvw, Zvw, Qlf
Xuc, Xuc, Uh, Qlf, Qlf, Qlf, Uu, Uu, Uh, Xuc, Uu, Zvw, Uu, Xuc, Xuc, Xuc, Xuc, Ur, Ur, Ur, Xuc, Xuc, Zvw, Xuc, Xuc, Xuc, Xuc, Uh, Uu, Uu, Uu, Xuc, Xuc, Xuc, Xuc, Xuc, Uu, Zvw, Zvw, Zvw, Qlf, Qlf, Xuc, Qlf, Xuc, Xuc, Xuc, Xuc, Xuc, Xuc, Xuc, Xuc, Zvw^Vzps, Zvw, Qlf
Xuc, Uh, Uu^Zdcm, Uu^Zdcm, Qlf, Qlf, Uu, Uu, Xuc, Xuc, Zvw, Zvw, Zvw, Zvw, Zvw, Xuc, Xuc, Xuc, Xuc, Xuc, Xuc, Zvw, Zvw, Zvw, Zwsl^Zdcm, Uu, Xuc, Xuc, Uu, Uu, Uu, Uu, Xuc, Xuc, Xuc, Uu, Zvw, Zvw^Vzps, Uu, Zvw, Qlf, Xuc, Xuc, Qlf, Qlf, Xuc, Qlf, Xuc, Xuc, Xuc, Xuc, Zvw, Zvw, Zvw, Zvw
Xuc, Uh, Uu^Zdcm, Uu^Zdcm, Qlf, Qlf, Uu, Zvw, Uu, Xuc, Zvw, Zvw, Zvw, Xuc, Xuc, Xuc, Xuc, Xuc, Xuc, Xuc, Uu, Uu, Uu, Zwsl^Zdcm, Zvw^Zdcm, Zwsl^Zdcm, Zwsl^Zdcm, Uu, Uu, Uu, Uu, Uu, Xuc, Xuc, Xuc, Uu, Zvw, Zvw, Zvw, Zvw, Qlf, Xuc, Xuc, Xuc, Zvw, Zvw, Zvw, Xuc, Zvw, Xuc, Qlf^Bs/, Zvw, Xuc, Zvw, Xuc
Xuc, Xuc, Uu^Zdcm, Uu^Zdcm, Qlf, Qlf, Uu, Zvw, Zvw, Uu^Vzps, Zvw, Zvw, Uu, Xuc, Xuc, Xuc, Xuc, Xuc, 2 Kud, Xuc, Xuc, Xuc, Xuc, Xuc, Uu, Zwsl^Zdcm, Zwsl^Zdcm, Zvw, Zvw, Uu^Vzps, Zvw, Zvw, Uu, Xuc, Xuc, Xuc, Uu, Zvw, Uu, Zvw, Zvw, Qlf, Qlf, Zvw, Zvw, Zvw, Qlf^Bs\, Qlf, Zvw^Vzps, Zvw, Zvw, Qlf, Qlf^Bs/, Zvw, Xuc
Xuc, Xuc, Xuc, Uu^Zdcm, Qlf, Qlf, Qlf, Uu, Zvw, Zvw, Zvw, Uu, Xuc, Xuc, Uu, Xuc, Cud, Cud, Cud, Cud, Cud, Uu, Zvw, Zvw, Zvw, Zvw, Zvw, Zvw, Qlf, Zvw, Uu, Qlf, Qlf, Qlf, Qlf, Xuc, Qlf, Qlf^Bs|, Qlf, Qlf, Qlf, Qlf^Bs\, Zvw, Zvw, Xuc, Qlf, Qlf, Zvw, Xuc, Xuc, Xuc, Zvw, Zvw, Xuc, Xuc
Xuc, Xuc, Xuc, Qlf, Qlf, Qlf, Qlf, Uu, Zvw, Zvw, Zvw, Uu, Xuc, Xuc, Zvw, Zvw, Zvw, Cud, Zvw, Cud, Zvw, Zvw, Uu^Vzps, Zvw, Qlf, Zvw, Qlf^Bs\, Qlf, Qlf, Qlf^Bs|, Qlf, Qlf, Xuc, Xuc, Xuc, Qlf, Xuc, Zvw, Xuc, Qlf, Qlf, Zvw, Zvw, Xuc, Qlf, Xuc, Xuc, Qlf, Xuc, Xuc, Zvw, Qlf^Bs/, Xuc, Xuc, Xuc
Xuc, Xuc, Xuc, Xuc, Xuc, Qlf, Zvw, Qlf^Bs/, Qlf, Zvw, Zvw, Zvw^Vzps, Zvw, Zvw, Zvw, Zvw, Uu, Zvw, Uu, Zvw, Qlf, Uu, Qlf, Qlf, Qlf, Qlf, Zvw, Zvw, Qlf, Zvw, Zvw, Qlf, Qlf^Bs/, Zvw, Zvw, Qlf, Zvw, Zvw, Xuc, Zvw, Zvw, Qlf^Bs/, Xuc, Qlf, Xuc, Qlf, Qlf, Zvw, Zvw, Zvw^Vzps, Zvw, Zvw, Xuc, Xuc, Xuc
Xuc, Xuc, Xuc, Xuc, Xuc, Zvw, Zvw, Zvw, Qlf, Qlf, Zvw, Zvw, Uu, Zvw, Qlf, Qlf, Qlf^Bs|, Qlf, Qlf, Qlf, Zvw, Qlf^Bs|, Zvw, Qlf, Qlf, Xuc, Zvw, Zvw, Qlf, Xuc, Zvw, Zvw, Qlf, Xuc, Zvw, Qlf^Bs/, Qlf, Xuc, Xuc, Qlf, Zvw, Qlf, Zvw, Xuc, Zvw, Zvw, Zvw, Qlf^Bs/, Qlf, Zvw, Xuc, Zvw, Xuc, Xuc, Xuc
Xuc, Xuc, Xuc, Xuc, Xuc, Xuc, Zvw, Zvw, Xuc, Xuc, Zvw, Zvw, Qlf, Xuc, Qlf^Bs/, Uu, Uu, Xuc, Qlf, Xuc, Xuc, Zvw, Qlf^Bs\, Qlf, Zvw, Qlf^Bs/, Xuc, Zvw, Zvw, Qlf^Bs/, Xuc, Xuc, Qlf, Qlf, Zvw, Zvw^Vzps, Qlf, Qlf, Qlf, Qlf, Zvw, Zvw^Vzps, Zvw, Qlf^Bs/, Qlf, Qlf, Qlf, Xuc, Qlf, Qlf, Qlf^Bs/, Zvw, Xuc, Xuc, Xuc
Xuc, Xuc, Xuc, Xuc, Zvw, Qlf^Bs/, Qlf, Xuc, Qlf, Xuc, Xuc, Xuc, Qlf^Bs/, Zvw, Zvw^Vzps, Xuc, Qlf, Qlf, Qlf, Xuc, Zvw, Qlf, Qlf^Bs/, Zvw, Zvw, Qlf, Qlf, Xuc, Qlf^Bs|, Qlf, Qlf, Qlf, Zvw, Qlf^Bs/, Qlf, Qlf^Bs\, Zvw, Zvw, Zvw, Qlf^Bs/, Qlf, Zvw, Qlf, Qlf, Xuc, Xuc, Qlf, Xuc, Zvw, Zvw, Xuc, Xuc, Xuc, Xuc, Xuc
Xuc, Xuc, Xuc, Zvw, Qlf, Qlf, Xuc, Xuc, Qlf, Qlf, Xuc, Zwsl^Zdcm, Xuc, Qlf, Qlf, Qlf^Bs\, Zvw, Zvw, Zvw, Qlf^Bs/, Xuc, Zvw, Zvw^Vzps, Xuc, Qlf, Zvw, Qlf, Qlf, Zvw, Qlf, Zvw, Zvw, Zvw, Xuc, Qlf, Qlf, Xuc, Zvw, Zvw, Zvw, Qlf, Qlf, Qlf, Qlf, Xuc, Xuc, Zvw, Zvw, Zvw, Zvw, Xuc, Xuc, Xuc, Xuc, Xuc
Xuc, Xuc, Xuc, Zvw, Qlf^Bs\, Xuc, Xuc, Xuc, Xuc, Qlf, Qlf, Zwsl^Zdcm, Zwsl^Zdcm, Xuc, Xuc, Qlf, Qlf^Bs|, Qlf, Xuc, Qlf, Qlf, Xuc, Xuc, Qlf, Qlf, Qlf^Bs|, Zvw, Qlf^Bs/, Xuc, Zvw, Zvw^Vzps, Zvw, Zvw, Qlf^Bs\, Zvw, Xuc, Xuc, Xuc, Xuc, Zvw, Qlf^Bs\, Xuc, Qlf, Xuc, Xuc, Xuc, Zvw, Zvw^Vzps, Zvw, Xuc, Xuc, Xuc, Xuc, Xuc, Xuc
Xuc, Xuc, Xuc, Qlf, Qlf, Zvw, Zvw, Xuc, Zvw^Vzps, Qlf, Qlf^Bs/, Zwsl^Zdcm, Zwsl^Zdcm, Zwsl^Zdcm, Qlf, Qlf, Zvw, Zvw, Xuc, Xuc, Zvw, Qlf, Zvw, Qlf, Zvw, Zvw, Qlf^Bs|, Xuc, Zvw, Zvw, Zvw, Zvw, Xuc, Qlf, Zvw, Xuc, Qlf, Qlf, Qlf, Qlf, Zvw, Zvw, Zvw, Qlf, Qlf, Xuc, Zvw, Zvw, Xuc, Xuc, Xuc, Xuc, Xuc, Xuc, Xuc
Xuc, Xuc, Xuc, Qlf, Xuc, Qlf, Qlf^Bs/, Zvw, Qlf, Zvw, Qlf, Zwsl^Zdcm, Qlf^Bs\, Qlf, Qlf, Qlf, Qlf^Bs/, Zvw, Qlf, Zvw, Zvw, Qlf^Bs/, Zvw, Xuc, Xuc, Xuc, Zvw, Qlf, Zvw, Zvw, Zvw, Xuc, Qlf, Qlf, Xuc, Xuc, Zvw, Zvw, Zvw, Qlf^Bs/, Xuc, Xuc, Qlf, Qlf^Bs\, Zvw, Qlf^Bs/, Qlf, Xuc, Xuc, Xuc, Xuc, Xuc, Xuc, Xuc, Xuc
Xuc, Xuc, Xuc, Xuc, Zvw, Zvw, Zvw, Qlf, Qlf, Qlf, Xuc, Qlf, Zvw, Zvw, Zvw, Zvw, Xuc, Qlf, Qlf, Qlf, Qlf, Qlf, Qlf^Bs/, Zvw, Xuc, Zvw, Zvw, Qlf^Bs/, Qlf, Xuc, Qlf, Zvw, Qlf^Bs\, Qlf, Qlf^Bs/, Zvw, Qlf, Zvw, Zvw, Xuc, Xuc, Qlf, Xuc, Zvw, Zvw, Uu, Xuc, Xuc, Xuc, Xuc, Xuc, Xuc, Xuc, Xuc, Xuc
Xuc, Xuc, Xuc, Xuc, Zvw, Xuc, Zvw, Zvw, Xuc, Xuc, Xuc, Xuc, Zvw, Zvw, Ur, Zvw, Uh, Xuc, Xuc, Xuc, Xuc, Zvw, Zvw, Qlf, Qlf, Qlf, Qlf^Bs|, Qlf, Qlf, Qlf, Xuc, Qlf, Uu, Uu, Qlf, Qlf, Qlf, Xuc, Zvw, Xuc, Qlf, Qlf, Xuc, Zvw^Vzps, Uu, Xuc, Xuc, Xuc, Xuc, Xuc, Xuc, Xuc, Xuc, Xuc, Xuc
Xuc, Xuc, Xuc, Xuc, Uu, Uu, Ur, Uu, Xuc, Xuc, Xuc, Zvw, Uu, Zvw^Vzps, Ur, Uh, Uh, Uu^Zdcm, Uu^Zdcm, Xuc, Uu^Zdcm, Zwsl^Zdcm, Ur, Zvw, Zvw, Qlf, Zvw, Zvw, Zvw, Zvw, Xuc, Xuc, Xuc, Uu, Zvw, Qlf, Zvw, Qlf^Bs/, Qlf, Qlf, Xuc, Xuc, Zvw, Zvw, Uu^Zdcm, Xuc, Xuc, Xuc, Ur, Ur, Uh, Xuc, Xuc, Xuc, Xuc
Xuc, Xuc, Xuc, Uu, Uh, Uu, Ur, Uu, Xuc, Xuc, Xuc, Ur, Ur, Uu, Ur, Ur, Uh, Uu^Zdcm, Uu^Zdcm, Uu^Zdcm, Xuc, Xuc, Ur, Uu, Xuc, Zvw, Xuc, Uu, Uu, Uh, Uh, Xuc, Uu, Zvw, Xuc, Uu, Xuc, Zvw, Zvw, Zvw, Zvw, Zvw, Uu, Uu^Zdcm, Uu^Zdcm, Uu^Zdcm, Xuc, Xuc, Ur^Ziff, Uu, Uu, Uh, Xuc, Xuc, Xuc
Xuc, Xuc, Xuc, Uh, Uh, Ur, Ur, Ur, Ur, Xuc, Ur^Ziff, Ur^Ziff, Uh, Uh, Uu, Ur, Uh, Uh, Uh, Uu^Zdcm, Xuc, Xuc, Uu, Ur, Xuc, Xuc, Xuc, Uu, Xuc, Uu, Uh, Ur, Xuc, Uu, Uu, Xuc, Uu, Xuc, Uu, Zvw, Uu, Xuc, Uu, Uh, Uh, Uu^Zdcm, Ur, Ur, Ur^Ziff, Ur^Ziff, Xuc, Uh, Xuc, Xuc, Xuc
Xuc, Xuc, Xuc, Uh, Uu, Uu, Ur, Xuc, Ur, Ur^Ziff, Ur^Ziff, Ur^Ziff, Uh, Uh, Uu, Ur, Ur, Uu, Xuc, Uh, Uh, Uu, Uu, Ur, Uu, Uh, Uh, Uh, Uh, Uh, Uh, Ur, Uu, Uu, Uh, Uu, Uh, Uu, Uu, Ur, Ur, Ur, Uu^Vzps, Uh, Uh, Uh, Xuc, Xuc, Ur^Ziff, Ur^Ziff, Ur^Ziff, Uu^Ziff, Xuc, Xuc, Xuc
Xuc, Xuc, Xuc, Xuc, Uu, Uu, Ur, Ur, Ur, Ur, Uu, Uu, Uh, Xuc, Uh, Uh, Uh, Ur, Xuc, Uh, Uh, Uu, Xuc, Ur, Uu, Uh, Uu, Uh, Uu, Uh, Ur^Ziff, Ur^Ziff, Ur^Ziff, Uh, Uh, Uh, Xuc, Uh, Uu, Uu, Ur, Ur, Uu, Uh, Xuc, Xuc, Xuc, Xuc, Ur, Ur^Ziff, Ur^Ziff, Ur^Ziff, Xuc, Xuc, Xuc
Xuc, Xuc, Xuc, Uu, Uh, Uh, Uh, Ur, Ur, Ur, Uu, Uh, Uu, Uh, Uh, Uh, Uh, Ur, Ur, Xuc, Uu, Uu, Ur, Ur, Uu, Uu, Xuc, Uu, Uu, Uu, Ur^Ziff, Ur^Ziff, Ur^Ziff, Uh, Uh, Xuc, Xuc, Uh, Xuc, Ur, Ur^Ziff, Ur, Uu, Uh, Uh, Uh, Uh, Uh, Uu, Uu, Xuc, Xuc, Xuc, Xuc, Xuc
Xuc, Xuc, Uu, Uu, Uh, Uh, Ur, Ur, Ur^Vzps, Ur, Uu, Uu, Uh, Uu^Zdcm, Uu^Zdcm, Uh, Uh, Uh, Ur, Xuc, Uu, Ur, Ur^Vzps, Ur, Uh, Xuc, Xuc, Xuc, Xuc, Xuc, Uh, Ur^Ziff, Ur, Ur^Ziff, Uh, Uh, Xuc, Uu, Uu, Ur, Ur^Ziff, Ur^Vzps, Uu, Uh, Uh, Uh, Uh, Uu, Uu, Uu, Xuc, Xuc, Xuc, Xuc, Xuc
Xuc, Xuc, Uu, Uh, Uh, Uh, Ur^Ziff, Ur, Ur, Ur, Ur, Xuc, Uu^Zdcm, Uu^Zdcm, Xuc, Xuc, Xuc, Uh, Xuc, Ur, Ur, Ur, Ur, Ur, Xuc, Uh, Uh, Xuc, Ur, Uh, Ur, Ur, Uh, Ur, Ur, Uh, Uh, Xuc, Uu, Ur, Ur^Ziff, Ur^Ziff, Uu, Uu, Uu^Zdcm, Uh, Uu, Uu, Uu, Xuc, Xuc, Xuc, Xuc, Xuc, Xuc
Xuc, Xuc, Uu, Uh, Uh, Ur^Ziff, Ur^Ziff, Ur^Ziff, Uh, Uh, Uu, Ur, Uu^Zdcm, Uu^Zdcm, Uu^Zdcm, Xuc, Xuc, Xuc, Xuc, Uh, Ur, Ur, Ur^Ziff, Uu, Xuc, Xuc, Uu, Ur, Uh, Ur, Xuc, Xuc, Uh, Uu, Ur, Uh, Uh, Uh, Uh, Ur^Ziff, Ur^Ziff, Ur^Ziff, Xuc, Uu^Zdcm, Uu^Zdcm, Uu^Zdcm, Xuc, Uu, Xuc, Xuc, Xuc, Xuc, Xuc, Xuc, Xuc
Xuc, Uu, Uu, Uh, Uh, Ur^Ziff, Ur^Ziff, Ur^Ziff, Uh^Ziff, Uu, Xuc, Ur, Ur, Uh, Uh, Xuc, Xuc, Xuc, Uh, Uh, Ur^Ziff, Ur^Ziff, Ur^Ziff, Uu, Xuc, Uu, Uh, Ur, Uh, Uh, Xuc, Xuc, Uh, Uu, Ur, Ur, Ur, Uh, Uh, Ur, Ur^Ziff, Ur, Uu^Zdcm, Uu^Zdcm, Uu^Zdcm, Xuc, Xuc, Uu, Xuc, Xuc, Xuc, Xuc, Xuc, Xuc, Xuc
Xuc, Xuc, Uu, Uh, Uh, Ur, Ur, Uh, Uh, Uu, Xuc, Xuc, Xuc, Ur, Ur, Xuc, Xuc, Uh, Uh, Uh, Ur^Ziff, Ur^Ziff, Ur^Ziff, Uu, Uh, Uu, Uu, Ur, Uh, Uh, Xuc, Xuc, Xuc, Uh, Uh, Ur, Ur, Uh, Uh, Ur, Ur, Ur, Xuc, Uu^Zdcm, Uu^Zdcm, Uu^Zdcm, Uu^Zdcm, Uu, Xuc, Xuc, Xuc, Xuc, Xuc, Xuc, Xuc
Xuc, Xuc, Xuc, Uu, Uu, Uh, Ur, Uh, Uh, Uu, Uh, Xuc, Ur, Xuc, Ur, Ur, Ur, Uu, Ur, Uu, Ur, Ur^Ziff, Ur^Ziff, Ur, Ur, Uh, Uu, Ur, Uu, Xuc, Xuc, Xuc, Xuc, Xuc, Xuc, Uh, Ur, Ur, Ur, Ur, Ur, Ur, Ur, Ur, Ur, Xuc, Xuc, Uu^Zdcm, Xuc, Xuc, Xuc, Xuc, Xuc, Xuc, Xuc
Xuc, Xuc, Xuc, Xuc, Uu, Uh, Ur, Ur, Ur, Uh, Ur, Ur, Ur, Uu, Uu, Uu, Ur, Ur, Ur, Ur, Xuc, Xuc, Ur^Ziff, Xuc, Ur, Uu, Ur, Ur, Uu, Uu, Xuc, Xuc, Xuc, Xuc, Xuc, Xuc, Uh, Uh, Ur, Ur, Xuc, Ur, Ur, Xuc, Xuc, Ur, Ur, Ur, Xuc, Xuc, Xuc, Xuc, Xuc, Xuc, Xuc
Xuc, Xuc, Xuc, Xuc, Xuc, Uh, Ur, Ur, Urb^Vzps, Ur, Ur, Xuc, Ur, Ur, Ur, Ur, Xuc, Ur, Ur, Xuc, Ur, Ur, Xuc, Ur, Ur, Ur, Ur, Ur, Uu, Uu, Uu, Xuc, Xuc, Xuc, Xuc, Xuc, Uh, Uh, Uh, Ur, Ur, Xuc, Ur, Ur, Ur, Xuc, Xuc, Ur, Ur, Xuc, Xuc, Xuc, Xuc, Xuc, Xuc
Xuc, Xuc, Xuc, Xuc, Xuc, Xuc, Xuc, Ur, Ur, Ur, Ur, Ur, Ur, Ur, Xuc, Ur, Xuc, Ur, Ur, Ur, Ur, Xuc, Ur, Ur, Ur^Vzps, Ur, Ur, Ur, Ur, Ur, Ur, Uu, Xuc, Xuc, Xuc, Xuc, Xuc, Xuc, Xuc, Xuc, Xuc, Ur, Xuc, Ur, Xuc, Ur, Ur, Ur, Ur, Xuc, Ur, Xuc, Xuc, Xuc, Xuc
Xol, Xol, Xol, Xol, Xol, Xol, Urb, Ur, Ur, Ur, Ur, Ur, Ur, Xuc, Xuc, Ur, Xol, Xuc, Xol, Ur, Xol, Xuc, Xuc, Ur, Ur, Ur, Urb, Ur, Xol, Ur, Urb, Ur, Xol, Xol, Xol, Xol, Xol, Xol, Xol, Xol, Xol, Ur, Urb, Xuc, Urb, Ur, Urb, Urb, Urb, Ur, Urb, Ur, Xol, Xol, Xol
Xol, Xol, Xol, Xol, Urb, Urb, Urb, Xol, Urb, Urb, Urb, Ur, Urb, Xol, Xol, Ur, Xol, Xol, Xol, Xol, Xol, Xol, Ur, Ur, Urb, Urb, Xol, Urb, Urb, Xol, Urb, Urb, Urb, Xol, Xol, Xol, Xol, Xol, Xol, Xol, Xol, Urb, Urb, Urb, Xol, Xol, Xol, Urb, Urb, Xol, Xol, Urb, Xol, Xol, Xol
Xol, Xol, Xol, Xol, Urb, Urb, Xol, Urb, Urb, Urb, Urb, Urb^Vzps, Urb, Urb, Urb, Urb, Xol, Xol, Xol, Xol, Xol, Xol, Urb, Urb, Xol, Xol, Xol, Xol, Xol, Urb, Urb, Urb, Urb, Xol, Xol, Xol, Xol, Xol, Xol, Xol, Xol, Urb, Urb, Xol, Xol, Xol, Urb, Xol, Urb, Urb, Urb, Urb, Xol, Xol, Xol
Xol, Xol, Urb, Urb, Xol, Xol, Urb, Xol, Urb, Urb, Xol, Urb, Urb, Urb, Xol, Xol, Xol, Xol, Xol, Xol, Xol, Xol, Urb, Urb, Xol, Xol, Xol, Xol, Urb, Urb, Urb, Urb, Urb, Urb, Urb, Urb, Urb, Urb, Urb, Xol, Xol, Urb, Xol, Urb, Urb, Urb, Urb, Urb, Xol, Urb, Xol, Urb, Xol, Xol, Xol
Xol, Xol, Urb, Xol, Urb, Urb, Urb, Xol, Urb, Xol, Xol, Urb, Urb, Xol, Xol, Xol, Xol, Xol, Xol, Xol, Urb, Urb, Urb, Urb, Xol, Xol, Xol, Urb, Urb, Xol, Urb, Urb, Urb, Xol, Urb, Urb, Urb, Urb, Xol, Xol, Xol, Xol, Xol, Xol, Urb, Urb, Urb^Vzps, Urb, Urb, Urb, Urb, Urb, Xol, Xol, Xol
Xol, Xol, Xol, Urb, Urb, Urb, Xol, Urb, Xol, Xol, Xol, Xol, Xol, Xol, Xol, Xol, Urb, Xol, Urb, Urb, Urb, Urb, Urb, Xol, Xol, Xol, Urb, Urb, Xol, Xol, Urb, Xol, Urb, Urb, Urb, Urb, Urb, Urb, Urb, Xol, Xol, Xol, Xol, Urb, Urb, Urb, Urb, Urb, Urb, Urb, Xol, Urb, Xol, Xol, Xol
Xol, Xol, Xol, Xol, Urb, Urb, Urb, Urb, Urb, Urb, Xol, Xol, Xol, Xol, Urb, Urb, Urb, Urb, Urb, Urb, Urb, Urb, Xol, Xol, Xol, Xol, Xol, Urb, Urb, Urb, Xol, Urb, Urb, Urb, Urb, Urb^Vzps, Urb, Urb, Urb, Xol, Xol, Xol, Xol, Urb, Urb, Urb, Urb, Urb, Urb, Urb, Xol, Xol, Xol, Xol, Xol
Xol, Xol, Xol, Xol, Xol, Urb, Urb, Urb, Xol, Xol, Xol, Xol, Xol, Xol, Urb, Urb, Urb, Xol, Urb, Urb, Xol, Xol, Xol, Xol, Xol, Xol, Xol, Urb, Urb, Urb, Urb, Xol, Urb, Urb, Urb, Urb, Urb, Urb, Urb, Urb, Xol, Xol, Xol, Xol, Xol, Xol, Xol, Urb, Urb, Urb, Xol, Xol, Xol, Xol, Xol
Xol, Xol, Xol, Xol, Xol, Xol, Xol, Xol, Urb, Urb, Urb, Xol, Urb, Xol, Xol, Urb, Urb, Urb, Xol, Xol, Xol, Xol, Xol, Xol, Xol, Xol, Xol, Xol, Xol, Urb, Xol, Urb, Xol, Xol, Xol, Urb, Urb, Urb, Urb, Urb, Urb, Xol, Xol, Xol, Urb, Urb, Urb, Xol, Xol, Urb, Xol, Xol, Xol, Xol, Xol
Xol, Xol, Xol, Xol, Xol, Xol, Urb, Urb, Urb, Urb, Urb, Urb, Urb, Urb, Urb, Xol, Urb, Urb, Xol, Xol, Xol, Xol, Xol, Xol, Xol, Xol, Xol, Xol, Xol, Xol, Xol, Xol, Xol, Xol, Xol, Xol, Xol, Urb, Xol, Urb, Urb, Xol, Urb, Urb, Urb, Urb, Urb, Urb, Urb, Xol, Xol, Xol, Xol, Xol, Xol
Xol, Xol, Xol, Xol, Xol, Xol, Urb, Urb, Urb, Urb, 1 Urb, Urb, Urb, Urb, Urb, Xol, Xol, Xol, Xol, Xol, Xol, Xol, Xol, Xol, Xol, Xol, Xol, Xol, Xol, Xol, Xol, Xol, Xol, Xol, Xol, Xol, Xol, Xol, Xol, Xol, Xol, Xol, Urb, Urb, Urb, Urb, Urb, Urb, Urb, Xol, Xol, Xol, Xol, Xol, Xol
Xol, Xol, Xol, Xol, Xol, Xol, Urb, Urb, Urb, Urb, Urb, Urb, Urb, Urb, Urb, Urb, Xol, Xol, Xol, Xol, Xol, Xol, Xol, Xol, Xol, Xol, Xol, Xol, Xol, Xol, Xol, Xol, Xol, Xol, Xol, Xol, Xol, Xol, Xol, Xol, Xol, Urb, Urb, Urb, Urb, Urb, Urb, Urb, Urb, Urb, Xol, Xol, Xol, Xol, Xol
Xol, Xol, Xol, Xol, Xol, Xol, Urb, Urb, Urb, Urb, Urb, Urb, Urb, Urb, Urb, Urb, Xol, Xol, Xol, Xol, Xol, Xol, Xol, Xol, Xol, Xol, Xol, Xol, Xol, Xol, Xol, Xol, Xol, Xol, Xol, Xol, Xol, Xol, Xol, Xol, Xol, Urb, Urb, Urb, Urb, Urb, Urb, Urb, Urb, Urb, Urb, Xol, Xol, Xol, Xol
