border_size=1
usage=map

Xol         , Xol         , Xol         , Xol         , Xol         , Xol         , Xol         , Xol         , Xol         , Xol         , Mm^Xm       , Xol         , Xol         , Xol         , Xol         , Xol         , Xol         , Xol         , Xol         , Xol         , Xol         , Xol         , Xol         , Xol         , Xol         , Xol         , Xol         , Xol         , Mm^Xm       , Xol         , Mm^Xm       , Xol         , Xol         , Xol         , Xol         , Xol         , Xol         , Xol         , Xol         , Xol         , Xol         , Xol         , Xol         , Xol         , Xol         , Xol         , Xol         , Xol         , Xol         , Xol         , Xol         , Xol         , Xol         
Xol         , Xol         , Xol         , Xol         , Xol         , Xol         , Xol         , Xol         , Mm^Xm       , Mm^Xm       , Md          , Mm^Xm       , Mm^Xm       , Mm^Xm       , Mm^Xm       , Xol         , Mm^Xm       , Xol         , Xol         , Xol         , Mm^Xm       , Xol         , Mm^Xm       , Mm^Xm       , Mm^Xm       , Xol         , Mm^Xm       , Mm^Xm       , Md          , Mm^Xm       , Md          , Mm^Xm       , Mm^Xm       , Xol         , Xol         , Xol         , Xol         , Xol         , Xol         , Xol         , Xol         , Xol         , Xol         , Xol         , Xol         , Xol         , Xol         , Xol         , Xol         , Xol         , Xol         , Xol         , Xol         
Xol         , Xol         , Xol         , Xol         , Xol         , Xol         , Mm^Xm       , Mm^Xm       , Md          , Md          , Hh^Fms      , Md          , Md^Vhh      , Md          , Mm^Xm       , Mm^Xm       , Md          , Mm^Xm       , Mm^Xm       , Mm^Xm       , Md          , Mm^Xm       , Md          , Md          , Md          , Mm^Xm       , Md          , Md          , Hh^Fms      , Md          , Hh^Fms      , Md          , Md          , Mm^Xm       , Mm^Xm       , Mm^Xm       , Mm^Xm       , Xol         , Mm^Xm       , Xol         , Xol         , Xol         , Xol         , Xol         , Xol         , Xol         , Xol         , Xol         , Xol         , Xol         , Xol         , Xol         , Xol         
Xol         , Xol         , Xol         , Xol         , Xol         , Mm^Xm       , Md          , Md          , Hh^Fms      , Hh^Fms      , Cud         , Gs^Fds      , Gg          , Hh^Fms      , Hh^Fms      , Hh^Fms      , Hh^Fms      , Md          , Md          , Md          , Hh^Fms      , Md          , Hh^Fms      , Md          , Md          , Md          , Hh^Fms      , Hh^Fms      , Hh^Fms      , Hh^Fms      , Gs^Fds      , Hh^Fms      , Hh^Fms      , Md          , Md          , Md          , Md          , Mm^Xm       , Md          , Mm^Xm       , Mm^Xm       , Xol         , Xol         , Xol         , Xol         , Xol         , Xol         , Xol         , Xol         , Xol         , Xol         , Xol         , Xol         
Xol         , Xol         , Xol         , Xol         , Xol         , Mm^Xm       , Md          , Hh^Vhh      , Hh^Fms      , Cud         , 2 Kud       , Cud         , Gg          , Gg          , Gs^Fds      , Hh^Fms      , Md          , Md          , Md          , Hh^Fms      , Rr^Ve       , Hh^Fms      , Hh^Fms      , Hh^Fms      , Md          , Md          , Md          , Hh^Fms      , Gs^Fds      , Gs^Fds      , Gs^Fds      , Gs^Fds      , Gg^Ve       , Hh^Fms      , Gs^Fds      , Hh^Fms      , Hh^Fms      , Md          , Hh^Fms      , Md          , Md          , Mm^Xm       , Xol         , Xol         , Xol         , Xol         , Xol         , Xol         , Xol         , Xol         , Xol         , Xol         , Xol         
Xol         , Xol         , Xol         , Xol         , Xol         , Mm^Xm       , Md          , Hh^Fms      , Hh^Fms      , Cud         , Cud         , Cud         , Gg          , Gg          , Gs^Fds      , Hh^Fms      , Mv          , Md          , Md          , Hh^Fms      , Hh^Fms      , Rr^Fds      , Gs^Fds      , Hh^Fms      , Mv          , Mm^Xm       , Md          , Hh^Fms      , Gs^Fds      , Gs^Fds      , Rr          , Gs^Fds      , Rr          , Gs^Fds      , Gs^Fds      , Gs^Fds      , Gg^Ve       , Hh^Fms      , Gs^Fds      , Hh^Fms      , Md          , Mm^Xm       , Xol         , Xol         , Xol         , Xol         , Xol         , Xol         , Xol         , Xol         , Xol         , Xol         , Xol         
Xol         , Xol         , Xol         , Xol         , Xol         , Mm^Xm       , Mm^Xm       , Hh^Fms      , Hh^Fms      , Gs^Fds      , Gg          , Rr          , Rr          , Gg          , Gg^Ve       , Qlf         , Md          , Mm^Xm       , Md          , Hh^Fms      , Hh^Fms      , Rr^Fds      , Qlf^Bsb\    , Qlf         , Hh^Fms      , Md          , Hh^Fms      , Hh^Fms      , Gs^Fds      , Rr          , Gs^Fds      , Rr          , Gs^Fds      , Rr          , Rr          , Rr          , Rr          , Gg          , Gs^Fds      , Hh^Fms      , Md          , Mm^Xm       , Xol         , Xol         , Xol         , Xol         , Xol         , Xol         , Xol         , Xol         , Xol         , Xol         , Xol         
Xol         , Xol         , Xol         , Xol         , Xol         , Xol         , Xol         , Mm^Xm       , Hh^Fms      , Gs^Fds      , Gg^Ve       , Gg          , Rr          , Gg          , Qlf         , Qlf^Bsb\    , Hh^Fms      , Md          , Hh^Fms      , Hh^Fms      , Hh^Fms      , Hh^Fms      , Qlf         , Rr^Fds      , Rr^Fds      , Hh^Fms      , Rr^Fds      , Gs^Fds      , Gg          , Rr^Ve       , Gs^Fds      , Gs^Fds      , Hh^Fms      , Gs^Fds      , Hh^Fms      , Gs^Fds      , Gs^Fds      , Rr          , Gs^Fds      , Hh^Fms      , Md          , Mm^Xm       , Mm^Xm       , Xol         , Xol         , Xol         , Xol         , Xol         , Xol         , Xol         , Xol         , Xol         , Xol         
Xol         , Xol         , Xol         , Xol         , Xol         , Xol         , Xol         , Mm^Xm       , Md          , Md          , Md          , Gs^Fds      , Qlf         , Qlf^Bsb\    , Rr          , Gs^Fds      , Gs^Fds      , Hh^Fms      , Gs^Fds      , Hh^Fms      , Qlf^Bsb\    , Qlf         , Hh^Fms      , Gs^Fds      , Gs^Fds      , Rr^Fds      , Gs^Fds      , Rr          , Rr          , Rr          , Hh^Fms      , Hh^Fms      , Md          , Md          , Md          , Hh^Fms      , Gs^Fds      , Rr          , Gs^Fds      , Hh^Fms      , Mv          , Md          , Mm^Xm       , Xol         , Xol         , Xol         , Xol         , Xol         , Xol         , Xol         , Xol         , Xol         , Xol         
Xol         , Xol         , Xol         , Xol         , Xol         , Xol         , Xol         , Mm^Xm       , Mm^Xm       , Md          , Md          , Hh^Fms      , Qlf         , Gs^Fds      , Gg^Fet      , Rr          , Rr^Ve       , Gs^Fds      , Gg          , Gs^Fds      , Qlf         , Hh^Fms      , Hh^Fms      , Hh^Fms      , Hh^Fms      , Hh^Fms      , Hh^Fms      , Gs^Fds      , Gs^Fds      , Rr          , Gs^Fds      , Hh^Fms      , Md          , Mm^Xm       , Md          , Hh^Fms      , Gs^Fds      , Rr^Ve       , Qlf         , Qlf         , Hh^Fms      , Md          , Mm^Xm       , Xol         , Xol         , Xol         , Xol         , Xol         , Xol         , Xol         , Xol         , Xol         , Xol         
Xol         , Xol         , Xol         , Xol         , Xol         , Xol         , Xol         , Xol         , Xol         , Mm^Xm       , Md          , Md          , Qlf^Bsb\    , Gg^Ve       , Gs^Fds      , Gg          , Rr          , Gg          , Qlf         , Qlf         , Gg          , Hh^Fms      , Hh^Fms      , Md          , Mm^Xm       , Md          , Hh^Fms      , Hh^Fms      , Gs^Fds      , Rr          , Gs^Fds      , Hh^Fms      , Hh^Fms      , Hh^Fms      , Hh^Fms      , Hh^Fms      , Gs^Fds      , Rr          , Qlf^Bsb\    , Gs^Fds      , Hh^Fms      , Hh^Fms      , Md          , Mm^Xm       , Xol         , Xol         , Xol         , Xol         , Xol         , Xol         , Xol         , Xol         , Xol         
Xol         , Xol         , Xol         , Xol         , Xol         , Xol         , Xol         , Xol         , Xol         , Mm^Xm       , Mm^Xm       , Md          , Qlf         , Hh^Fms      , Hh^Fms      , Gs^Fds      , Gs^Fds      , Qlf^Bsb\    , Rr          , Gg^Ve       , Gg          , Gs^Fds      , Hh^Fms      , Md          , Md          , Md          , Hh^Fms      , Hh^Fms      , Gs^Fds      , Rr          , Gg          , Gs^Fds      , Gg          , Hh^Fms      , Gs^Fds      , Gs^Fds      , Qlf         , Qlf         , Rr          , Rr          , Gs^Fds      , Md          , Md          , Mm^Xm       , Xol         , Xol         , Xol         , Xol         , Xol         , Xol         , Xol         , Xol         , Xol         
Xol         , Xol         , Xol         , Xol         , Xol         , Xol         , Xol         , Xol         , Xol         , Xol         , Xol         , Mm^Xm       , Mm^Xm       , Qlf         , Qlf^Bsb/    , Gs^Fds      , Qlf         , Qlf         , Gg          , Rr          , Rr          , Gs^Fds      , Gs^Fds      , Hh^Fms      , Hh^Fms      , Hh^Fms      , Gs^Fds      , Gs^Fds      , Gs^Fds      , Rr          , Rr          , Gg          , Gg          , Gg          , Rr^Ve       , Rr          , Qlf^Bsb\    , Gg          , Rr^Ve       , Gs^Fds      , Hh^Fms      , Hh^Fms      , Mm^Xm       , Mm^Xm       , Xol         , Xol         , Xol         , Xol         , Xol         , Xol         , Xol         , Xol         , Xol         
Xol         , Xol         , Xol         , Xol         , Xol         , Xol         , Xol         , Xol         , Xol         , Xol         , Xol         , Xol         , Mm^Xm       , Md^Vhh      , Md          , Qlf         , Hh^Fms      , Gs^Fds      , Gg^Ve       , Rr          , Gg          , Rr          , Rr          , Gs^Fds      , Rr          , Gs^Fds      , Gg          , Gs^Fds      , Rr          , Rr          , Gg          , Rr          , Rr^Fds      , Rr          , Qlf         , Qlf         , Gs^Fds      , Rr^Fds      , Gs^Fds      , Gs^Fds      , Hh^Fms      , Md          , Mm^Xm       , Xol         , Xol         , Xol         , Xol         , Xol         , Xol         , Xol         , Xol         , Xol         , Xol         
Xol         , Xol         , Xol         , Xol         , Xol         , Xol         , Xol         , Xol         , Xol         , Xol         , Xol         , Xol         , Xol         , Mm^Xm       , Mm^Xm       , Qlf         , Qlf         , Hh^Fms      , Rr^Fds      , Rr          , Rr          , Gg          , Gs^Fds      , Rr^Ve       , Gs^Fds      , Rr          , Rr          , Rr          , Gg          , Gg^Ve       , Gg          , Gs^Fds      , Qlf         , Qlf^Bsb\    , Hh^Fms      , Gs^Fds      , Hh^Fms      , Gs^Fds      , Gs^Fds      , Hh^Fms      , Md          , Mm^Xm       , Xol         , Xol         , Xol         , Xol         , Xol         , Xol         , Xol         , Xol         , Xol         , Xol         , Xol         
Xol         , Xol         , Xol         , Xol         , Xol         , Xol         , Xol         , Xol         , Xol         , Xol         , Xol         , Xol         , Xol         , Xol         , Mm^Xm       , Md          , Md^Vhh      , Qlf^Bsb/    , Qlf         , Gg          , Rr          , Gs^Fds      , Hh^Fms      , Gs^Fds      , Gs^Fds      , Gs^Fds      , Gg          , Rr          , Rr          , Gg          , Gs^Fds      , Qlf         , Hh^Fms      , Hh^Fms      , Md          , Md          , Hh^Fms      , Gs^Fds      , Gs^Fds      , Hh^Fms      , Mm^Xm       , Mm^Xm       , Xol         , Xol         , Xol         , Xol         , Xol         , Xol         , Xol         , Xol         , Xol         , Xol         , Xol         
Xol         , Xol         , Xol         , Xol         , Xol         , Xol         , Xol         , Xol         , Xol         , Xol         , Xol         , Xol         , Xol         , Xol         , Xol         , Mm^Xm       , Md          , Hh^Fms      , Rr          , Qlf^Bsb/    , Qlf         , Hh^Fms      , Hh^Fms      , Hh^Fms      , Hh^Fms      , Gs^Fds      , Gg          , Gg          , Rr          , Gg          , Qlf         , Qlf         , Hh^Fms      , Hh^Fms      , Md          , Mm^Xm       , Md          , Hh^Fms      , Gs^Fds      , Hh^Fms      , Md          , Mm^Xm       , Xol         , Xol         , Xol         , Xol         , Xol         , Xol         , Xol         , Xol         , Xol         , Xol         , Xol         
Xol         , Xol         , Xol         , Xol         , Xol         , Xol         , Xol         , Xol         , Xol         , Xol         , Xol         , Xol         , Xol         , Xol         , Mm^Xm       , Mm^Xm       , Md          , Hh^Fms      , Rr          , Gs^Fds      , Qlf         , Md          , Mm^Xm       , Md          , Hh^Fms      , Gs^Fds      , Gg^Ve       , Gg          , Qlf         , Qlf^Bsb\    , Rr          , Gs^Fds      , Gs^Fds      , Hh^Fms      , Hh^Fms      , Md          , Hh^Fms      , Hh^Fms      , Gs^Fds      , Hh^Fms      , Md          , Mm^Xm       , Xol         , Xol         , Xol         , Xol         , Xol         , Xol         , Xol         , Xol         , Xol         , Xol         , Xol         
Xol         , Xol         , Xol         , Xol         , Xol         , Xol         , Xol         , Xol         , Xol         , Xol         , Xol         , Xol         , Xol         , Mm^Xm       , Md          , Md          , Md          , Hh^Fms      , Gs^Fds      , Rr          , Qlf         , Mv          , Hh^Fms      , Md          , Hh^Fms      , Gs^Fds      , Qlf         , Qlf         , Gg          , Gg          , Gg^Ve       , Rr          , Gg          , Gs^Fds      , Hh^Fms      , Hh^Fms      , Gs^Fds      , Gs^Fds      , Hh^Fms      , Md          , Mm^Xm       , Mm^Xm       , Xol         , Xol         , Xol         , Xol         , Xol         , Xol         , Xol         , Xol         , Xol         , Xol         , Xol         
Xol         , Xol         , Xol         , Xol         , Xol         , Xol         , Xol         , Xol         , Xol         , Xol         , Xol         , Xol         , Xol         , Mm^Xm       , Md          , Md          , Hh^Fms      , Gs^Fds      , Gg          , Rr          , Gs^Fds      , Qlf         , Qlf^Bsb/    , Hh^Fms      , Qlf         , Qlf^Bsb\    , Rr          , Gg          , Cv          , Gg          , Rr          , Rr          , Rr          , Rr          , Rr^Ve       , Gs^Fds      , Gs^Fds      , Gs^Fds      , Md          , Md          , Mm^Xm       , Xol         , Xol         , Xol         , Xol         , Xol         , Xol         , Xol         , Xol         , Xol         , Xol         , Xol         , Xol         
Xol         , Xol         , Xol         , Xol         , Xol         , Xol         , Xol         , Xol         , Xol         , Xol         , Xol         , Xol         , Xol         , Mm^Xm       , Md          , Hh^Fms      , Hh^Fms      , Gs^Fds      , Gg^Ve       , Rr          , Rr          , Rr^Fds      , Hh^Fms      , Qlf         , Qlf^Bsb/    , Rr^Fds      , Gs^Fds      , Cv          , Kv          , Cv          , Cv          , Gg          , Gs^Fds      , Gs^Fds      , Gs^Fds      , Rr          , Rr          , Gs^Fds      , Md          , Mm^Xm       , Xol         , Xol         , Xol         , Xol         , Xol         , Xol         , Xol         , Xol         , Xol         , Xol         , Xol         , Xol         , Xol         
Xol         , Xol         , Xol         , Xol         , Xol         , Xol         , Xol         , Xol         , Xol         , Xol         , Xol         , Xol         , Xol         , Mm^Xm       , Mm^Xm       , Md          , Hh^Fms      , Hh^Fms      , Rr          , Rr          , Gs^Fds      , Gs^Fds      , Hh^Fms      , Hh^Fms      , Qlf         , Hh^Fms      , Hh^Fms      , Cv          , Cv          , Cv          , Gs^Fds      , Gs^Fds      , Hh^Fms      , Gs^Fds      , Gs^Fds      , Gs^Fds      , Hh^Fms      , Rr          , Rr          , Mm^Xm       , Mm^Xm       , Xol         , Xol         , Xol         , Xol         , Xol         , Xol         , Xol         , Xol         , Xol         , Xol         , Xol         , Xol         
Urb         , Urb         , Urb         , Urb         , Urb         , Xol         , Xol         , Xol         , Xol         , Xol         , Xol         , Xol         , Xol         , Xol         , Mm^Xm       , Md          , Rr          , Rr          , Hh^Fms      , Rr          , Hh^Fms      , Hh^Fms      , Md          , Md          , Mm^Xm       , Md          , Md          , Gs^Fds      , Gg          , Rr          , Hh^Fms      , Hh^Fms      , Hh^Fms      , Hh^Fms      , Md          , Hh^Fms      , Md          , Hh^Fms      , Rr          , Hh^Fms      , Mm^Xm       , Xol         , Xol         , Xol         , Xol         , Xol         , Xol         , Xol         , Xol         , Xol         , Xol         , Xol         , Xol         
Urb         , Urb         , Urb         , Urb         , Urb         , Urb         , Xol         , Xol         , Xol         , Xol         , Xol         , Xol         , Xol         , Xol         , Mm^Xm       , Hh^Fms      , Rr          , Md          , Md          , Rr          , Rr          , Mm^Xm       , Mm^Xm       , Mm^Xm       , Xol         , Mm^Xm       , Mm^Xm       , Hh^Fms      , Gg          , Rr          , Mm^Xm       , Md          , Mm^Xm       , Md          , Mm^Xm       , Md          , Mm^Xm       , Mm^Xm       , Rr          , Gg          , Xol         , Xol         , Xol         , Xol         , Xol         , Xol         , Xol         , Xol         , Xol         , Xol         , Xol         , Xol         , Xol         
Urb         , Urb         , Urb         , Urb         , Urb         , Urb         , Xol         , Xol         , Xol         , Xol         , Xol         , Xol         , Xol         , Mm^Xm       , Urb         , Rr          , Gg          , Mm^Xm       , Mm^Xm       , Hh^Fms      , Rr          , Mm^Xm       , Xol         , Xol         , Xol         , Xol         , Xol         , Mm^Xm       , Urb         , Urb         , Mm^Xm       , Mm^Xm       , Xol         , Mm^Xm       , Xol         , Mm^Xm       , Xol         , Xol         , Urb         , Urb         , Urb         , Xol         , Xol         , Xol         , Xol         , Xol         , Xol         , Xol         , Xol         , Xol         , Xol         , Xol         , Xol         
Urb         , Urb         , Urb         , Urb         , Urb         , Urb         , Urb         , Xol         , Xol         , Xol         , Xol         , Xol         , Urb         , Urb         , Urb         , Urb         , Mm^Xm       , Mm^Xm       , Xol         , Urb         , Urb         , Mm^Xm       , Xol         , Xol         , Xol         , Xol         , Xol         , Mm^Xm       , Urb         , Urb         , Mm^Xm       , Xol         , Xol         , Xol         , Xol         , Xol         , Xol         , Xol         , Xol         , Urb         , Urb         , Xol         , Xol         , Xol         , Xol         , Xol         , Xol         , Xol         , Xol         , Xol         , Xol         , Xol         , Xol         
Urb         , Urb         , Urb         , Urb         , Urb         , Urb         , Urb         , Urb         , Urb         , Xol         , Xol         , Urb         , Urb         , Urb         , Urb         , Xol         , Xol         , Xol         , Xol         , Urb         , Urb         , Xol         , Xol         , Xol         , Xol         , Xol         , Xol         , Xol         , Urb         , Urb         , Xol         , Xol         , Xol         , Xol         , Xol         , Xol         , Xol         , Xol         , Xol         , Urb         , Urb         , Urb         , Xol         , Xol         , Xol         , Xol         , Xol         , Xol         , Xol         , Xol         , Xol         , Xol         , Xol         
Urb         , Urb         , Urb         , Urb         , Xol         , Xol         , Xol         , Urb         , Urb         , Urb         , Urb         , Urb         , Urb         , Urb         , Xol         , Xol         , Xol         , Xol         , Urb         , Urb         , Urb         , Xol         , Xol         , Xol         , Xol         , Xol         , Xol         , Xol         , Urb         , Urb         , Xol         , Xol         , Xol         , Xol         , Xol         , Xol         , Xol         , Xol         , Xol         , Xol         , Urb         , Urb         , Urb         , Xol         , Xol         , Xol         , Xol         , Xol         , Xol         , Xol         , Xol         , Xol         , Xol         
Urb         , Urb         , Xol         , Xol         , Xol         , Xol         , Xol         , Xol         , Xol         , Urb         , Urb         , Urb         , Xol         , Xol         , Xol         , Xol         , Urb         , Urb         , Urb         , Urb         , Urb         , Xol         , Xol         , Xol         , Xol         , Xol         , Xol         , Xol         , Urb         , Urb         , Xol         , Xol         , Xol         , Xol         , Xol         , Xol         , Xol         , Xol         , Xol         , Xol         , Urb         , Urb         , Urb         , Urb         , Xol         , Xol         , Xol         , Xol         , Xol         , Xol         , Xol         , Xol         , Xol         
Xol         , Xol         , Xol         , Xol         , Xol         , Xol         , Xol         , Xol         , Xol         , Xol         , Xol         , Xol         , Xol         , Xol         , Xol         , Xol         , Urb         , Urb         , Urb         , Urb         , Xol         , Xol         , Xol         , Xol         , Xol         , Xol         , Xol         , Xol         , Urb         , Urb         , Xol         , Xol         , Xol         , Xol         , Xol         , Xol         , Xol         , Xol         , Xol         , Xol         , Xol         , Urb         , Urb         , Urb         , Urb         , Xol         , Xol         , Xol         , Xol         , Xol         , Xol         , Xol         , Xol         
Xol         , Xol         , Xol         , Xol         , Xol         , Xol         , Xol         , Xol         , Xol         , Xol         , Xol         , Xol         , Xol         , Xol         , Urb         , Urb         , Urb         , Urb         , Xol         , Xol         , Xol         , Xol         , Xol         , Xol         , Xol         , Xol         , Xol         , Xol         , Urb         , Urb         , Xol         , Xol         , Xol         , Xol         , Xol         , Xol         , Xol         , Xol         , Xol         , Xol         , Xol         , Xol         , Xol         , Urb         , Urb         , Urb         , Xol         , Xol         , Xol         , Xol         , Xol         , Xol         , Xol         
Xol         , Xol         , Xol         , Xol         , Xol         , Xol         , Xol         , Xol         , Urb         , Xol         , Xol         , Xol         , Urb         , Urb         , Urb         , Urb         , Xol         , Xol         , Xol         , Xol         , Xol         , Xol         , Xol         , Xol         , Xol         , Xol         , Xol         , Xol         , Urb         , Urb         , Xol         , Xol         , Xol         , Xol         , Xol         , Xol         , Xol         , Xol         , Xol         , Xol         , Xol         , Xol         , Xol         , Xol         , Urb         , Urb         , Urb         , Xol         , Xol         , Xol         , Xol         , Xol         , Xol         
Xol         , Xol         , Xol         , Xol         , Xol         , Xol         , Urb         , Urb         , Urb         , Urb         , Urb         , Urb         , Urb         , Urb         , Xol         , Xol         , Xol         , Xol         , Xol         , Xol         , Xol         , Xol         , Xol         , Xol         , Xol         , Xol         , Xol         , Xol         , Urb         , Urb         , Xol         , Xol         , Xol         , Xol         , Xol         , Xol         , Xol         , Xol         , Xol         , Xol         , Xol         , Xol         , Xol         , Xol         , Xol         , Urb         , Urb         , Urb         , Urb         , Xol         , Xol         , Xol         , Xol         
Xol         , Xol         , Xol         , Xol         , Xol         , Xol         , Urb         , Urb         , Urb         , Urb         , Urb         , Urb         , Xol         , Xol         , Xol         , Xol         , Xol         , Xol         , Xol         , Xol         , Xol         , Xol         , Xol         , Xol         , Xol         , Xol         , Urb         , Urb         , Urb         , Urb         , Urb         , Xol         , Xol         , Xol         , Xol         , Xol         , Xol         , Xol         , Xol         , Xol         , Xol         , Xol         , Xol         , Xol         , Urb         , Urb         , Urb         , Urb         , Urb         , Urb         , Xol         , Xol         , Xol         
Xol         , Xol         , Xol         , Xol         , Xol         , Urb         , Urb         , Urb         , Urb         , Urb         , Urb         , Urb         , Xol         , Xol         , Xol         , Xol         , Xol         , Xol         , Xol         , Xol         , Xol         , Xol         , Xol         , Xol         , Urb         , Urb         , Urb         , Urb         , Urb         , Urb         , Urb         , Xol         , Xol         , Xol         , Xol         , Xol         , Xol         , Xol         , Xol         , Xol         , Xol         , Xol         , Xol         , Xol         , Urb         , Urb         , Urb         , Urb         , Urb         , Urb         , Urb         , Xol         , Xol         
Xol         , Xol         , Xol         , Xol         , Urb         , Urb         , Urb         , Urb         , 1 Urb       , Urb         , Urb         , Urb         , Xol         , Xol         , Xol         , Xol         , Xol         , Xol         , Xol         , Xol         , Xol         , Xol         , Xol         , Xol         , Urb         , Urb         , Urb         , Urb         , Urb         , Urb         , Urb         , Urb         , Xol         , Xol         , Xol         , Xol         , Xol         , Xol         , Xol         , Xol         , Xol         , Xol         , Xol         , Xol         , Urb         , Urb         , Urb         , Urb         , Urb         , Urb         , Urb         , Urb         , Urb         
Xol         , Xol         , Xol         , Xol         , Urb         , Urb         , Urb         , Urb         , Urb         , Urb         , Urb         , Urb         , Xol         , Xol         , Xol         , Xol         , Xol         , Xol         , Xol         , Xol         , Xol         , Xol         , Xol         , Urb         , Urb         , Urb         , Urb         , Urb         , Urb         , Urb         , Urb         , Urb         , Xol         , Xol         , Xol         , Xol         , Xol         , Xol         , Xol         , Xol         , Xol         , Xol         , Xol         , Xol         , Urb         , Urb         , Urb         , Urb         , Urb         , Urb         , Urb         , Urb         , Urb         
Xol         , Xol         , Xol         , Xol         , Urb         , Urb         , Urb         , Urb         , Urb         , Urb         , Urb         , Urb         , Xol         , Xol         , Xol         , Xol         , Xol         , Xol         , Xol         , Xol         , Xol         , Xol         , Xol         , Urb         , Urb         , Urb         , Urb         , Urb         , Urb         , Urb         , Urb         , Urb         , Xol         , Xol         , Xol         , Xol         , Xol         , Xol         , Xol         , Xol         , Xol         , Xol         , Xol         , Xol         , Urb         , Urb         , Urb         , Urb         , Urb         , Urb         , Urb         , Urb         , Urb         
