border_size=1
usage=map

Xol         , Xol         , Xol         , Xol         , Xol         , Xol         , Xol         , Xol         , Xol         , Xol         , Xol         , Xol         , Xol         , Xol         , Xol         , Xol         , Xol         , Xol         , Xol         , Xol         , Xol         , Xol         , Xol         , Xol         , Xol         , Xol         , Xol         , Xol         , Xol         , Xol         , Xol         , Xol         , Xol         , Xol         , Xol         , Xol         , Xol         , Xol         , Xol         , Xol         , Xol         , Xol         , Xol         , Xol         , Xol         , Xol         , Xol         , Xol         , Xol         , Xol         , Xol         , Xol         , Xol         
Xol         , Xol         , Xol         , Xol         , Xol         , Xol         , Xol         , Xol         , Xol         , Xol         , Urb         , Xol         , Xol         , Xol         , Xol         , Xol         , Xol         , Xol         , Xol         , Xol         , Xol         , Xol         , Xol         , Xol         , Xol         , Xol         , Xol         , Xol         , Uh^Dr       , Xol         , Uh^Dr       , Xol         , Xol         , Xol         , Xol         , Xol         , Xol         , Xol         , Xol         , Xol         , Xol         , Xol         , Xol         , Xol         , Xol         , Xol         , Xol         , Xol         , Xol         , Xol         , Xol         , Xol         , Xol         
Xol         , Xol         , Xol         , Xol         , Xol         , Xol         , Xol         , Xol         , Urb         , Urb         , Urb         , Urb         , Urb^Vzps    , Urb         , Xol         , Xol         , Uh^Dr       , Xol         , Xol         , Xol         , Urb^Dr      , Xol         , Uu^Dr       , Uh^Dr       , Uu^Dr       , Xol         , Uu^Dr       , Uu^Dr       , Uu^Dr       , Uu^Dr       , Urb^Dr      , Uu^Dr       , Urb^Dr      , Xol         , Xol         , Xol         , Xol         , Xol         , Xol         , Xol         , Xol         , Xol         , Xol         , Xol         , Xol         , Xol         , Xol         , Xol         , Xol         , Xol         , Xol         , Xol         , Xol         
Xol         , Xol         , Xol         , Xol         , Xol         , Xol         , Urb         , Urb         , Urb         , Urb         , Cud         , Urb         , Urb         , Urb         , Urb^Dr      , Uu^Dr       , Urb^Dr      , Uu^Dr       , Urb^Dr      , Urb^Dr      , Urb         , Urb         , Urb^Dr      , Uu^Dr       , Urb^Dr      , Urb^Dr      , Urb^Dr      , Urb^Dr      , Urb         , Urb^Dr      , Urb         , Urb^Dr      , Urb         , Urb         , Urb         , Urb         , Urb         , Xol         , Urb^Dr      , Xol         , Xol         , Xol         , Xol         , Xol         , Xol         , Xol         , Xol         , Xol         , Xol         , Xol         , Xol         , Xol         , Xol         
Xol         , Xol         , Xol         , Xol         , Xol         , Xol         , Urb         , Urb^Vzps    , Urb         , Cud         , 2 Kud       , Cud         , Urb         , Urb         , Urb         , Urb^Dr      , Urb^Dr      , Urb^Dr      , Uh^Dr       , Urb         , Urb^Vzps    , Urb^Dr      , Urb^Dr      , Urb^Dr      , Uh^Dr       , Uu^Dr       , Uh^Dr       , Urb^Dr      , Urb         , Urb         , Urb         , Urb         , Urb^Vzps    , Urb         , Urb         , Urb         , Urb         , Urb         , Urb^Dr      , Uu^Dr       , Uh^Dr       , Xol         , Xol         , Xol         , Xol         , Xol         , Xol         , Xol         , Xol         , Xol         , Xol         , Xol         , Xol         
Xol         , Xol         , Xol         , Xol         , Xol         , Xol         , Urb         , Urb         , Urb         , Cud         , Cud         , Cud         , Urb         , Urb         , Urb         , Urb^Dr      , Qxua        , Uh^Dr       , Uh^Dr       , Urb^Dr      , Urb^Dr      , Urb         , Urb         , Uu^Dr       , Qxua        , Xol         , Uu^Dr       , Urb^Dr      , Urb         , Urb         , Urb         , Urb         , Urb         , Urb         , Urb         , Urb         , Urb^Vzps    , Urb         , Urb         , Uu^Dr       , Uu^Dr       , Xol         , Xol         , Xol         , Xol         , Xol         , Xol         , Xol         , Xol         , Xol         , Xol         , Xol         , Xol         
Xol         , Xol         , Xol         , Xol         , Xol         , Xol         , Xol         , Urb         , Urb         , Urb         , Urb         , Urb         , Urb         , Urb         , Urb^Vzps    , Qxua        , Urb^Dr      , Xol         , Uu^Dr       , Uu^Dr       , Uu^Dr       , Urb^Dr      , Qxua^Bs\    , Qxua        , Uu^Dr       , Uu^Dr       , Uu^Dr       , Urb^Dr      , Urb         , Urb         , Urb         , Urb         , Urb         , Urb         , Urb         , Urb         , Urb         , Urb         , Urb         , Urb^Dr      , Urb^Dr      , Xol         , Xol         , Xol         , Xol         , Xol         , Xol         , Xol         , Xol         , Xol         , Xol         , Xol         , Xol         
Xol         , Xol         , Xol         , Xol         , Xol         , Xol         , Xol         , Xol         , Urb         , Urb         , Urb^Vzps    , Urb         , Urb         , Urb         , Qxua        , Qxua^Bs\    , Urb^Dr      , Uu^Dr       , Urb^Dr      , Uu^Dr       , Urb^Dr      , Urb^Dr      , Qxua        , Urb         , Urb         , Urb^Dr      , Urb         , Urb         , Urb         , Urb^Vzps    , Urb         , Urb         , Uh^Dr       , Urb         , Urb^Dr      , Urb         , Urb         , Urb         , Urb         , Urb^Dr      , Uu^Dr       , Xol         , Xol         , Xol         , Xol         , Xol         , Xol         , Xol         , Xol         , Xol         , Xol         , Xol         , Xol         
Xol         , Xol         , Xol         , Xol         , Xol         , Xol         , Xol         , Xol         , Urb         , Urb         , Urb         , Urb         , Qxua        , Qxua^Bs\    , Urb         , Urb         , Urb         , Urb^Dr      , Urb         , Urb^Dr      , Qxua^Bs\    , Qxua        , Urb^Dr      , Urb         , Urb         , Urb         , Urb         , Urb         , Urb         , Urb         , Uu^Dr       , Uu^Dr       , Uh^Dr       , Uu^Dr       , Uh^Dr       , Urb^Dr      , Urb         , Urb         , Urb         , Urb^Dr      , Qxua        , Uh^Dr       , Xol         , Xol         , Xol         , Xol         , Xol         , Xol         , Xol         , Xol         , Xol         , Xol         , Xol         
Xol         , Xol         , Xol         , Xol         , Xol         , Xol         , Xol         , Xol         , Xol         , Urb         , Urb         , Urb         , Qxua        , Urb         , Urb         , Urb         , Urb^Vzps    , Urb         , Urb         , Urb         , Qxua        , Urb^Dr      , Urb^Dr      , Uu^Dr       , Uh^Dr       , Uu^Dr       , Uu^Dr       , Urb         , Urb         , Urb         , Urb^Dr      , Urb^Dr      , Uh^Dr       , Xol         , Uu^Dr       , Urb^Dr      , Urb         , Urb^Vzps    , Qxua        , Qxua        , Urb^Dr      , Uu^Dr       , Xol         , Xol         , Xol         , Xol         , Xol         , Xol         , Xol         , Xol         , Xol         , Xol         , Xol         
Xol         , Xol         , Xol         , Xol         , Xol         , Xol         , Xol         , Xol         , Xol         , Xol         , Urb         , Urb         , Qxua^Bs\    , Urb^Vzps    , Urb         , Urb         , Urb         , Urb         , Qxua        , Qxua        , Urb         , Urb^Dr      , Urb^Dr      , Uu^Dr       , Xol         , Uh^Dr       , Uu^Dr       , Urb^Dr      , Urb         , Urb         , Urb         , Urb^Dr      , Uu^Dr       , Uh^Dr       , Urb^Dr      , Urb         , Urb         , Urb         , Qxua^Bs\    , Urb         , Urb^Dr      , Uu^Dr       , Uh^Dr       , Xol         , Xol         , Xol         , Xol         , Xol         , Xol         , Xol         , Xol         , Xol         , Xol         
Xol         , Xol         , Xol         , Xol         , Xol         , Xol         , Xol         , Xol         , Xol         , Xol         , Xol         , Urb         , Qxua        , Urb         , Urb         , Urb         , Urb         , Qxua^Bs\    , Urb         , Urb^Vzps    , Urb         , Urb         , Urb^Dr      , Uu^Dr       , Uu^Dr       , Uu^Dr       , Uu^Dr       , Urb^Dr      , Urb         , Urb         , Urb         , Urb         , Urb         , Urb^Dr      , Urb         , Urb         , Qxua        , Qxua        , Urb         , Urb         , Urb         , Uu^Dr       , Uu^Dr       , Xol         , Xol         , Xol         , Xol         , Xol         , Xol         , Xol         , Xol         , Xol         , Xol         
Xol         , Xol         , Xol         , Xol         , Xol         , Xol         , Xol         , Xol         , Xol         , Xol         , Xol         , Xol         , Xol         , Qxua        , Qxua^Bs/    , Urb         , Qxua        , Qxua        , Urb         , Urb         , Urb         , Urb         , Urb         , Urb^Dr      , Urb^Dr      , Uu^Dr       , Urb         , Urb         , Urb         , Urb         , Urb         , Urb         , Urb         , Urb         , Urb^Vzps    , Urb         , Qxua^Bs\    , Urb         , Urb^Vzps    , Urb         , Urb         , Urb^Dr      , Xol         , Xol         , Xol         , Xol         , Xol         , Xol         , Xol         , Xol         , Xol         , Xol         , Xol         
Xol         , Xol         , Xol         , Xol         , Xol         , Xol         , Xol         , Xol         , Xol         , Xol         , Xol         , Xol         , Xol         , Urb^Vzps    , Urb         , Qxua        , Urb         , Urb         , Urb^Vzps    , Urb         , Urb         , Urb         , Urb         , Urb         , Urb         , Urb         , Urb         , Urb         , Urb         , Urb         , Urb         , Urb         , Urb         , Urb         , Qxua        , Qxua        , Urb         , Urb         , Urb         , Urb         , Urb         , Urb^Dr      , Xol         , Xol         , Xol         , Xol         , Xol         , Xol         , Xol         , Xol         , Xol         , Xol         , Xol         
Xol         , Xol         , Xol         , Xol         , Xol         , Xol         , Xol         , Xol         , Xol         , Xol         , Xol         , Xol         , Xol         , Xol         , Xol         , Qxua        , Qxua        , Urb         , Urb         , Urb         , Urb         , Urb         , Urb         , Urb^Vzps    , Urb         , Urb         , Urb         , Urb         , Urb         , Urb^Vzps    , Urb         , Urb         , Qxua        , Qxua^Bs\    , Urb^Dr      , Urb         , Urb^Dr      , Urb         , Urb         , Urb         , Urb         , Xol         , Xol         , Xol         , Xol         , Xol         , Xol         , Xol         , Xol         , Xol         , Xol         , Xol         , Xol         
Xol         , Xol         , Xol         , Xol         , Xol         , Xol         , Xol         , Xol         , Xol         , Xol         , Xol         , Xol         , Xol         , Xol         , Xol         , Urb         , Urb         , Qxua^Bs/    , Qxua        , Urb         , Urb         , Urb         , Uu^Dr       , Urb         , Urb         , Urb         , Urb         , Urb         , Urb         , Urb         , Urb         , Qxua        , Urb^Dr      , Urb^Dr      , Uu^Dr       , Uh^Dr       , Uh^Dr       , Urb         , Urb         , Urb         , Xol         , Xol         , Xol         , Xol         , Xol         , Xol         , Xol         , Xol         , Xol         , Xol         , Xol         , Xol         , Xol         
Xol         , Xol         , Xol         , Xol         , Xol         , Xol         , Xol         , Xol         , Xol         , Xol         , Xol         , Xol         , Xol         , Xol         , Xol         , Xol         , Urb^Vzps    , Urb         , Urb         , Qxua^Bs/    , Qxua        , Uu^Dr       , Uh^Dr       , Uu^Dr       , Urb^Dr      , Urb         , Urb         , Urb         , Urb         , Urb         , Qxua        , Qxua        , Urb^Dr      , Uu^Dr       , Uh^Dr       , Xol         , Uh^Dr       , Uu^Dr       , Urb         , Urb^Dr      , Uh^Dr       , Xol         , Xol         , Xol         , Xol         , Xol         , Xol         , Xol         , Xol         , Xol         , Xol         , Xol         , Xol         
Xol         , Xol         , Xol         , Xol         , Xol         , Xol         , Xol         , Xol         , Xol         , Xol         , Xol         , Xol         , Xol         , Xol         , Xol         , Xol         , Urb         , Urb         , Urb         , Urb         , Qxua        , Uh^Dr       , Xol         , Uh          , Urb^Dr      , Urb         , Urb^Vzps    , Urb         , Qxua        , Qxua^Bs\    , Urb         , Urb         , Urb         , Uu^Dr       , Uu^Dr       , Uh          , Uu^Dr       , Urb^Dr      , Urb         , Urb^Dr      , Uu^Dr       , Xol         , Xol         , Xol         , Xol         , Xol         , Xol         , Xol         , Xol         , Xol         , Xol         , Xol         , Xol         
Xol         , Xol         , Xol         , Xol         , Xol         , Xol         , Xol         , Xol         , Xol         , Xol         , Xol         , Xol         , Xol         , Xol         , Uh^Dr       , Urb^Dr      , Urb^Dr      , Urb         , Urb         , Urb^Dr      , Qxua        , Uu^Dr       , Uh^Dr       , Uh^Dr       , Uu^Dr       , Urb         , Qxua        , Qxua        , Urb         , Urb         , Urb^Vzps    , Urb         , Urb         , Urb         , Urb^Dr      , Uu^Dr       , Urb         , Urb         , Urb^Dr      , Urb^Dr      , Xol         , Xol         , Xol         , Xol         , Xol         , Xol         , Xol         , Xol         , Xol         , Xol         , Xol         , Xol         , Xol         
Xol         , Xol         , Xol         , Xol         , Xol         , Xol         , Xol         , Xol         , Xol         , Xol         , Xol         , Xol         , Xol         , Xol         , Uu^Dr       , Uu^Dr       , Urb^Dr      , Urb         , Urb         , Urb         , Urb         , Qxua        , Qxua^Bs/    , Uu^Dr       , Qxua        , Qxua^Bs\    , Urb         , Urb         , Cud         , Urb         , Urb         , Urb         , Urb         , Urb         , Urb^Vzps    , Urb         , Urb         , Urb         , Urb^Dr      , Uh^Dr       , Xol         , Xol         , Xol         , Xol         , Xol         , Xol         , Xol         , Xol         , Xol         , Xol         , Xol         , Xol         , Xol         
Xol         , Xol         , Xol         , Xol         , Xol         , Xol         , Xol         , Xol         , Xol         , Xol         , Xol         , Xol         , Xol         , Xol         , Urb^Dr      , Urb^Dr      , Urb         , Urb         , Urb^Vzps    , Urb         , Urb         , Urb         , Urb         , Qxua        , Qxua^Bs/    , Urb         , Urb         , Cud         , Kud         , Cud         , Cud         , Urb         , Urb         , Urb         , Urb         , Urb         , Urb         , Urb         , Urb         , Xol         , Xol         , Xol         , Xol         , Xol         , Xol         , Xol         , Xol         , Xol         , Xol         , Xol         , Xol         , Xol         , Xol         
Xol         , Xol         , Xol         , Xol         , Xol         , Xol         , Xol         , Xol         , Xol         , Xol         , Xol         , Xol         , Xol         , Xol         , Xol         , Urb^Dr      , Urb         , Urb         , Urb         , Urb         , Urb         , Urb         , Urb^Dr      , Urb^Dr      , Qxua        , Urb^Dr      , Urb^Dr      , Cud         , Cud         , Cud         , Urb         , Urb         , Urb^Dr      , Urb         , Urb         , Urb         , Urb         , Urb         , Urb         , Xol         , Xol         , Xol         , Xol         , Xol         , Xol         , Xol         , Xol         , Xol         , Xol         , Xol         , Xol         , Xol         , Xol         
Urb         , Urb         , Urb         , Urb         , Urb         , Xol         , Xol         , Xol         , Xol         , Xol         , Xol         , Xol         , Xol         , Xol         , Xol         , Urb         , Urb         , Urb         , Urb         , Urb         , Urb         , Urb^Dr      , Uh^Dr       , Uh^Dr       , Xol         , Uu^Dr       , Urb^Dr      , Urb         , Urb         , Urb         , Urb^Dr      , Urb^Dr      , Uu^Dr       , Urb^Dr      , Urb^Dr      , Urb^Dr      , Urb^Dr      , Urb         , Urb         , Urb         , Xol         , Xol         , Xol         , Xol         , Xol         , Xol         , Xol         , Xol         , Xol         , Xol         , Xol         , Xol         , Xol         
Urb         , Urb         , Urb         , Urb         , Urb         , Urb         , Xol         , Xol         , Xol         , Xol         , Xol         , Xol         , Xol         , Xol         , Xol         , Urb         , Urb         , Urb         , Urb         , Urb         , Urb         , Xol         , Xol         , Xol         , Xol         , Xol         , Xol         , Urb         , Urb         , Urb         , Xol         , Uh^Dr       , Xol         , Uh^Dr       , Xol         , Uu^Dr       , Xol         , Xol         , Urb         , Urb         , Xol         , Xol         , Xol         , Xol         , Xol         , Xol         , Xol         , Xol         , Xol         , Xol         , Xol         , Xol         , Xol         
Urb         , Urb         , Urb         , Urb         , Urb         , Urb         , Xol         , Xol         , Xol         , Xol         , Xol         , Xol         , Xol         , Xol         , Urb         , Urb         , Urb         , Xol         , Xol         , Urb         , Urb         , Xol         , Xol         , Xol         , Xol         , Xol         , Xol         , Xol         , Urb         , Urb         , Xol         , Xol         , Xol         , Xol         , Xol         , Xol         , Xol         , Xol         , Urb         , Urb         , Urb         , Xol         , Xol         , Xol         , Xol         , Xol         , Xol         , Xol         , Xol         , Xol         , Xol         , Xol         , Xol         
Urb         , Urb         , Urb         , Urb         , Urb         , Urb         , Urb         , Xol         , Xol         , Xol         , Xol         , Xol         , Urb         , Urb         , Urb         , Urb         , Xol         , Xol         , Xol         , Urb         , Urb         , Xol         , Xol         , Xol         , Xol         , Xol         , Xol         , Xol         , Urb         , Urb         , Xol         , Xol         , Xol         , Xol         , Xol         , Xol         , Xol         , Xol         , Xol         , Urb         , Urb         , Xol         , Xol         , Xol         , Xol         , Xol         , Xol         , Xol         , Xol         , Xol         , Xol         , Xol         , Xol         
Urb         , Urb         , Urb         , Urb         , Urb         , Urb         , Urb         , Urb         , Urb         , Xol         , Xol         , Urb         , Urb         , Urb         , Urb         , Xol         , Xol         , Xol         , Xol         , Urb         , Urb         , Xol         , Xol         , Xol         , Xol         , Xol         , Xol         , Xol         , Urb         , Urb         , Xol         , Xol         , Xol         , Xol         , Xol         , Xol         , Xol         , Xol         , Xol         , Urb         , Urb         , Urb         , Xol         , Xol         , Xol         , Xol         , Xol         , Xol         , Xol         , Xol         , Xol         , Xol         , Xol         
Urb         , Urb         , Urb         , Urb         , Xol         , Xol         , Xol         , Urb         , Urb         , Urb         , Urb         , Urb         , Urb         , Urb         , Xol         , Xol         , Xol         , Xol         , Urb         , Urb         , Urb         , Xol         , Xol         , Xol         , Xol         , Xol         , Xol         , Xol         , Urb         , Urb         , Xol         , Xol         , Xol         , Xol         , Xol         , Xol         , Xol         , Xol         , Xol         , Xol         , Urb         , Urb         , Urb         , Xol         , Xol         , Xol         , Xol         , Xol         , Xol         , Xol         , Xol         , Xol         , Xol         
Urb         , Urb         , Xol         , Xol         , Xol         , Xol         , Xol         , Xol         , Xol         , Urb         , Urb         , Urb         , Xol         , Xol         , Xol         , Xol         , Urb         , Urb         , Urb         , Urb         , Urb         , Xol         , Xol         , Xol         , Xol         , Xol         , Xol         , Xol         , Urb         , Urb         , Xol         , Xol         , Xol         , Xol         , Xol         , Xol         , Xol         , Xol         , Xol         , Xol         , Urb         , Urb         , Urb         , Urb         , Xol         , Xol         , Xol         , Xol         , Xol         , Xol         , Xol         , Xol         , Xol         
Xol         , Xol         , Xol         , Xol         , Xol         , Xol         , Xol         , Xol         , Xol         , Xol         , Xol         , Xol         , Xol         , Xol         , Xol         , Xol         , Urb         , Urb         , Urb         , Urb         , Xol         , Xol         , Xol         , Xol         , Xol         , Xol         , Xol         , Xol         , Urb         , Urb         , Xol         , Xol         , Xol         , Xol         , Xol         , Xol         , Xol         , Xol         , Xol         , Xol         , Xol         , Urb         , Urb         , Urb         , Urb         , Xol         , Xol         , Xol         , Xol         , Xol         , Xol         , Xol         , Xol         
Xol         , Xol         , Xol         , Xol         , Xol         , Xol         , Xol         , Xol         , Xol         , Xol         , Xol         , Xol         , Xol         , Xol         , Urb         , Urb         , Urb         , Urb         , Xol         , Xol         , Xol         , Xol         , Xol         , Xol         , Xol         , Xol         , Xol         , Xol         , Urb         , Urb         , Xol         , Xol         , Xol         , Xol         , Xol         , Xol         , Xol         , Xol         , Xol         , Xol         , Xol         , Xol         , Xol         , Urb         , Urb         , Urb         , Xol         , Xol         , Xol         , Xol         , Xol         , Xol         , Xol         
Xol         , Xol         , Xol         , Xol         , Xol         , Xol         , Xol         , Xol         , Urb         , Xol         , Xol         , Xol         , Urb         , Urb         , Urb         , Urb         , Xol         , Xol         , Xol         , Xol         , Xol         , Xol         , Xol         , Xol         , Xol         , Xol         , Xol         , Xol         , Urb         , Urb         , Xol         , Xol         , Xol         , Xol         , Xol         , Xol         , Xol         , Xol         , Xol         , Xol         , Xol         , Xol         , Xol         , Xol         , Urb         , Urb         , Urb         , Xol         , Xol         , Xol         , Xol         , Xol         , Xol         
Xol         , Xol         , Xol         , Xol         , Xol         , Xol         , Urb         , Urb         , Urb         , Urb         , Urb         , Urb         , Urb         , Urb         , Xol         , Xol         , Xol         , Xol         , Xol         , Xol         , Xol         , Xol         , Xol         , Xol         , Xol         , Xol         , Xol         , Xol         , Urb         , Urb         , Xol         , Xol         , Xol         , Xol         , Xol         , Xol         , Xol         , Xol         , Xol         , Xol         , Xol         , Xol         , Xol         , Xol         , Xol         , Urb         , Urb         , Urb         , Urb         , Xol         , Xol         , Xol         , Xol         
Xol         , Xol         , Xol         , Xol         , Xol         , Xol         , Urb         , Urb         , Urb         , Urb         , Urb         , Urb         , Xol         , Xol         , Xol         , Xol         , Xol         , Xol         , Xol         , Xol         , Xol         , Xol         , Xol         , Xol         , Xol         , Xol         , Urb         , Urb         , Urb         , Urb         , Urb         , Xol         , Xol         , Xol         , Xol         , Xol         , Xol         , Xol         , Xol         , Xol         , Xol         , Xol         , Xol         , Xol         , Urb         , Urb         , Urb         , Urb         , Urb         , Urb         , Xol         , Xol         , Xol         
Xol         , Xol         , Xol         , Xol         , Xol         , Urb         , Urb         , Urb         , Urb         , Urb         , Urb         , Urb         , Xol         , Xol         , Xol         , Xol         , Xol         , Xol         , Xol         , Xol         , Xol         , Xol         , Xol         , Xol         , Urb         , Urb         , Urb         , Urb         , Urb         , Urb         , Urb         , Xol         , Xol         , Xol         , Xol         , Xol         , Xol         , Xol         , Xol         , Xol         , Xol         , Xol         , Xol         , Xol         , Urb         , Urb         , Urb         , Urb         , Urb         , Urb         , Urb         , Xol         , Xol         
Xol         , Xol         , Xol         , Xol         , Urb         , Urb         , Urb         , Urb         , 1 Urb       , Urb         , Urb         , Urb         , Xol         , Xol         , Xol         , Xol         , Xol         , Xol         , Xol         , Xol         , Xol         , Xol         , Xol         , Xol         , Urb         , Urb         , Urb         , Urb         , Urb         , Urb         , Urb         , Urb         , Xol         , Xol         , Xol         , Xol         , Xol         , Xol         , Xol         , Xol         , Xol         , Xol         , Xol         , Xol         , Urb         , Urb         , Urb         , Urb         , Urb         , Urb         , Urb         , Urb         , Urb         
Xol         , Xol         , Xol         , Xol         , Urb         , Urb         , Urb         , Urb         , Urb         , Urb         , Urb         , Urb         , Xol         , Xol         , Xol         , Xol         , Xol         , Xol         , Xol         , Xol         , Xol         , Xol         , Xol         , Urb         , Urb         , Urb         , Urb         , Urb         , Urb         , Urb         , Urb         , Urb         , Xol         , Xol         , Xol         , Xol         , Xol         , Xol         , Xol         , Xol         , Xol         , Xol         , Xol         , Xol         , Urb         , Urb         , Urb         , Urb         , Urb         , Urb         , Urb         , Urb         , Urb         
Xol         , Xol         , Xol         , Xol         , Urb         , Urb         , Urb         , Urb         , Urb         , Urb         , Urb         , Urb         , Xol         , Xol         , Xol         , Xol         , Xol         , Xol         , Xol         , Xol         , Xol         , Xol         , Xol         , Urb         , Urb         , Urb         , Urb         , Urb         , Urb         , Urb         , Urb         , Urb         , Xol         , Xol         , Xol         , Xol         , Xol         , Xol         , Xol         , Xol         , Xol         , Xol         , Xol         , Xol         , Urb         , Urb         , Urb         , Urb         , Urb         , Urb         , Urb         , Urb         , Urb         
