border_size=1
usage=map

Xv          , Xv          , Xv          , Xv          , Xv          , Xv          , Xv          , Xv          , Ql          , Ql          , Ql          , Ql          , Ql          , Ql          , Ql          , Ql          , Ql          , Ql          , Ql          , Xv          , Xv          , Xv          , Xv          , Xv          , Xv          , Xv          , Ql          , Ql          , Ql          , Ql          , Ql          , Ql          , Ql          , Ql          , Ql          , Ql          , Ql          , Ql          , Ql          , Ql          , Xv          , Xv          , Xv          , Xv          , Xv          , Xv          , Xv          , Xv          , Xv          , Xv          , Xv          , Xv          , Xv          
Xv          , Xv          , Xv          , Xv          , Xv          , Xv          , Ql          , Ql          , Ql          , Ql          , Uu          , Ql          , Ql          , Ql          , Ql          , Ql          , Ql          , Ql          , Ql          , Xv          , Ql          , Ql          , Ql          , Ql          , Ql          , Ql          , Ql          , Ql          , Uh^Dr       , Ql          , Uh^Dr       , Ql          , Ql          , Ql          , Ql          , Ql          , Ql          , Ql          , Ql          , Ql          , Ql          , Xv          , Xv          , Xv          , Xv          , Xv          , Xv          , Xv          , Xv          , Xv          , Xv          , Xv          , Xv          
Xv          , Xv          , Xv          , Xv          , Xv          , Ql          , Ql          , Ql          , Uu          , Uu^Dr       , Zwsl        , Zwsl        , Zwsl^Vzps   , Uu          , Ql          , Ql          , Uh^Dr       , Ql          , Ql          , Ql          , Uu          , Ql          , Uu^Dr       , Uh^Dr       , Uu^Dr       , Ql          , Uu^Dr       , Uu^Dr       , Uu^Dr       , Uu^Dr       , Uu          , Uu^Dr       , Uu          , Ql          , Ql          , Ql          , Ql          , Ql          , Ql          , Ql          , Ql          , Ql          , Ql          , Xv          , Xv          , Xv          , Xv          , Xv          , Xv          , Xv          , Xv          , Xv          , Ql          
Xv          , Xv          , Xv          , Xv          , Ql          , Ql          , Uu          , Uu          , Zwsl        , Zwsl        , Cud         , Zwsl        , Zwsl        , Zwsl        , Uu          , Uu^Dr       , Uu          , Uu^Dr       , Uu          , Uu          , Zwsl        , Zwsl        , Uu          , Uu^Dr       , Uu          , Ql^Bs/      , Uu          , Uu          , Zwsl        , Uu          , Zwsl        , Uu          , Zwsl        , Zwsl        , Zwsl        , Zwsl        , Zwsl        , Ql          , Uu          , Ql          , Ql          , Ql          , Ql          , Ql          , Ql          , Xv          , Xv          , Xv          , Xv          , Xv          , Xv          , Ql          , Ql          
Xv          , Xv          , Ql          , Xv          , Ql          , Ql          , Uu^Dr       , Zwsl^Vzps   , Zwsl        , Cud         , 2 Kud       , Cud         , Zwsl        , Zwsl        , Zwsl        , Uu          , Uu          , Uu          , Uh^Dr       , Zwsl        , Zwsl^Vzps   , Uu          , Uu          , Uu          , Uh^Dr       , Ql^Bs\      , Uh^Dr       , Uu          , Zwsl        , Zwsl        , Zwsl        , Zwsl        , Zwsl^Vzps   , Zwsl        , Zwsl        , Zwsl        , Zwsl        , Zwsl        , Uu          , Uu^Dr       , Uh^Dr       , Ql          , Ql          , Ql          , Ql          , Ql          , Ql          , Ql          , Ql          , Xv          , Ql          , Ql          , Ql          
Xv          , Xv          , Ql          , Ql          , Ql          , Ql          , Uu^Dr       , Zwsl        , Zwsl        , Cud         , Cud         , Cud         , Zwsl        , Zwsl        , Zwsl        , Uu          , Ql          , Uh^Dr       , Uh^Dr       , Uu          , Uu          , Zwsl        , Zwsl        , Uu^Dr       , Ql          , Ql          , Uu^Dr       , Uu          , Zwsl        , Zwsl        , Zwsl        , Zwsl        , Zwsl        , Zwsl        , Zwsl        , Zwsl        , Zwsl^Vzps   , Zwsl        , Zwsl        , Uu^Dr       , Uu^Dr       , Ql          , Ql          , Ql          , Ql          , Ql          , Ql          , Ql          , Ql          , Ql          , Ql          , Ql          , Ql          
Ql          , Ql          , Ql          , Ql          , Ql          , Ql          , Ql          , Uu          , Uu          , Zwsl        , Zwsl        , Zwsl        , Zwsl        , Zwsl        , Zwsl^Vzps   , Ql          , Uu          , Ql          , Uu^Dr       , Uu^Dr       , Uu          , Uu          , Ql^Bs\      , Ql          , Uu^Dr       , Uu^Dr       , Uu^Dr       , Uu          , Zwsl        , Zwsl        , Zwsl        , Zwsl        , Zwsl        , Zwsl        , Zwsl        , Zwsl        , Zwsl        , Zwsl        , Zwsl        , Uu          , Uu          , Ql          , Ql          , Ql          , Ql          , Ql          , Ql          , Ql          , Ql          , Ql          , Ql          , Ql          , Ql          
Ql          , Ql          , Xv          , Xv          , Xv          , Ql          , Ql          , Ql          , Uu^Dr       , Uu          , Zwsl^Vzps   , Zwsl        , Zwsl        , Zwsl        , Ql          , Ql^Bs\      , Uu          , Uu          , Uu          , Uu          , Uu          , Uu          , Ql          , Zwsl        , Zwsl        , Zwsl^Dr     , Zwsl        , Zwsl        , Zwsl        , Zwsl^Vzps   , Zwsl        , Zwsl        , Uh^Dr       , Zwsl        , Uu          , Zwsl        , Zwsl        , Zwsl        , Zwsl        , Uu          , Uu^Dr       , Ql          , Ql          , Ql          , Ql          , Ql          , Ql          , Ql          , Xv          , Ql          , Ql          , Ql          , Ql          
Ql          , Ql          , Xv          , Xv          , Xv          , Xv          , Ql          , Ql          , Uu^Dr       , Uu          , Zwsl        , Zwsl        , Ql          , Ql^Bs\      , Zwsl        , Zwsl        , Zwsl        , Uu          , Zwsl        , Uu          , Ql^Bs\      , Ql          , Uu          , Zwsl        , Zwsl        , Zwsl        , Zwsl        , Zwsl        , Zwsl        , Zwsl        , Uu          , Uu          , Uh^Dr       , Uu^Dr       , Uh^Dr       , Uu          , Zwsl        , Zwsl        , Zwsl        , Uu          , Ql          , Ql^Bs\      , Uu          , Ql          , Ql          , Ql          , Ql          , Ql          , Xv          , Xv          , Xv          , Xv          , Ql          
Ql          , Ql          , Ql          , Xv          , Xv          , Xv          , Xv          , Ql          , Ql          , Uu          , Zwsl        , Zwsl        , Ql          , Zwsl        , Zwsl        , Zwsl        , Zwsl^Vzps   , Zwsl        , Zwsl        , Zwsl        , Ql          , Uu          , Uu          , Uu^Dr       , Uh^Dr       , Uu^Dr       , Uu^Dr       , Zwsl        , Zwsl        , Zwsl        , Uu          , Uu          , Uh^Dr       , Xv          , Uu^Dr       , Uu          , Zwsl        , Zwsl^Vzps   , Ql          , Ql          , Uu          , Uu          , Uu          , Ql          , Ql          , Ql          , Ql          , Ql          , Ql          , Xv          , Xv          , Xv          , Xv          
Ql          , Ql          , Ql          , Xv          , Xv          , Xv          , Ql          , Xv          , Ql          , Ql          , Uu          , Zwsl        , Ql^Bs\      , Zwsl^Vzps   , Zwsl        , Zwsl        , Zwsl        , Zwsl        , Ql          , Ql          , Zwsl        , Uu          , Uu          , Uu^Dr       , Xv          , Uh^Dr       , Uu^Dr       , Uu          , Zwsl        , Zwsl        , Zwsl        , Uu          , Uu^Dr       , Uh^Dr       , Uu          , Zwsl        , Zwsl        , Zwsl        , Ql^Bs\      , Zwsl        , Uu          , Uu          , Uh^Dr       , Ql          , Ql          , Ql          , Ql          , Ql          , Ql          , Xv          , Xv          , Xv          , Xv          
Ql          , Ql          , Ql          , Ql          , Ql          , Ql          , Ql          , Ql          , Ql          , Ql          , Ql          , Zwsl        , Ql          , Zwsl        , Zwsl        , Zwsl        , Zwsl        , Ql^Bs\      , Zwsl        , Zwsl^Vzps   , Zwsl        , Zwsl        , Uu          , Uu^Dr       , Uu^Dr       , Uu^Dr       , Uu^Dr       , Uu          , Zwsl        , Zwsl        , Zwsl        , Zwsl        , Zwsl        , Uu          , Zwsl        , Zwsl        , Ql          , Ql          , Zwsl        , Zwsl        , Zwsl        , Uu          , Uu          , Ql          , Ql          , Ql          , Ql          , Ql          , Ql          , Xv          , Xv          , Xv          , Ql          
Ql          , Ql          , Ql          , Ql          , Ql          , Ql          , Ql          , Ql          , Ql          , Ql          , Ql          , Ql          , Ql          , Ql          , Ql^Bs/      , Zwsl        , Ql          , Ql          , Zwsl        , Zwsl        , Zwsl        , Zwsl        , Zwsl        , Uu          , Uu          , Uu^Dr       , Zwsl        , Zwsl        , Zwsl        , Zwsl        , Zwsl        , Zwsl        , Zwsl        , Zwsl        , Zwsl^Vzps   , Zwsl        , Ql^Bs\      , Zwsl        , Zwsl^Vzps   , Zwsl        , Zwsl        , Uu          , Xv          , Ql          , Ql          , Ql          , Ql          , Ql          , Ql          , Xv          , Ql          , Ql          , Ql          
Ql          , Ql          , Ql          , Xv          , Xv          , Xv          , Xv          , Ql          , Ql          , Ql          , Ql          , Ql          , Xv          , Uu^Vzps     , Uu          , Ql          , Zwsl        , Zwsl        , Zwsl^Vzps   , Zwsl        , Zwsl        , Zwsl        , Zwsl        , Zwsl        , Zwsl        , Zwsl        , Zwsl        , Zwsl        , Zwsl        , Zwsl        , Zwsl        , Zwsl        , Zwsl        , Zwsl        , Ql          , Ql          , Zwsl        , Zwsl        , Zwsl        , Zwsl        , Uu          , Uu          , Xv          , Xv          , Ql          , Ql          , Ql          , Ql          , Ql          , Ql          , Ql          , Ql          , Ql          
Ql          , Ql          , Ql          , Xv          , Xv          , Xv          , Xv          , Ql          , Ql          , Ql          , Xv          , Ql          , Xv          , Xv          , Ql          , Ql          , Ql          , Zwsl        , Zwsl        , Zwsl        , Zwsl        , Zwsl        , Zwsl        , Zwsl^Vzps   , Zwsl        , Zwsl        , Zwsl        , Zwsl        , Zwsl        , Zwsl^Vzps   , Zwsl        , Zwsl        , Ql          , Ql^Bs\      , Uu          , Zwsl        , Uu          , Zwsl        , Zwsl        , Zwsl        , Uu          , Xv          , Xv          , Xv          , Ql          , Ql          , Ql          , Ql          , Ql          , Ql          , Xv          , Ql          , Ql          
Ql          , Ql          , Ql          , Xv          , Xv          , Xv          , Xv          , Ql          , Ql          , Ql          , Xv          , Xv          , Xv          , Xv          , Xv          , Uu          , Uu          , Ql^Bs/      , Ql          , Zwsl        , Zwsl        , Zwsl        , Uu^Dr       , Zwsl        , Zwsl        , Zwsl        , Zwsl        , Zwsl        , Zwsl        , Zwsl        , Zwsl        , Ql          , Uu          , Uu          , Uu          , Uh^Dr       , Uh^Dr       , Zwsl        , Zwsl        , Uu          , Xv          , Xv          , Xv          , Xv          , Ql          , Ql          , Xv          , Xv          , Xv          , Xv          , Xv          , Ql          , Ql          
Ql          , Ql          , Ql          , Ql          , Ql          , Ql          , Ql          , Ql          , Ql          , Ql          , Xv          , Xv          , Xv          , Xv          , Xv          , Xv          , Uu^Vzps     , Zwsl        , Zwsl        , Ql^Bs/      , Ql          , Uu^Dr       , Uh^Dr       , Uu^Dr       , Uu          , Zwsl        , Zwsl        , Zwsl        , Zwsl        , Zwsl        , Ql          , Ql          , Uu          , Uu          , Uh^Dr       , Xv          , Uh^Dr       , Uu^Dr       , Zwsl        , Uu          , Uh^Dr       , Ql          , Ql          , Ql          , Ql          , Ql          , Xv          , Xv          , Xv          , Xv          , Xv          , Ql          , Ql          
Xol         , Ql          , Ql          , Ql          , Ql          , Ql          , Ql          , Ql          , Ql          , Ql          , Ql          , Ql          , Ql          , Xv          , Xv          , Xv          , Uu          , Zwsl        , Zwsl        , Zwsl        , Ql          , Uh^Dr       , Xv          , Uh          , Uu          , Zwsl        , Zwsl^Vzps   , Zwsl        , Ql          , Ql^Bs\      , Zwsl        , Zwsl        , Zwsl        , Uu          , Uu          , Uh          , Uu          , Uu          , Zwsl        , Uu          , Uu^Dr       , Ql          , Ql          , Ql          , Ql          , Xv          , Xv          , Xv          , Xv          , Xv          , Ql          , Ql          , Ql          
Xol         , Xol         , Xol         , Xol         , Xol         , Ql          , Xol         , Ql          , Ql          , Ql          , Ql          , Ql          , Ql          , Ql          , Uh^Dr       , Uu          , Uu          , Zwsl        , Zwsl        , Uu          , Ql          , Uu^Dr       , Uh^Dr       , Uh^Dr       , Uu          , Zwsl        , Ql          , Ql          , Zwsl        , Zwsl        , Zwsl^Vzps   , Zwsl        , Zwsl        , Zwsl        , Uu          , Uu          , Zwsl        , Zwsl        , Uu          , Uu          , Ql          , Ql          , Ql          , Ql          , Ql          , Xv          , Xv          , Xv          , Ql          , Ql          , Ql          , Ql          , Ql          
Xol         , Xol         , Xol         , Xol         , Xol         , Xol         , Xol         , Xol         , Xol         , Ql          , Ql          , Ql          , Ql          , Ql          , Uu^Dr       , Uu^Dr       , Uu          , Zwsl        , Zwsl        , Zwsl        , Zwsl        , Ql          , Ql^Bs/      , Uu          , Ql          , Ql^Bs\      , Zwsl        , Zwsl        , Cud         , Zwsl        , Zwsl        , Zwsl        , Zwsl        , Zwsl        , Zwsl^Vzps   , Zwsl        , Zwsl        , Zwsl        , Uu          , Uh^Dr       , Ql          , Ql          , Ql          , Ql          , Ql          , Ql          , Ql          , Ql          , Ql          , Ql          , Ql          , Ql          , Ql          
Xol         , Xol         , Xol         , Xol         , Xol         , Xol         , Xol         , Xol         , Xol         , Xol         , Xol         , Ql          , Ql          , Ql          , Uu          , Uu          , Zwsl        , Zwsl        , Zwsl^Vzps   , Zwsl        , Zwsl        , Zwsl        , Zwsl        , Ql          , Ql^Bs/      , Zwsl        , Zwsl        , Cud         , Kud         , Cud         , Cud         , Zwsl        , Zwsl        , Zwsl        , Zwsl        , Zwsl        , Zwsl        , Zwsl        , Zwsl        , Ql          , Ql          , Ql          , Ql          , Ql          , Ql          , Ql          , Ql          , Ql          , Ql          , Ql          , Ql          , Ql          , Ql          
Xol         , Xol         , Xol         , Xol         , Xol         , Xol         , Xol         , Xol         , Xol         , Xol         , Xol         , Ql          , Ql          , Ql          , Ql          , Uu          , Zwsl        , Zwsl        , Zwsl        , Zwsl        , Zwsl        , Zwsl        , Uu          , Uu          , Ql          , Uu          , Uu          , Cud         , Cud         , Cud         , Zwsl        , Zwsl        , Zwsl        , Zwsl        , Zwsl        , Zwsl        , Zwsl        , Zwsl        , Zwsl        , Ql          , Ql          , Ql          , Ql          , Ql          , Xv          , Ql          , Ql          , Ql          , Ql          , Ql          , Ql          , Ql          , Ql          
Urb         , Urb         , Urb         , Urb         , Urb         , Xol         , Xol         , Xol         , Xol         , Xol         , Xol         , Xol         , Xol         , Ql          , Ql          , Zwsl        , Zwsl        , Zwsl        , Zwsl        , Zwsl        , Zwsl        , Uu          , Uh^Dr       , Uh^Dr       , Ql          , Uu^Dr       , Uu          , Zwsl        , Zwsl        , Zwsl        , Zwsl        , Zwsl        , Uu^Dr       , Zwsl        , Uu          , Zwsl        , Uu          , Uu          , Uu          , Zwsl        , Ql          , Ql          , Xv          , Xv          , Xv          , Xv          , Xv          , Xv          , Xol         , Ql          , Xol         , Ql          , Ql          
Urb         , Urb         , Urb         , Urb         , Urb         , Urb         , Xol         , Xol         , Xol         , Xol         , Xol         , Xol         , Xol         , Xol         , Ql          , Zwsl        , Zwsl        , Zwsl        , Zwsl        , Zwsl        , Zwsl        , Ql          , Ql          , Ql          , Ql          , Ql          , Ql          , Zwsl        , Zwsl        , Zwsl        , Ql          , Uh^Dr       , Uu^Dr       , Uh^Dr       , Xv          , Uu          , Xv          , Xv          , Uu          , Zwsl        , Xol         , Xv          , Xv          , Xv          , Xv          , Xv          , Xv          , Xol         , Xol         , Xol         , Xol         , Xol         , Xol         
Urb         , Urb         , Urb         , Urb         , Urb         , Urb         , Xol         , Xol         , Xol         , Xol         , Xol         , Xol         , Xol         , Xol         , Zwsl        , Zwsl        , Zwsl        , Ql          , Ql          , Zwsl        , Zwsl        , Ql          , Ql          , Ql          , Ql          , Ql          , Ql          , Ql          , Zwsl        , Zwsl        , Ql          , Ql          , Ql          , Xv          , Xv          , Xv          , Xv          , Xv          , Uu          , Urb         , Urb         , Xol         , Xol         , Xol         , Xol         , Xv          , Xol         , Xol         , Xol         , Xol         , Xol         , Xol         , Xol         
Urb         , Urb         , Urb         , Urb         , Urb         , Urb         , Urb         , Xol         , Xol         , Xol         , Xol         , Xol         , Urb         , Urb         , Urb         , Zwsl        , Ql          , Ql          , Ql          , Zwsl        , Urb         , Ql          , Ql          , Ql          , Ql          , Ql          , Ql          , Ql          , Urb         , Zwsl        , Ql          , Ql          , Ql          , Xv          , Xol         , Xv          , Xol         , Xv          , Xv          , Urb         , Urb         , Xol         , Xol         , Xol         , Xol         , Xol         , Xol         , Xol         , Xol         , Xol         , Xol         , Xol         , Xol         
Urb         , Urb         , Urb         , Urb         , Urb         , Urb         , Urb         , Urb         , Urb         , Xol         , Xol         , Urb         , Urb         , Urb         , Urb         , Xol         , Xol         , Ql          , Ql          , Urb         , Urb         , Ql          , Xol         , Xol         , Xol         , Xol         , Xol         , Xol         , Urb         , Urb         , Xol         , Xol         , Xol         , Xol         , Xol         , Xol         , Xol         , Xol         , Xol         , Urb         , Urb         , Urb         , Xol         , Xol         , Xol         , Xol         , Xol         , Xol         , Xol         , Xol         , Xol         , Xol         , Xol         
Urb         , Urb         , Urb         , Urb         , Xol         , Xol         , Xol         , Urb         , Urb         , Urb         , Urb         , Urb         , Urb         , Urb         , Xol         , Xol         , Xol         , Xol         , Urb         , Urb         , Urb         , Xol         , Xol         , Xol         , Xol         , Xol         , Xol         , Xol         , Urb         , Urb         , Xol         , Xol         , Xol         , Xol         , Xol         , Xol         , Xol         , Xol         , Xol         , Xol         , Urb         , Urb         , Urb         , Xol         , Xol         , Xol         , Xol         , Xol         , Xol         , Xol         , Xol         , Xol         , Xol         
Urb         , Urb         , Xol         , Xol         , Xol         , Xol         , Xol         , Xol         , Xol         , Urb         , Urb         , Urb         , Xol         , Xol         , Xol         , Xol         , Urb         , Urb         , Urb         , Urb         , Urb         , Xol         , Xol         , Xol         , Xol         , Xol         , Xol         , Xol         , Urb         , Urb         , Xol         , Xol         , Xol         , Xol         , Xol         , Xol         , Xol         , Xol         , Xol         , Xol         , Urb         , Urb         , Urb         , Urb         , Xol         , Xol         , Xol         , Xol         , Xol         , Xol         , Xol         , Xol         , Xol         
Xol         , Xol         , Xol         , Xol         , Xol         , Xol         , Xol         , Xol         , Xol         , Xol         , Xol         , Xol         , Xol         , Xol         , Xol         , Xol         , Urb         , Urb         , Urb         , Urb         , Xol         , Xol         , Xol         , Xol         , Xol         , Xol         , Xol         , Xol         , Urb         , Urb         , Xol         , Xol         , Xol         , Xol         , Xol         , Xol         , Xol         , Xol         , Xol         , Xol         , Xol         , Urb         , Urb         , Urb         , Urb         , Xol         , Xol         , Xol         , Xol         , Xol         , Xol         , Xol         , Xol         
Xol         , Xol         , Xol         , Xol         , Xol         , Xol         , Xol         , Xol         , Xol         , Xol         , Xol         , Xol         , Xol         , Xol         , Urb         , Urb         , Urb         , Urb         , Xol         , Xol         , Xol         , Xol         , Xol         , Xol         , Xol         , Xol         , Xol         , Xol         , Urb         , Urb         , Xol         , Xol         , Xol         , Xol         , Xol         , Xol         , Xol         , Xol         , Xol         , Xol         , Xol         , Xol         , Xol         , Urb         , Urb         , Urb         , Xol         , Xol         , Xol         , Xol         , Xol         , Xol         , Xol         
Xol         , Xol         , Xol         , Xol         , Xol         , Xol         , Xol         , Xol         , Urb         , Xol         , Xol         , Xol         , Urb         , Urb         , Urb         , Urb         , Xol         , Xol         , Xol         , Xol         , Xol         , Xol         , Xol         , Xol         , Xol         , Xol         , Xol         , Xol         , Urb         , Urb         , Xol         , Xol         , Xol         , Xol         , Xol         , Xol         , Xol         , Xol         , Xol         , Xol         , Xol         , Xol         , Xol         , Xol         , Urb         , Urb         , Urb         , Xol         , Xol         , Xol         , Xol         , Xol         , Xol         
Xol         , Xol         , Xol         , Xol         , Xol         , Xol         , Urb         , Urb         , Urb         , Urb         , Urb         , Urb         , Urb         , Urb         , Xol         , Xol         , Xol         , Xol         , Xol         , Xol         , Xol         , Xol         , Xol         , Xol         , Xol         , Xol         , Xol         , Xol         , Urb         , Urb         , Xol         , Xol         , Xol         , Xol         , Xol         , Xol         , Xol         , Xol         , Xol         , Xol         , Xol         , Xol         , Xol         , Xol         , Xol         , Urb         , Urb         , Urb         , Urb         , Xol         , Xol         , Xol         , Xol         
Xol         , Xol         , Xol         , Xol         , Xol         , Xol         , Urb         , Urb         , Urb         , Urb         , Urb         , Urb         , Xol         , Xol         , Xol         , Xol         , Xol         , Xol         , Xol         , Xol         , Xol         , Xol         , Xol         , Xol         , Xol         , Xol         , Urb         , Urb         , Urb         , Urb         , Urb         , Xol         , Xol         , Xol         , Xol         , Xol         , Xol         , Xol         , Xol         , Xol         , Xol         , Xol         , Xol         , Xol         , Urb         , Urb         , Urb         , Urb         , Urb         , Urb         , Xol         , Xol         , Xol         
Xol         , Xol         , Xol         , Xol         , Xol         , Urb         , Urb         , Urb         , Urb         , Urb         , Urb         , Urb         , Xol         , Xol         , Xol         , Xol         , Xol         , Xol         , Xol         , Xol         , Xol         , Xol         , Xol         , Xol         , Urb         , Urb         , Urb         , Urb         , Urb         , Urb         , Urb         , Xol         , Xol         , Xol         , Xol         , Xol         , Xol         , Xol         , Xol         , Xol         , Xol         , Xol         , Xol         , Xol         , Urb         , Urb         , Urb         , Urb         , Urb         , Urb         , Urb         , Xol         , Xol         
Xol         , Xol         , Xol         , Xol         , Urb         , Urb         , Urb         , Urb         , 1 Urb       , Urb         , Urb         , Urb         , Xol         , Xol         , Xol         , Xol         , Xol         , Xol         , Xol         , Xol         , Xol         , Xol         , Xol         , Xol         , Urb         , Urb         , Urb         , Urb         , Urb         , Urb         , Urb         , Urb         , Xol         , Xol         , Xol         , Xol         , Xol         , Xol         , Xol         , Xol         , Xol         , Xol         , Xol         , Xol         , Urb         , Urb         , Urb         , Urb         , Urb         , Urb         , Urb         , Urb         , Urb         
Xol         , Xol         , Xol         , Xol         , Urb         , Urb         , Urb         , Urb         , Urb         , Urb         , Urb         , Urb         , Xol         , Xol         , Xol         , Xol         , Xol         , Xol         , Xol         , Xol         , Xol         , Xol         , Xol         , Urb         , Urb         , Urb         , Urb         , Urb         , Urb         , Urb         , Urb         , Urb         , Xol         , Xol         , Xol         , Xol         , Xol         , Xol         , Xol         , Xol         , Xol         , Xol         , Xol         , Xol         , Urb         , Urb         , Urb         , Urb         , Urb         , Urb         , Urb         , Urb         , Urb         
Xol         , Xol         , Xol         , Xol         , Urb         , Urb         , Urb         , Urb         , Urb         , Urb         , Urb         , Urb         , Xol         , Xol         , Xol         , Xol         , Xol         , Xol         , Xol         , Xol         , Xol         , Xol         , Xol         , Urb         , Urb         , Urb         , Urb         , Urb         , Urb         , Urb         , Urb         , Urb         , Xol         , Xol         , Xol         , Xol         , Xol         , Xol         , Xol         , Xol         , Xol         , Xol         , Xol         , Xol         , Urb         , Urb         , Urb         , Urb         , Urb         , Urb         , Urb         , Urb         , Urb         
