border_size=1
usage=map

Ww, Mm^Xm, Mm^Xm, Mm^Xm, Mm^Xm, Mm, Hh, Mm, Mm, Mm, Mm^Fds, Mm^Fds, Mm, Gg, Gll^Fds, Gg, Gll^Fds, Gll^Fds, Gll^Fds, Gll^Fds, Gg^Fds, Gg^Fds, Ww, Gg^Fds, Gll^Fds, Gll^Fds, Gll^Fds, Gll^Fds, Gll^Fms, Gll^Fds, Gll^Fds, Gll^Fds, Gll^Fds, Gll^Fds, Gll^Fds, Gll^Fds, Gll^Fds, Gll^Fds, Gll^Fds, Gll^Fds, Gll^Fds, Gll^Fds, Gll^Fds, Gll^Fds, Gll^Fds, Gll^Fds
Mm^Xm, Ww, Ww, Mm^Xm, Mm, Hh, Mm^Fds, Mm, Mm, Mm, Mm, Mm, Gll^Fds, Gll^Fds, Gll^Fds, Gll^Fds, Gll^Fds, Gll^Fds, Gll^Fds, Gll^Fds, Gg^Fds, Ww, Gg^Fds, Gg^Fds, Gll^Fds, Gll^Fds, Gg, Gll^Fms, Gll^Fds, Gll^Fms, Gll^Fds, Gg, Gg^Es, Gll^Fms, Gll^Fms, Gll^Fds, Gll^Fms, Gll^Fds, Gll^Fds, Gll^Fds, Gll^Fms, Gll^Fms, Gll^Fds, Gll^Fds, Gll^Fms, Gll^Fds
Mm^Xm, Mm^Xm, Ww, Mm, Hh^Fds, Hh, Hh, Mm, Mm^Fds, Mm, Gll^Fds, Gll^Fds, Gll^Fds, Gll^Fds, Gll^Fds, Gg^Ve, Gll^Fds, Gll^Fds, Gll^Fds, Gg^Fds, Ww, Ww, Gg^Fds, Gll^Fds, Gg^Ve, Gll^Fms, Gll^Fds, Gll^Fms, Gll^Fms, Gll^Fms, Gll^Fms, Gll^Fms, Gg^Efm, Gll^Fms, Gll^Fds, Gll^Fms, Gll^Fms, Gll^Fms, Gll^Fms, Gll^Fms, Gll^Fds, Gll^Fds, Gll^Fms, Gll^Fms, Gll^Fms, Gll^Fds
Mm, Mm^Fds, Hh^Fds, Ww, Ww, Ww, Ww^Edt, Gg, Gg, Gll^Fds, Gg, Gll^Fds, Gg, Gll^Fds, Gg, Gll^Fds, Gg^Fds, Gg^Fds, Gg^Fds, Gg^Fds, Ww, Gg^Fds, Gll^Fds, Gll^Fds, Gll^Fds, Gll^Fds, Gll^Fds, Gll^Fds, Gll^Fds, Gll^Fms, Gll^Fms, Gll^Fms, Gll^Fms, Gll^Fds, Gll^Fms, Gll^Fds, Gll^Fds, Gll^Fms, Gll^Fms, Gll^Fds, Gll^Fds, Gll^Fms, Gll^Fds, Gll^Fms, Gll^Fms, Gll^Fds
Mm, Mm, Gll^Fds, Ww, Ww, Ww^Edt, 1 Ww^Edt, Ww^Edt, Ww^Edt, Gg^Efm, Gg, Gg^Es, Gg, Gg, Gg, Gg^Fds, Ww, Ww, Ww, Ww, Gg^Fds, Gg^Fds, Gg, Gll^Fds, Gll, Gll^Fds, Gs^Fds, Gll^Fms, Gll^Fms, Gg^Fet, Gll^Fms, Gll^Fds, Gg^Ve, Gll^Fms, Gll^Fds, Gll^Fms, Gll^Fms, Gll^Fds, Gll^Fds, Gll^Fms, Gll^Fms, Gll^Fms, Gll^Fds, Gll^Fms, Gll^Fms, Gll^Fds
Mm, Hh^Fds, Gll^Fds, Ww, Ww, Ww^Edt, Ww^Edt, Ww^Edt, Ww^Edt, Gg^Em, Gg, Gg, Ww^Edt, Gg, Ww, Ww, Gg, Gg^Efm, Gg^Fds, Gg^Fds, Gll^Fds, Gg, Gg, Gg^Efm, Gll^Fds, Gll^Fds, Gll^Fds, Gll^Fms, Gll^Fms, Gll^Fms, Gll^Fms, Gll^Fds, Gll^Fds, Gll^Fms, Gll^Fms, Gll^Fms, Gll^Fds, Gll^Fds, Gll^Fds, Gll^Fms, Gll^Fms, Gll^Fms, Gll^Fds, Gll^Fms, Gll^Fms, Gll^Fds
Hh^Fds, Hh^Fds, Gg^Ve, Gll^Fds, Gg^Efm, Ww, Ww, Ww, Gg, Ww^Edt, Ww, Ww, Gg, Ww, Gg, Gg, Gll^Fds, Gll^Fds, Gll^Fds, Gll^Fds, Gg^Ve, Gll^Fds, Gll^Fds, Gll^Fds, Gll^Fds, Gll^Fds, Gll^Fds, Gll^Fms, Gg, Gll^Fms, Gg, Gll^Fms, Gll^Fms, Gll^Fds, Gll^Fds, Gll^Fds, Gll^Fds, Gll^Fds, Gll^Fms, Gll^Fds, Gll^Fds, Gg^Ve, Gll^Fds, Gll^Fds, Gll^Fms, Gll^Fms
Hh^Fds, Gll^Fds, Gll^Fds, Gll^Fds, Gg, Gg^Em, Gg, Gg^Efm, Gg, Gg, Gg, Gg, Gg, Gg^Es, Gg, Gll^Fds, Gll^Fds, Gll^Fds, Gll^Fds, Gll^Fds, Gll^Fds, Gll^Fds, Gll^Fds, Gll^Fds, Gll^Fds, Gll^Fms, Gll^Fms, Gg, Gg^Es, Gg^Efm, Gs^Fms, Gll^Fds, Gs^Fds, Gll^Fms, Gs^Fds, Gll^Fds, Gs^Fms, Gll^Fms, Gs^Fds, Gll^Fds, Gs^Fds, Gll^Fds, Gll^Fms, Gll^Fms, Gs^Fms, Gll^Fds
Gll^Fds, Gll^Fds, Gll^Fds, Gg^Efm, Gll^Fds, Gg, Gll^Fds, Gll^Fds, Gll^Fds, Gll^Fds, Gll^Fds, Gg, Gll^Fds, Gg, Gll^Fds, Gll^Fds, Gll^Fds, Gll^Fds, Gll^Fds, Gll^Fms, Gg, Gg, Gll^Fms, Gll^Fms, Gll^Fms, Gll^Fms, Gll^Fms, Gg, Gll^Fms, Gll^Fms, Gs^Fds, Gs^Fds, Gs^Fds, Gs^Fms, Gs^Fms, Gs^Fms, Gs^Fms, Gs^Fms, Gs^Fds, Gs^Fds, Gs^Fms, Gs^Fms, Gs^Fms, Gs^Fms, Gs^Fms, Gs^Fmw
Gll^Fds, Gll^Fds, Gll^Fds, Gll^Fds, Gll^Fds, Gll^Fds, Gll^Fds, Gll^Fds, Gll^Fds, Gg, Gll^Fds, Gg, Gll^Fds, Gll^Fds, Gg^Em, Gg, Gll^Fms, Gll^Fms, Gll^Fms, Gg, Gg^Efm, Gll^Fms, Gll^Fds, Gll^Fms, Gg^Fet, Gll^Fms, Gll^Fds, Gs^Fms, Gll^Fms, Gll^Fms, Gs^Fds, Gg^Ve, Gs^Fms, Gs^Fds, Gs^Fms, Gs^Fms, Gs^Fms, Gg^Fet, Gs^Fds, Gs^Fms, Gs^Fms, Gs^Fms, Gg^Ve, Gs^Fds, Gs^Fms, Gs^Fmw
Gll^Fds, Gll^Fds, Gll^Fds, Gll^Fds, Gll^Fds, Gll^Fds, Gg, Gll^Fds, Gg^Ve, Gll^Fds, Gll^Fds, Gg, Gll^Fds, Gg, Gll^Fds, Gll^Fds, Gll^Fms, Gll^Fds, Gll^Fds, Gll^Fms, Gll^Fms, Gll^Fms, Gll^Fms, Gll^Fms, Gll^Fds, Gll^Fds, Gll^Fds, Gll^Fms, Gll^Fms, Gll^Fds, Gs^Fms, Gs^Fds, Gs^Fms, Gs^Fms, Gs^Fds, Gs^Fds, Gs^Fds, Gs^Fds, Gs^Fds, Gg^Fet, Gs^Fds, Gs^Fds, Gs^Fms, Gs^Fms, Gs^Fms, Gs^Fmw
Gll^Fds, Gll^Fds, Gg, Gll^Fds, Gll^Fds, Gg^Es, Gll^Fds, Gll^Fds, Gg, Gg, Gg, Gll^Fds, Gll^Fds, Gll^Fds, Gll^Fds, Gll^Fds, Gll^Fds, Gll^Fms, Gg^Efm, Gg, Gll^Fms, Gll^Fms, Gll^Fds, Gg^Ve, Gll^Fds, Gll^Fds, Gll^Fds, Gll^Fms, Gll^Fms, Gs^Fms, Gs^Fms, Gs^Fds, Gs^Fds, Gs^Fms, Gs^Fms, Gs^Fds, Gg^Fet, Gs^Fds, Gs^Fds, Gs^Fds, Gs^Fms, Gs^Fms, Gs^Fds, Gs^Fms, Gs^Fms, Gs^Fmw
Gll^Fds, Gg, Gg, Gll^Fds, Gll^Fds, Gll^Fds, Gll^Fds, Gg, Gll^Fds, Gg^Es, Gg, Gll^Fds, Gll^Fds, Gll^Fds, Gll^Fds, Gll^Fms, Gll^Fms, Gg, Gg, Gll^Fms, Gll^Fds, Gll^Fms, Gll^Fds, Gll^Fds, Gll^Fds, Gll^Fds, Gll^Fds, Gll^Fms, Gll^Fms, Gg^Fet, Gs^Fds, Gs^Fms, Gs^Fms, Gs^Fms, Cv, Cv, Cv, Gg^Ve, Gs^Fds, Gs^Fms, Gs^Fms, Gs^Fms, Gg^Ve, Gs^Fms, Gs^Fds, Gs^Fmw
Gg, Gll^Fds, Gll^Fds, Gll^Fds, Gg^Em, Gg, Gg, Gll^Fds, Gll^Fds, Gg, Gll^Fds, Gll^Fds, Gll^Fds, Gll^Fds, Gll^Fds, Gll^Fds, Gll^Fds, Gg, Gll^Fds, Gll^Fds, Gll^Fds, Gll^Fds, Gll^Fds, Gll^Fds, Gg^Ve, Gll^Fds, Gll^Fds, Gll^Fms, Gll^Fms, Gll^Fds, Gs^Fms, Gs^Fds, Gs^Fms, Gg^Fet, Gs^Fds, Gg^Ve, Gs^Fms, Gs^Fds, Gs^Fds, Gs^Fms, Gs^Fms, Gs^Fms, Gs^Fms, Gs^Fms, Gs^Fmw, Gs^Fmw
Gll^Fds, Gll^Fds, Gll^Fds, Gg, Gg, Gg, Gll^Fds, Gll^Fds, Gll^Fds, Gll^Fds, Gll^Fds, Gll^Fds, Gll^Fds, Gll^Fms, Gll^Fms, Gll^Fms, Gll^Fms, Gll^Fds, Gll^Fds, Gll^Fds, Gll^Fds, Gll^Fds, Gll^Fds, Gll^Fds, Gll^Fms, Gll^Fds, Gll^Fms, Gs^Fms, Gll^Fms, Gll^Fms, Gs^Fms, Gs^Fms, Gs^Fms, Gs^Fds, Gs^Fds, Gs^Fms, Gs^Fms, Gs^Fds, Gs^Fms, Gs^Fms, Gs^Fds, Gs^Fms, Gs^Fms, Gs^Fms, Gs^Fmw, Gs^Fmw
Gg, Gg^Es, Gll^Fds, Gll^Fds, Gll^Fds, Gll^Fds, Gll^Fds, Gll^Fds, Gll^Fds, Gll^Fds, Gll^Fds, Gll^Fds, Gll^Fms, Gll^Fms, Gll^Fms, Gg^Fet, Gll^Fms, Gll^Fms, Gll^Fds, Gll^Fds, Gll^Fms, Gll^Fds, Gg^Fet, Gg, Gg^Em, Gll^Fms, Gll^Fds, Gll^Fms, Gll^Fms, Gs^Fms, Gs^Fms, Gs^Fms, Gg^Fet, Gs^Fms, Gs^Fms, Gs^Fds, Gs^Fds, Gs^Fms, Gs^Fms, Gs^Fds, Gs^Fms, Gg^Ve, Gs^Fds, Gs^Fms, Gs^Fds, Gs^Fmw
Gll^Fds, Gll^Fds, Gg^Ve, Gll^Fds, Gll^Fds, Gll^Fds, Gg, Gg, Gll^Fds, Gll^Fds, Gll^Fms, Gll^Fms, Gll^Fds, Gll^Fds, Gll^Fds, Gll^Fds, Gll^Fms, Gg^Ve, Gll^Fms, Gll^Fms, Gll^Fds, Gll^Fms, Gll^Fds, Gg^Efm, Gll^Fms, Gll^Fms, Gll^Fds, Gs^Fds, Gll^Fms, Gs^Fms, Gs^Fms, Gs^Fms, Gs^Fms, Gs^Fms, Gs^Fms, Gs^Fds, Gs^Fds, Gs^Fms, Gg^Fet, Gs^Fms, Gs^Fms, Gs^Fds, Gs^Fds, Gs^Fds, Gs^Fds, Gs^Fds
Gll^Fds, Gll^Fds, Gll^Fds, Gll^Fds, Gll^Fms, Gll^Fms, Gll^Fds, Gg, Gll^Fms, Gg^Ve, Gg, Gll^Fms, Gll^Fds, Gll^Fds, Gll^Fds, Gll^Fds, Gll^Fds, Gll^Fms, Gll^Fds, Gll^Fms, Gll^Fms, Gll^Fms, Gll^Fds, Gll^Fds, Gll^Fms, Gll^Fms, Gll^Fds, Gs^Fds, Gll^Fms, Gs^Fms, Gs^Fds, Gg^Ve, Gs^Fms, Gs^Fms, Gs^Fms, Gs^Fds, Gg^Ve, Gs^Fds, Gs^Fds, Gs^Fms, Gs^Fms, Gs^Fms, Gs^Fms, Gs^Fds, Ww, Ww
Gll^Fds, Gll^Fms, Gll^Fds, Gll^Fds, Gll^Fds, Gll^Fms, Gll^Fds, Gll^Fms, Gll^Fms, Gll^Fds, Gg, Gll^Fms, Gg^Efm, Gll^Fds, Gll^Fms, Gll^Fms, Gll^Fds, Gg, Gg^Es, Gg, Gll^Fms, Gll^Fds, Gll^Fds, Gll^Fms, Gll^Fms, Gll^Fds, Gll^Fds, Gg^Fet, Gs^Fds, Gs^Fms, Gs^Fms, Gs^Fms, Gs^Fds, Gs^Fms, Gs^Fds, Gs^Fms, Gs^Fms, Gs^Fds, Gs^Fms, Gs^Fms, Ww, Ww, Ww, Ww, Gs^Fds, Gs^Fds
Gll^Fds, Gll^Fms, Gll^Fms, Gg^Fet, Gll^Fms, Gll^Fds, Gll^Fds, Gll^Fds, Gll^Fds, Gg, Gg^Em, Gg, Gll^Fms, Gll^Fms, Gll^Fds, Gll^Fds, Gll^Fds, Gg, Gll^Fds, Gg^Efm, Gll^Fds, Gll^Fds, Gll^Fds, Gll^Fms, Gg, Gg, Gg, Gs^Fds, Gs^Fds, Gs^Fds, Gs^Fds, Gg^Ve, Gs^Fds, Gs^Fds, Gs^Fds, Gs^Fds, Gs^Fds, Gs^Fds, Ww, Ww, Ww, Ww, Gs^Fds, Gs^Fds, Gs^Fds, Gs^Fds
Gll^Fms, Gll^Fms, Gll^Fds, Gll^Fms, Gll^Fds, Gll^Fds, Gll^Fds, Gll^Fds, Gll^Fds, Gll^Fds, Gll^Fds, Gll^Fms, Gll^Fds, Gll^Fds, Gll^Fds, Gll^Fds, Gll^Fds, Gll^Fds, Gll^Fds, Gll^Fds, Gll^Fds, Gll^Fds, Gll^Fds, Gll^Fds, Gll^Fms, Gg^Em, Gg^Efm, Gs^Fms, Gs^Fms, Gs^Fds, Gs^Fds, Gs^Fds, Gs^Fds, Gs^Fds, Ww, Ww, Ww, Ww^Bw\, Gs^Fp, Ww, Gs^Fp, Gs^Fds, Gs^Fds, Gs^Fds, Gs^Fds, Gs^Fds
Gll^Fds, Gll^Fds, Gg^Ve, Gll^Fms, Gll^Fms, Gll^Fds, Gg, Gg^Em, Gll^Fms, Gll^Fds, Gll^Fms, Gll^Fds, Gll^Fms, Gll^Fds, Gll^Fds, Gg^Fet, Gll^Fms, Gll^Fds, Gll^Fds, Gll^Fds, Gll^Fms, Gll^Fms, Gll^Fms, Gll^Fms, Gll^Fds, Gll^Fds, Gll^Fds, Gs^Fms, Gs^Fms, Gs^Fms, Gs^Fds, Gs^Fds, Ww, Ww, Ww, Ww, Gs^Fms, Gs^Fp, Gs^Fp, Gll^Fp, Gs^Fp, Gs^Fds, Gs^Fds, Gs^Fds, Gs^Fds, Gs^Fds
Gll^Fds, Gll^Fds, Gll^Fds, Gll^Fms, Gll^Fms, Gll^Fds, Gll^Fds, Gg, Gll^Fds, Gll^Fms, Gll^Fms, Gll^Fms, Gll^Fds, Gll^Fds, Gll^Fds, Gll^Fds, Gll^Fds, Gll^Fds, Gll^Fds, Gll^Fds, Gll^Fds, Gg^Fet, Gll^Fms, Gll^Fms, Gll^Fms, Gll^Fds, Gll^Fds, Gs^Fms, Gs^Fms, Gg^Fet, Gs^Fds, Gs^Fds, Ww, Ww, Gs^Fms, Gs^Fms, Gs^Fms, Gs^Fp, Gll^Fp, Gll^Fp, Gs^Fp, Gs^Fp, Gs^Fds, Gs^Fds, Gs^Fds, Gs^Fds
Gll^Fds, Gll^Fds, Gll^Fds, Gll^Fds, Gll^Fds, Gll^Fds, Gll^Fds, Gll^Fds, Gll^Fms, Gll^Fds, Gll^Fms, Gll^Fms, Gll^Fds, Gll^Fms, Gll^Fms, Gll^Fms, Gll^Fms, Gll^Fds, Gll^Fds, Gll^Fds, Gll^Fds, Gll^Fds, Gll^Fds, Gll^Fms, Gll^Fms, Gll^Fms, Gll^Fds, Gs^Fms, Gg^Ve, Gs^Fms, Gs^Fms, Ww, Ww, Ww, Gs^Fms, Gs^Fms, Gs^Fms, Gll^Fp, Gs^Fp, Gs^Fp, Gs^Fp, Gs^Fp, Gs^Fds, Gs^Fds, Gs^Fds, Gs^Fds
Gg, Gll^Fds, Gll^Fds, Gll^Fds, Gll^Fds, Gll^Fds, Gll^Fds, Gll^Fds, Gll^Fms, Gll^Fds, Gll^Fds, Gll^Fds, Gll^Fds, Gg^Ve, Gll^Fms, Gll^Fms, Gll^Fms, Gg, Gg^Em, Gll^Fds, Gll^Fds, Gll^Fms, Gll^Fms, Gg^Ve, Gll^Fms, Gg^Efm, Gg, Gs^Fms, Gs^Fp, Gs^Fms, Gs^Fms, Gs^Fds, Ww, Ww, Gs^Fms, Gs^Fms, Gs^Fms, Gs^Fp, Gg^Ve, Gs^Fp, Gg^Fet, Gs^Fp, Gs^Fds, Gs^Fds, Gs^Fds, Gs^Fds
Gg^Es, Gg, Gll^Fds, Gll^Fds, Gll^Fds, Gg^Fet, Gll^Fms, Gll^Fds, Gll^Fms, Gll^Fds, Gll^Fds, Gll^Fds, Gll^Fds, Gll^Fds, Gll^Fds, Gll^Fms, Gll^Fds, Gg, Gg, Gg^Efm, Gll^Fds, Gll^Fms, Gll^Fds, Gll^Fds, Gg, Gg^Em, Gg, Gs^Fp, Gs^Fp, Gs^Fp, Gs^Fp, Gs^Fp, Gg^Fet, Ww, Ww, Gs^Fms, Ww, Gg^Ve, Cv, Cv, Cv, Gs^Fp, Gs^Fds, Gs^Fds, Gs^Fds, Gs^Fds
Gg, Gg, Gll^Fds, Gll^Fds, Gll^Fms, Gll^Fds, Gll^Fds, Gll^Fms, Gll^Fds, Gll^Fds, Gll^Fds, Gll^Fds, Gll^Fds, Gll^Fds, Gll^Fds, Gll^Fds, Gll^Fds, Gll^Fds, Gll^Fds, Gll^Fms, Gll^Fms, Gll^Fms, Gll^Fms, Gll^Fds, Gg^Em, Gg, Gg, Gs^Fp, Gs^Fp, Gs^Fp, Gg^Fet, Gs^Fp, Gs^Fp, Gs^Fp, Gs^Fp, Ww, Gs^Fp, Ww, Cv, Kv, Gg^Fet, Gg^Ve, Gs^Fp, Gs^Fds, Gs^Fds, Gs^Fds
Gll^Fds, Gll^Fds, Gll^Fds, Gll^Fds, Gg^Ve, Gll^Fms, Gll^Fms, Gg, Gg^Es, Gg^Efm, Gll^Fds, Gll^Fds, Gll^Fds, Gll^Fds, Gll^Fds, Gll^Fds, Gll^Fds, Gll^Fds, Gll^Fms, Gll^Fms, Gll^Fms, Gll^Fms, Gll^Fms, Gll^Fms, Gll^Fms, Gll^Fms, Gll^Fms, Gs^Fp, Gs^Fp, Gs^Fp, Gs^Fp, Gs^Fp, Gs^Fp, Gg^Ve, Gs^Fp, Gs^Fp, Gs^Fp, Ww, Ww, Cv, Ww, Gs^Fp, Ww, Gs^Fp, Gs^Fp, Gs^Fds
Gll^Fds, Gll^Fds, Gll^Fds, Gll^Fds, Gll^Fds, Gll^Fds, Gll^Fds, Gll^Fds, Gll^Fds, Gll^Fds, Gll^Fds, Gll^Fds, Gll^Fds, Gll^Fms, Gll^Fds, Gll^Fds, Gg^Fet, Gll^Fds, Gll^Fms, Gll^Fms, Gll^Fds, Gll^Fms, Gll^Fds, Gll^Fms, Gll^Fds, Gll^Fms, Gll^Fds, Gll^Fms, Gs^Fp, Gs^Fp, Gs^Fp, Gs^Fp, Gs^Fp, Gs^Fp, Gs^Fp, Gs^Fp, Gs^Fp, Ww, Ww, Ww, Gs^Fds, Ww, Gg, Ww, Gs^Fp, Gs^Fds
Gll^Fds, Gll^Fms, Gll^Fms, Gll^Fds, Gll^Fms, Gll^Fds, Gll^Fds, Gll^Fms, Gll^Fms, Gll^Fms, Gll^Fms, Gll^Fms, Gll^Fms, Gll^Fms, Gll^Fds, Gll^Fds, Gll^Fds, Gll^Fds, Gll^Fms, Gll^Fds, Gg^Ve, Gll^Fds, Gll^Fds, Gll^Fds, Gll^Fds, Gll^Fds, Gll^Fds, Gs^Fms, Gs^Fms, Gs^Fp, Gs^Fp, Gs^Fp, Gs^Fp, Gs^Fp, Gs^Fp, Gs^Fp, Ww, Ww, Gg^Fet, Gs^Fds, Cv, Cv, Cv, Ww^Bw/, Ww, Gs^Fp
Gll^Fds, Gll^Fms, Gll^Fms, Gll^Fms, Gll^Fds, Gll^Fms, Gll^Fms, Gll^Fds, Gll^Fms, Gll^Fms, Gll^Fms, Gll^Fms, Gll^Fms, Gll^Fds, Gg^Ve, Gll^Fms, Gll^Fds, Gll^Fds, Gll^Fds, Gll^Fms, Gll^Fds, Gll^Fds, Gll^Fms, Gll^Fds, Gg^Fet, Gll^Fms, Gll^Fds, Gs^Fms, Gs^Fms, Gs^Fms, Gs^Fms, Gs^Fp, Gs^Fms, Gs^Fp, Gs^Fp, Ww, Ww, Ww, Cv, Gg^Fet, 2 Kv, Gg^Fet, Gg^Ve, Gg^Fet, Ww, Ww
Gll^Fds, Gll^Fds, Gll^Fms, Gg^Fet, Gll^Fds, Gll^Fds, Gg, Gg^Efm, Gg, Gll^Fds, Gll^Fds, Gll^Fds, Gll^Fds, Gll^Fms, Gll^Fds, Gll^Fds, Gll^Fms, Gll^Fds, Gll^Fms, Gll^Fds, Gll^Fds, Gll^Fms, Gll^Fds, Gll^Fds, Gll^Fds, Gll^Fms, Gll^Fms, Gs^Fms, Gg^Ve, Gs^Fms, Gs^Fms, Gs^Fms, Gs^Fp, Gs^Fp, Gs^Fp, Ww, Ww, Cv, Gg^Ve, Cv, Gg^Ve, Cv, Gg^Fet, Gs^Fds, Ww, Ww
Gll^Fds, Gll^Fms, Gg^Ve, Gll^Fms, Gll^Fds, Gll^Fds, Gll^Fms, Gg^Em, Gg, Gll^Fms, Gll^Fms, Gll^Fds, Gll^Fds, Gll^Fds, Gll^Fds, Gll^Fds, Gll^Fms, Gll^Fms, Gll^Fms, Gll^Fds, Gll^Fms, Gll^Fms, Gll^Fds, Gll^Fds, Gll^Fms, Gll^Fds, Gll^Fds, Gs^Fms, Gs^Fms, Gs^Fms, Gs^Fms, Gs^Fms, Gs^Fms, Gs^Fp, Gs^Fp, Ww, Ww, Gg^Fet, Gg^Fet, Cv, Gg^Ve, Gg^Ve, Gs^Fds, Gg^Fet, Ww, Gs^Fms
Gll^Fds, Gll^Fds, Gll^Fds, Gll^Fds, Gll^Fms, Gll^Fms, Gll^Fds, Gg, Gll^Fds, Gll^Fds, Gll^Fds, Gll^Fds, Gll^Fds, Gll^Fds, Gll^Fms, Gg^Fet, Gll^Fds, Gll^Fds, Gll^Fms, Gll^Fds, Gll^Fds, Gll^Fms, Gll^Fds, Gll^Fds, Gg^Ve, Gll^Fms, Gll^Fds, Gs^Fms, Gs^Fms, Gs^Fms, Gg^Fet, Gs^Fms, Gs^Fms, Gs^Fms, Gs^Fms, Gs^Fp, Gs^Fp, Ww, Ww, Gs^Fds, Gs^Fds, Gg^Fet, Ww, Ww, Gs^Fp, Gs^Fms
Gll^Fds, Gll^Fds, Gll^Fds, Gll^Fds, Gll^Fds, Gll^Fms, Gll^Fds, Gll^Fds, Gll^Fds, Gll^Fms, Gll^Fms, Gll^Fms, Gll^Fds, Gll^Fds, Gll^Fds, Gll^Fds, Gll^Fds, Gll^Fds, Gll^Fds, Gll^Fds, Gll^Fds, Gll^Fds, Gll^Fds, Gll^Fds, Gll^Fds, Gll^Fms, Gll^Fds, Gs^Fms, Gs^Fms, Gs^Fms, Gs^Fms, Gs^Fms, Gs^Fms, Gs^Fms, Gs^Fms, Gs^Fms, Gs^Fms, Gs^Fp, Ww, Ww^Bw|, Ww, Ww, Gs^Fms, Gs^Fp, Gs^Fms, Gs^Fms
