border_size=1
usage=map

Gll^Fds, Hh^Fms, Hh^Fms, Hh^Fms, Gll^Fms, Gll, Gll^Fms, Gll^Fms, Gll^Fms, Gll^Fms, Ds, Ww, Gll^Fms, Gll^Fms, Gll^Fms, Gll^Fms, Gll^Fms, Gll^Fms, Hh^Fms, Hh^Fms, Hh^Fms, Gll^Fms, Gll^Fms, Gll^Fms, Gll, Gll^Fms, Gll^Fds, Gll^Fms, Hh^Fds, Hh^Fms
Gll^Fms, Gll^Fds, Hh^Fms, Hh^Fms, Hh^Fds, Gll, Rb, Chr, 4 Khr, Gll^Fms, Ds, Ww, Ds, Gll^Fms, Gll^Fms, Gll^Fms, Gll^Fms, Gll^Fms, Hh^Fds, Hh^Fms, Hh^Fms, Gll^Fms, Gll^Vl, Gll^Fms, Rb, Gll^Fds, Gll^Fms, Gll^Fds, Hh^Fms, Hh^Fms
Gll^Fms, Gll^Fds, Hh^Fds, Hh^Fms, Hh^Fds, Gll^Fms, Rb, Chr, Chr, Gll^Fms, Gll^Fms, Ww, Ww, Gll^Fms, Gll^Fms, Gll^Fms, Gll^Fms, Gll^Fds, Hh^Fms, Hh^Fms, Hh^Fms, Gll^Fms, Gll^Fms, Rb, Gll^Fms, Gll^Fms, Gll^Fms, Gll^Fds, Hh^Fms, Hh^Fms
Gll^Fds, Gll^Fds, Gll^Fds, Hh^Fms, Hh^Fms, Hh^Fms, Gll^Vl, Gll, Gll, Gll^Fms, Gll^Fms, Ds, Ww, Gll^Fds, Gll^Fds, Gll^Fms, Gll^Fms, Hh^Fms, Hh^Fms, Hh^Fms, Gll^Fms, Gll^Fms, Gll^Fms, Gll, Gll^Fds, Gll^Fms, Gll^Fms, Gll^Fms, Hh^Fms, Hh^Fms
Gll^Fds, Gll^Fms, Gll^Fms, Gll^Fms, Hh^Fms, Hh^Fms, Hh^Fms, Gll^Fms, Rb, Gll^Fms, Gll^Fms, Ds, Ww, Gll^Fms, Gll^Fms, Gll^Fms, Gll^Fds, Hh^Fms, Hh^Fms, Hh^Fms, Gll^Fds, Gll^Fds, Rb, Gll, Gll^Fms, Gll^Fms, Gll^Fms, Gll^Fms, Gll^Fms, Hh^Fms
Gll^Fds, Gll^Fms, Gll^Fms, Gll^Fms, Gll^Fms, Hh^Fms, Hh^Fms, Gll^Fms, Gll^Fds, Rb, Gll^Fms, Gll^Fms, Ww, Ds, Gll^Fms, Gll^Fms, Gll^Fms, Hh^Fds, Gll^Fds, Gll^Fds, Gll^Fds, Gll^Fds, Rb, Gll^Fms, Gll^Fms, Gll^Fds, Gll^Fds, Gll^Fds, Gll^Fms, Gll^Fms
Gll^Fms, Gll^Fms, Gll^Fms, Gll^Fms, Gll^Fms, Gll^Fms, Gll^Fds, Gll^Fds, Gll, Rb, Gll^Fms, Gll^Fms, Ds, Ww, Gll^Fms, Gll^Fms, Gll^Fms, Gll^Fms, Gll^Fms, Gll^Fms, Gll^Fms, Rb, Gll^Fms, Gll^Fms, Rp^Vl, Gll^Fms, Gll^Fms, Gll^Fms, Gll^Fms, Gll^Fms
Gll^Fms, Gll^Fds, Gll^Fds, Gll^Fms, Gll^Fms, Gll^Fms, Gll^Fms, Gll^Fms, Gll, Gll^Fms, Hh^Fms, Ds, Ds, Ww, Gll^Fms, Rp^Vl, Rp, Rp, Rp, Rp^Vl, Gll^Fms, Rb, Gll^Fms, Gll^Fms, Rp, Gll^Fms, Gll^Fms, Gll^Fms, Gll^Fms, Gll^Fms
Gll^Fms, Gll^Fds, Gll^Fms, Gll^Fms, Gll^Fms, Gll^Fms, Gll^Fds, Gll^Fds, Rb, Gll^Fms, Hh^Fms, Gll^Fms, Ds, Ww, Rp, Rp, Hh^Fms, Rp^Vl, Gll^Fms, Rp, Rp, Rb, Rp^Vhc, Gll^Fms, Rp, Rp^Vhc, Gll^Fms, Hh^Fms, Hh^Fms, Gll^Fms
Gll^Fms, Gll^Fds, Gll^Fms, Gll^Fms, Gll^Fms, Gll^Fds, Gll^Fms, Gll^Vl, Gll^Fms, Rb, Gll, Hh^Fms, Rb, Ww^Bh/, Ds, Hh^Fds, Gll^Fds, Hh^Fms, Gll^Fms, Rp^Vhc, Rp, Rp, Rp, Rp, Rp, Gll^Fms, Gll^Fms, Hh^Fms, Hh^Fms, Gll^Fms
Gll^Fms, Gll^Fms, Gll^Fms, Gll^Fds, Gll^Fms, Gll^Fms, Gll^Fms, Gll^Fms, Gll^Fms, Gll^Fms, Gll^Fds, Gll, Rb, Ww, Ww, Gll^Fms, Rp^Vl, Gll^Fds, Rp^Vhc, Rp, Rp, Rp^Vhc, Gll^Fds, Gll^Fms, Gll^Fms, Rp, Rp^Vhc, Hh^Fms, Gll^Fms, Gll^Fms
Gll^Fms, Gll^Fms, Gll^Fms, Gll^Fds, Gll^Fds, Gll^Fms, Gll^Fms, Gll^Fms, Gll^Fms, Gll^Fms, Gll^Fds, Gll, Hh^Fms, Gll^Fds, Ww, Ds, Gll^Fds, Rp, Rp, Gll^Fms, Rp^Vhc, Rp, Ch, Ch, Ch, Rp, Rp, Gll^Fds, Rp^Vl, Gll^Fms
Gll^Fms, Gll^Fms, Gll^Fms, Gll^Fds, Gll^Fms, Gll^Fds, Gll^Fms, Gll^Fms, Gll^Fms, Gll^Fms, Rb, Gll, Ww, Ww, Ww, Ds, Hh^Fms, Rp^Vl, Gll^Fms, Rp, Rp, Rp, Ch, 3 Kh, Rp, Rp, Rp^Ve, Rp, Gll^Fms, Gll^Fms
Gll^Fds, Gll^Vl, Gll^Fms, Gll^Fms, Gll^Fms, Gll^Fms, Gll^Fms, Gll^Fms, Gll^Fms, Gll^Fms, Rb, Ds, Ww, Ds, Ww, Ds, Gll^Fms, Gll^Fms, Gll^Fms, Rp^Vhc, Rp, Rp, Rp, Rp, Rb, Gll^Fms, Gll^Fms, Gll^Fms, Gll^Fms, Gll^Fms
Gll^Fms, Gll^Fms, Gll^Fms, Gll^Fms, Gll^Fms, Gll^Fms, Gll^Fms, Gll^Fms, Gll^Fms, Gll^Fms, Gll, Gll^Fms, Ww, Ds, Gll^Fds, Ww^Bw/r, Ds, Gll^Fms, Gll^Fms, Gll^Fms, Rp^Vl, Gll^Fms, Gll^Fms, Rp^Vl, Hh^Fms, Rb, Gll^Fms, Gll^Fms, Gll^Fms, Gll^Fms
Gll^Fms, Gll^Fms, Ww, Ww, Ww, Ds, Ds, Wwr, Ww, Gll^Fms, Gll, Gll^Fms, Ww, Gll^Fds, Gll^Vl, Ww, Ds, Gll^Fms, Gll^Fms, Gll^Fms, Gll^Fms, Gll^Fms, Gll^Fms, Gll^Fms, Gll^Fms, Rb, Gll^Fms, Gll^Fms, Gll^Fms, Gll^Fms
Ds, Ww, Ds, Ds, Ds, Ww, Ww, Ds, Ds, Ww, Rb, Ds, Ww, Gll^Fds, Ww, Ww, Gll^Fms, Gll^Fms, Gll^Fms, Gll^Fms, Gll^Fds, Gll^Fms, Gll^Fds, Gll^Fms, Gll^Fms, Gll, Gll^Fds, Gll^Fms, Gll^Fms, Gll^Fms
Ww, Ww, Gll^Fms, Gll^Fms, Gll^Fms, Gll^Fms, Gll^Fms, Ww, Ww, Gll^Fms, Rp, Ds, Ww, Ww, Ds, Ww, Gll^Fms, Gll^Fms, Gll^Fms, Gll^Fds, Gll^Fms, Gll^Fds, Gll^Fds, Gll^Fds, Gll^Fds, Rb, Gll^Fds, Gll^Fds, Gll^Fds, Gll^Fms
Gll^Fms, Gll^Fms, Gll^Fms, Gll^Fms, Gll^Fms, Gll^Fms, Gll^Fms, Gll^Fms, Rp, Ww^Bh/, Ww, Ww, Gll^Fds, Gll^Fms, Ww, Ww, Gll^Fms, Gll^Fms, Gll^Fms, Gll^Fds, Gll^Fms, Gll^Fms, Gll^Fms, Gll^Fds, Gll^Fds, Rb, Gll^Fms, Gll^Fms, Gll^Fms, Gll^Fms
Gll^Fds, Gll^Fms, Gll^Fms, Gll^Fms, Gll^Vl, Gll^Fms, Gll, Rb, Gll^Fds, Ds, Ds, Ds, Gll^Fds, Gll^Fds, Ww, Gll^Fds, Gll^Fms, Gll^Fms, Gll^Fms, Gll^Fds, Gll^Fds, Gll^Fms, Gll^Fms, Gll^Fds, Gll^Fms, Gll, Gll, Gll^Vl, Gll^Fms, Gll^Fms
Gll^Fms, Gll^Fms, Gll^Fms, Gll^Fms, Gll^Fds, Rb, Gll^Fds, Gll^Fds, Gll^Fds, Gll^Fds, Gll^Fds, Gll^Fms, Gll^Fms, Wwr, Gll^Fms, Gll^Fms, Gll^Fms, Gll^Fms, Gll^Fms, Gll^Fds, Gll^Fms, Gll^Fms, Gll^Fms, Gll^Fms, Gll^Fms, Gll^Fms, Gll, Gll^Fds, Gll^Fms, Gll^Fms
Gll^Fms, Gll^Fms, Gll^Fms, Gll^Fms, Gll, 1 Rp, Gll^Fms, Gll^Fms, Wwf, Gll^Fds, Gll^Fms, Gll^Fds, Wwr, Wwr, Gll^Fms, Gll^Fms, Gll^Fms, Gll^Fms, Gll^Fds, Gll^Fds, Gll^Fms, Gll^Fms, Gll^Fms, Gll^Fms, Gll^Fms, Gll^Fms, Gll^Fms, Rb, Gll, Gll^Fms
Gll^Fms, Gll^Fms, Gll, Rb, Gll^Fds, Gll^Fms, Gll^Fms, Gll^Fms, Gll^Fms, Wwf, Wwf, Wwf, Gll^Fds, Wwr, Gll^Fds, Gll^Fms, Gll^Fms, Gll^Vl, Gll^Fms, Gll^Fms, Gll^Fms, Gll^Fms, Gll^Fms, Gll^Fms, Gll^Fms, Gll^Fms, Gll^Fms, Gll^Fms, Gll^Fms, Gll
Rp, Rp, Gll^Fms, Gll^Fms, Gll^Fms, Gll^Fms, Gll^Fms, Gll^Fms, Gll^Fms, Gll^Fms, Gll^Fms, Gll^Fms, Gll^Fms, Wwr, Gll^Fds, Gll^Fds, Gll^Fds, Gll^Fms, Gll^Fms, Gll^Fms, Gll^Fms, Gll^Fms, Gll^Fms, Gll^Fms, Gll^Fds, Gll^Fds, Gll^Fms, Gll^Fms, Gll^Fms, Gll^Fms
