border_size=1
usage=map

Gll^Fds, Gg, Gll^Fds, Gg, Gll^Fds, Gg, Gll^Fms, Kv, Ww, Ww, Cv, Cv, Gll^Fms, Cv, Cv, Ww, Ww, Kv, Gll^Fms, Gg, Gll^Fms, Gg, Gll^Fms, Gg
Gll^Fms, Gll^Fms, Gll^Fds, Gll^Fds, Gll^Fms, Gll^Fms, Gll^Fds, Cv, Ww, Kv, Gll^Fms, Gg^Fet, Cv, Gg^Fet, Gll^Fms, Kv, Ww, Cv, Gll^Fms, Gll^Fms, Gll^Fms, Gll^Fds, Gll^Fms, Gll^Fms
Gll^Fms, Gll^Fms, Gll^Fms, Gg^Fet, Gll^Fds, Gll^Fds, Gll^Fms, Cv, Ww, Cv, Gg^Fet, Cv, 2 Kv, Cv, Gg^Fet, Cv, Ww, Cv, Gll^Fms, Gll^Fms, Gll^Fds, Gg^Fet, Gll^Fms, Gll^Fms
Gll^Fms, Gll^Fms, Gll^Fms, Gg^Ve, Gll^Fms, Gll^Fds, Gll^Fds, Cv, Ww, Cv, Gll^Fds, Cv, Cv, Cv, Gll^Fms, Cv, Ww, Cv, Gll^Fds, Gll^Fds, Gll^Fds, Gg^Ve, Gll^Fms, Gg
Gll^Fms, Gll^Fds, Gll^Fms, Gll^Fms, Gll^Fds, Gll^Fds, Gll^Fds, Cv, Ww, Kv, Cv, Gg^Fet, Gll^Fds, Gg^Fet, Cv, Kv, Ww, Cv, Gll^Fms, Gll^Fms, Gll^Fds, Gll^Fds, Gll^Fds, Gg
Gll^Fds, Gll^Fds, Gll^Fms, Gll^Fms, Gll^Fds, Gll^Fds, Gll^Fds, Kv, Cv, Ww, Ww, Cv, Kv, Cv, Ww, Ww, Cv, Kv, Gll^Fms, Gll^Fms, Gll^Fms, Gll^Fds, Gll^Fms, Gll^Fms
Gll^Fms, Gll^Fds, Gll^Fds, Gll^Fds, Gll^Fms, Gll^Fds, Gll^Fds, Gll^Fds, Gll^Fms, Cv, Cv, Ww, Ww, Ww, Cv, Cv, Gll^Fds, Gll^Fds, Gll^Fds, Gll^Fms, Gll^Fms, Gll^Fms, Gll^Fds, Gll^Fds
Gll^Fms, Gll^Fms, Gll^Fds, Gg^Em, Gll^Fms, Gll^Fms, Gll^Fds, Gll^Fms, Gll^Fms, Gll^Fds, Gll^Fds, Cv, Kv, Cv, Gll^Fms, Gll^Fds, Gll^Fms, Gll^Fms, Gg^Em, Gll^Fms, Gll^Fms, Gll^Fms, Gll^Fds, Gll^Fds
Gll^Fms, Gll^Fds, Gll^Fds, Gll^Fms, Gll^Fds, Gg^Ve, Gll^Fds, Gg, Gg, Gll^Fms, Gll^Fms, Gll^Fds, Gll^Fms, Gll^Fds, Gll^Fms, Gll^Fms, Gll^Fds, Gll^Fds, Gll^Fds, Gll^Fds, Gll^Fds, Gll^Fms, Gll^Fds, Gll^Fds
Gll^Fms, Gll^Fms, Gll^Fms, Gll^Fds, Gll^Fds, Gll^Fds, Gll^Fds, Gg^Es, Gll^Fms, Gg, Gll^Fds, Gll^Fms, Gg^Em, Gg, Gll^Fms, Gll^Fms, Gll^Fms, Gll^Fms, Gll^Fds, Gll^Fms, Gg^Ve, Gll^Fds, Gll^Fds, Gll^Fds
Gg, Gll^Fms, Gll^Fms, Gll^Fms, Gll^Fds, Gll^Fds, Gll^Fds, Gg^Fet, Gll^Fds, Gll^Fds, Gg, Gg^Es, Gg^Em, Gg, Gll^Fds, Gll^Fms, Gll^Fds, Gg^Fet, Gg^Es, Gg, Gg^Efm, Gg, Gll^Fms, Gll^Fds
Gll^Fds, Gll^Fds, Gll^Fds, Gll^Fms, Gg, Gll^Fms, Gg^Efm, Gll^Fds, Gll^Fms, Gll^Fds, Gll^Fms, Gg, Gg, Gg, Gg, Gll^Fms, Gll^Fds, Gg, Gll^Fds, Gll^Fds, Gll^Fms, Gg, Gll^Fms, Gll^Fms
Gll^Fms, Gll^Fms, Gg^Es, Gg, Gg^Es, Gg, Gg, Gg, Gll^Fms, Gll^Fms, Gll^Fms, Gll^Fms, Gll^Fds, Gll^Fds, Gll^Fms, Gg, Gll^Fds, Gll^Fds, Gll^Fds, Gll^Fms, Gll^Fms, Gg, Gll^Fms, Gll^Fms
Gll^Fms, Gll^Fds, Gll^Fms, Gg, Gg, Gg, Gg, Gll^Fms, Gll^Fds, Gll^Fds, Gll^Fds, Gll^Fds, Gg, Gll^Fds, Gll^Fms, Gll^Fds, Gll^Fms, Gll^Fms, Gll^Fds, Gs^Fms, Gs^Fms, Gll^Fds, Gll^Fms, Gll^Fms
Gg, Gll^Fms, Gll^Fms, Gll^Fms, Gll^Fds, Gll^Fms, Gll^Fms, Gll^Fms, Gg, Gg, Gg, Gg, Gg, Gg, Gg, Gg, Gll^Fms, Gll^Fms, Gs^Fms, Gll^Fds, Gll^Fms, Gll^Fms, Gll^Fms, Gll^Fms
Gg, Gg^Em, Gll^Fms, Gll^Fms, Gg, Gll^Fds, Gg, Gll^Fms, Gg, Gg, Gg, Gg, 1 Gg^Es, Gg, Gg, Gg^Efm, Gg, Gg, Gg, Gll^Fds, Gll^Fms, Gll^Fms, Gll^Fds, Gll^Fds
Gll^Fms, Gll^Fms, Gg, Gg, Gg^Em, Gg, Gg, Gg, Gg^Efm, Gg^Em, Gg^Em, Gg^Efm, Gg, Gg, Gg^Efm, Gg^Em, Gg^Em, Gg^Es, Gg^Em, Gg^Efm, Gg^Em, Gg, Gll^Fms, Gll^Fds
Gg, Gg, Gg^Es, Gg^Efm, Gg, Gg^Em, Gg, Gg, Gll^Fms, Gg^Efm, Gg, Gg^Em, Gg, Gg, Gg, Gg, Gll^Fds, Gg, Gg, Gg^Em, Gg, Gg, Gll^Fds, Gll^Fds
Gg, Gg, Gg, Gg, Gg, Gg, Gll^Fms, Gll^Fms, Gll^Fms, Gg, Gg, Gg, Gg, Gg, Gg, Gg, Gg, Gll^Fds, Gg, Gll^Fds, Gll^Fds, Gll^Fds, Gll^Fds, Gll^Fds
