border_size=1
usage=map

Gs^Fds, Ww, Ww, Gg, Gs^Fp, Gs^Fds, Gg^Vh, Gs^Fds, Gs^Fds, Gs^Fds, Gg, Gs^Fp, Gg, Gs^Fds, Gs^Fds, Gg, Gs^Fds, Gg, Gg, Gs^Fds, Gs^Fms, Gs^Fp, Gs^Fp, Gs^Fds, Re, Gg, Gg^Em, Gs^Fds, Gg, Gs^Fds
Gg, Gg^Es, Wwf, Gg, Gs^Fds, Gg, Gs^Fp, Gg^Es, Gs^Fds, Gs^Fds, Gg^Em, Gs^Fp, Gg, Gg^Efm, Gs^Fds, Gs^Fds, Gs^Fds, Gg^Es, Gs^Fds, Gs^Fds, Gs^Fp, Gg, Gg^Es, Re, Gg, Gg, Gg, Gs^Fds, Gg^Es, Gg
Gs^Fds, Gs^Fds, Gg, Wwf, Ww, Gs^Fds, Gs^Fds, Gs^Fp, Gs^Fds, Gg, Gs^Fds, Gg^Es, Gs^Fds, Gg, Gg, Gg, Gs^Fds, Gs^Fds, Gg^Efm, Gs^Fp, Gg, Gg, Re, Re, Gg, Gg^Efm, Gs^Fds, Gs^Fds, Gs^Fds, Gs^Fds
Gs^Fds, Gg, Gs^Fds, Gg, Ww, Gg, Gs^Fds, Gg^Es, Gs^Fp, Gg^Efm, Gg, Gs^Fds, Gs^Fds, Gg^Es, Gg^Vh, Gg^Efm, Gg, Gg, Gs^Fds, Gg^Em, Gg, Re, Gs^Fds, Gs^Fms, Gs^Fds, Gg, Gg, Gs^Fds, Gg, Gg
Gg, Gg^Es, Gs^Fp, Gg^Es, Gg, Ww, Ww, Gs^Fp, Gs^Fp, Gs^Fp, Gg, Gg^Es, Gg, Gs^Fp, Gs^Fp, Gg, Gs^Fds, Gs^Fds, Gs^Fds, Gg, Gg^Efm, Re, Gs^Fds, Gs^Fds, Gs^Fds, Gs^Fds, Gg^Em, Gg, Gg, Gs^Fds
Gg, Gs^Fds, Gs^Fp, Gs^Fp, Gs^Fds, Gg, Gg, Ww, Ww, Ww, Ww, Ww, Gs^Fds, Gs^Fds, Gg^Es, Gg^Em, Gs^Fp, Gg^Es, Gs^Fds, Gg, Re, Re, Gg^Efm, Gs^Fp, Gs^Fds, Gg, Gg, Gg^Es, Gs^Fds, Gg
Gs^Fds, Gs^Fp, Gg, Gs^Fp, Gg, Gg^Efm, Ww, Ww, Ww, Ww, Ww, Ww, Ww, Gs^Fds, Ww, Gg, Gs^Fds, Gg, Gs^Fds, Gg, Rd, Gg, Gs^Fds, Gs^Fds, Gs^Fds, Gg, Gg, Gs^Fds, Gs^Fds, Gg
Gg, Gs^Fms, Gg, Gg^Efm, Gg^Es, Gg, Ww, Ww, Wo, Wo, Wo, Ww, Ww, Ww, Ww, Gs^Fds, Gg^Em, Gs^Fds, Gg, Re, Gg, Gg^Efm, Gs^Fp, Gs^Fds, Gs^Fp, Gg, Gs^Fds, Gg, Gg, Gg
Gs^Fms, Gs^Fds, Gs^Fds, Gs^Fds, Gg, Ww, Wo, Wo, Ww, Wo, Wo, Wo, Wo, Ww, Ww, Ww, Gs^Fds, Gs^Fds, Rd, Rd, Gg, Gs^Fds, Gs^Fds, Gs^Fp, Gg, Gs^Fds, Gg, Gg, Gg, Gs^Fp
Gs^Fp, Gg, Gg^Es, Gs^Fp, Wo, Wo, Ww, Ww, Ww, Wo, Wo, Wo, Wo, Ww, Ww, Ww, Rd, Rd, Gs^Fp, Gg, Gs^Fds, Gs^Fds, Gs^Fp, Gs^Fds, Gg^Vh, Gg^Em, Gg, Gg^Es, Gg, Gs^Fds
Gg, Gs^Fp, Wo, Wo, Gll^Fds, Gll^Fds, Gll^Fds, Ww, Ww, Wo, Wo, Wo, Wo, Wo, Wo, Ww, Ww^Bw|, Gs^Fds, Gs^Fds, Gs^Fds, Ww, Ww, Ww, Gg, Gg, Gg, Gs^Fds, Gs^Fp, Gg^Efm, Gg^Efm
Wo, Wo, Gll^Fds, Gll^Fds, Gll^Fds, Gll^Fds, Gll^Fds, Ww, Ww, Wo, Ww, Wo, Wo, Wo, Wo, Wo, Ww^Bw|, Wo, Wo, Wo, Wo, Wo, Ww, Ww, Gg, Gg^Es, Gg, Gs^Fp, Gg, Gg
Gll^Fds, Gll^Fds, Gll^Fds, Gs^Fms, Gll^Fds, Gll^Fds, Gll^Ve, Gll^Fds, Gll^Fds, Gll^Fds, Gll^Fds, Ww, Ww, Ww, Ww, Ww, Ww^Bw|, Wo, Wo, Ww, Ww, Wo, Ww, Ww, Gs^Fds, Gs^Fds, Gs^Fp, Gs^Fp, Gs^Fp, Gg
Gll^Fds, Gll^Fds, Gll^Fds, Gll^Fds, Gll^Fds, Gs^Fp, Gll^Fds, Gll^Fds, Gll^Fds, Gll^Fds, Gll^Fds, Gll^Fds, Gll^Fds, Cv, Kv, Ww, Rd, Ww, Ww, Wo, Wo, Wo, Wo, Gg^Em, Gg, Gs^Fp, Gg, Gg, Gg, Gg
Gll^Fds, Gll^Fds, Gll^Fds, Gll^Fds, Gll^Fp, Gll^Fds, Gll^Fds, Gll^Fds, Gll^Fds, Gll^Fds, Gll^Fds, Gll^Fp, Gll^Fds, Cv, Cv, Cv, Rd, Cv, Cv, Ww, Gll^Fds, Ww, Gll^Fds, Wo, Wo, Ww, Ww, Gg^Es, Gg^Em, Gg
Gll^Fds, Gs^Fp, Hh^Fds, Hh^Fds, Gll^Fds, Gll^Fp, Gll^Fds, Gll^Fp, Gll^Fds, Gll^Fds, Gll^Fds, Gll^Fds, Gll^Fds, Gll^Fds, Gll^Fds, Cv, Rd, Cv, Gll^Fds, Gll^Fds, Gll^Fds, Gll^Fds, Gll^Fds, Gll^Fds, Gll^Fds, Wo, Wo, Wo, Wo, Ww
Hh^Fds, Hh^Fds, Hh^Fds, Gll^Fds, Gll^Fds, Gll^Fds, Gll^Fds, Gll^Fds, Gll^Fms, Gll^Fds, Gll^Fms, Gll^Fms, Gll^Fds, Gll^Fds, Gll^Fds, Gll^Fds, Rd, Gll^Fds, Gll^Fds, Gll^Fds, Gll^Fds, Gll^Fds, Gg^Fet, Gll^Fds, Gll^Fds, Gll^Fds, Gll^Fds, Ww, Ww, Wo
Gll^Fds, Hh^Fds, Gll^Fds, Gll^Fds, Gg^Fet, Gll^Fds, Gll^Fds, Gll^Fms, Gs^Fds, Gll^Fms, Gll^Fds, Gll^Fds, Gll^Fds, Gll^Fds, Re, Rd, Gll^Fds, Gll^Fds, Gll^Fms, Gll^Fds, Gs^Fp, Gll^Fds, Gll^Fds, Gll^Fds, Gll^Fds, Gll^Fds, Gll^Fds, Gll^Fds, Gll^Fds, Ww
Hh^Fds, Gll^Fds, Gll^Fds, Gs^Fp, Gll^Fds, Gll^Fds, Gll^Fds, Gll^Fms, Gs^Fds, Gll^Fp, Gll^Fp, Gll^Fds, Gll, Re, Gll^Fds, Gll^Fds, Gll^Fds, Gll^Fds, Gll^Fds, Gll^Fms, Gll^Fds, Gll^Fds, Gll^Fds, Gll^Fds, Gg^Ve, Gll^Fds, Gll^Fds, Gll^Fds, Gll^Fds, Gll^Fds
Gs^Fmw, Gll^Fds, Gll^Fms, Gs^Fp, Gll^Fms, Gll^Fds, Gll^Fms, Gll^Fms, Gll^Fms, Gll^Fp, Gll^Fds, Gll^Fds, Gll, Gll^Fds, Gll^Fds, Gg^Ve, Gll^Fds, Gll^Fds, Gs^Fms, Gs^Fp, Gll^Fds, Gll^Fms, Gll^Fds, Gs^Fp, Gs^Fp, Gll^Fds, Gll^Fds, Gll^Fds, Gll^Fds, Gll^Fds
Hh^Fds, Gll^Fms, Gll^Fms, Gll^Fms, Gll^Fms, Gll^Fms, Gll^Fds, Gll^Fds, Gll^Fds, Gll^Fms, Gll^Fds, Gll, Gll^Fds, Gll^Fds, Gll^Fds, Gll^Fds, Gll^Fds, Gs^Fp, Gll^Fds, Gll^Fds, Gll^Fds, Gll^Fms, Gll^Fds, Gll^Fds, Gs^Fp, Gll^Fds, Gll^Fds, Gll^Fds, Gll^Fds, Gll^Fds
Gll^Fms, Gll^Fms, Gll^Fms, Gs^Fds, Gll^Fms, Gll^Fds, Gll^Fds, Gll^Fds, Gll^Fds, Gll^Fms, Rd, Gll, Gll^Fds, Gll^Fms, Gll^Fms, Gll^Fds, Gg^Fet, Gll^Fds, Gll^Fds, Gll^Fds, Gll^Fds, Gll^Fds, Gll^Fp, Gll^Fds, Gll^Fds, Gll^Fds, Gll^Fds, Gll^Fds, Gg^Fet, Gll^Fds
Hh^Fds, Gs^Fds, Gll^Fms, Gll^Fms, Gll^Fms, Gll^Fds, Gll^Fms, Gll^Fms, Gll^Fms, Gll^Fms, Re, Gll^Fms, Re^Gvs, Re^Gvs, Re^Gvs, Gll^Fms, Gll^Fds, Gll^Fds, Gs^Fp, Gll^Ve, Gll^Fds, Gll^Fp, Gll^Fds, Gll^Fds, Gll^Fds, Gll^Fds, Gll^Fds, Gll^Fds, Gs^Fp, Gll^Fds
Gs^Fds, Hh^Fds, Hh^Fds, Gll^Fds, Gll^Fds, Gll^Fds, Gll^Fds, Gll^Fds, Gll^Fds, Re, Gll^Fms, Gll^Fms, Gll^Fms, Re^Gvs, Re^Gvs, Re^Gvs, Gll^Fms, Gll^Fms, Gll^Fms, Gll^Fds, Gll^Fds, Gll^Fds, Gll^Fds, Gll^Fds, Hh^Fds, Gll^Fds, Gll^Ve, Gs^Fp, Gll^Fds, Gll^Fds
Gs^Fdw, Gs^Fds, Gs^Fds, Hh^Fds, Gll^Fds, Hh^Fds, Gll^Fds, Gll^Fds, Rd, Rd, Hh^Fds, Gll^Fms, Hh^Fds, Re^Gvs, Gll^Fds, Re^Vh, Hh^Fds, Gll^Fds, Gll^Fms, Gll^Fms, Gll^Fms, Gll^Fds, Gll^Fds, Gll^Fds, Gll^Fp, Gll^Fds, Gll^Fp, Gll^Fds, Gll^Fds, Hh^Fds
Gll^Fms, Gs^Fds, Gll^Fms, Hh^Fds, Gll^Fds, Gll^Fds, Gll, Re, Gs^Fds, Gll^Fms, Hh^Fds, Hh^Fds, Gs^Fds, Hh^Fds, Gll^Fms, Gll^Fds, Hh^Fds, Gll^Fds, Hh^Fds, Hh^Fds, Gll^Fms, Gll^Fms, Gll^Fds, Gll^Fds, Gll^Fds, Gll^Fp, Gll^Fds, Gll^Fds, Gll^Fds, Hh^Fds
Gll^Fms, Gll^Fms, Gll^Fms, Gll^Fds, Gll^Fms, Gll^Fms, Rd, Gll^Fms, Gll^Fms, Gll^Fms, Gll^Fms, Gll^Fms, Gll^Fms, Gll^Fms, Gll^Fms, Gll^Fms, Gll^Fms, Hh^Fds, Hh^Fds, Gll^Fms, Gs^Fds, Gll^Fms, Gll^Fds, Gll^Fds, Gll^Fds, Gll^Fds, Gs^Fp, Gll^Fds, Gll^Fds, Gll^Fds
Gll^Fms, Gll^Fds, Gll^Fms, Gll^Fms, Gll^Fms, Gll^Fms, Rd, Gll^Fms, Gll^Fms, Gll^Fms, Gll^Fms, Gll^Fms, Gll^Fms, Gll^Fds, Gll^Fms, Gll^Fms, Gs^Fds, Gs^Fds, Hh^Fds, Hh^Fds, Hh^Fds, Gs^Fp, Gll^Fds, Gll^Fds, Gll^Fds, Gll^Fds, Gs^Fp, Gll^Fds, Hh^Fms, Gs^Fp
Gll^Fms, Gll^Fds, Gll^Fms, Gll^Fms, Gll^Fms, Gll^Fms, Gll, Gll^Fms, Gll^Fms, Gll^Fms, Gll^Fms, Gll^Fms, Gll^Fds, Gll^Fds, Gll^Fms, Gll^Fms, Gs^Fds, Gs^Fds, Gll^Fms, Hh^Fds, Hh^Fms, Hh^Fms, Gs^Fp, Gs^Fp, Gs^Fp, Gll^Fds, Gll^Fds, Gll^Fds, Hh^Fds, Hh^Fms
Gll^Fds, Gll^Fds, Gll^Fms, Gll^Fms, Gll^Fms, Gll^Fms, Gll^Fms, Gll, Gll^Fds, Gll^Fms, Gll^Fds, Gll^Fds, Gll^Fds, Gll^Fms, Gll^Fms, Gll^Fms, Gll^Fms, Gll^Fms, Gs^Fds, Hh^Fms, Hh^Fms, Hh^Fms, Hh^Fms, Gs^Fds, Hh^Fds, Hh^Fds, Hh^Fds, Hh^Fms, Hh^Fds, Hh^Fds
Gll^Fds, Gll^Fds, Gll^Fms, Gll^Fms, Gll^Fms, Gll^Fds, Gll^Fms, Re, Rd, Gll^Fds, Gll^Fms, Gll^Fms, Gll^Fds, Gll^Fms, Gll^Fms, Gs^Fds, Gs^Fds, Gs^Fds, Gs^Fds, Gll^Fms, Hh^Fms, Hh^Fms, Hh^Fds, Hh^Fds, Hh^Fds, Hh^Fds, Hh^Fds, Hh^Fds, Gs^Fp, Gs^Fp
Gll^Fms, Gll^Fds, Gll^Fms, Gll^Fds, Gll^Fds, Gll^Fds, Gll^Fms, Gll^Fms, Rd, Gll^Fms, Gs^Fds, Gll^Fms, Gll^Fms, Gll^Fds, Gll^Fms, Gll^Fms, Gs^Fds, Gs^Fds, Gll^Fms, Gll^Fms, Hh^Fds, Hh^Fms, Hh^Fds, Hh^Fds, Hh^Fds, Hh^Fds, Hh^Fds, Gll^Fds, Gll^Fds, Ww
Gll^Fms, Gll^Fms, Gll^Fds, Gll^Fms, Gll^Fms, Gll^Fds, Rd, Rd, Gs^Fds, Gs^Fds, Gll^Fms, Gll^Fms, Gs^Fds, Gll^Fms, Gll^Fms, Gll^Fms, Gs^Fds, Gs^Fds, Gll^Fms, Gll^Fms, Hh^Fms, Gs^Fds, Hh^Fds, Hh^Fds, Hh^Fms, Hh^Fds, Gll^Fds, Gll^Fds, Ww, Ww
Gs^Fmw, Gll^Fds, Gll^Fds, Gll^Fds, Gll^Fds, Gll^Fds, Rd, Gs^Fds, Gs^Fds, Gll^Fms, Gll^Fms, Gs^Fds, Gll^Ve, Gll^Fms, Gll^Fms, Gg^Fet, Gll^Fms, Gll^Fms, Gll^Fms, Gs^Fds, Hh^Fms, Hh^Fds, Hh^Fds, Hh^Fds, Hh^Fds, Hh^Fds, Gll^Fds, Gll^Fds, Ww, Ww
Gs^Fmw, Gll^Fds, Gll^Fds, Gll^Fds, Gll^Fds, Gll, Gs^Fds, Gs^Fds, Gll^Fms, Gll^Fms, Gll^Fms, Gll^Fms, Gll^Fms, Gll^Fms, Gll^Fms, Gll^Fms, Gs^Fds, Gll^Fms, Gs^Fds, Gs^Fds, Hh^Fds, Hh^Fms, Hh^Ve, Hh^Fds, Hh^Fds, Hh^Fds, Gll^Fds, Gll^Fds, Ww, Ww
Gll^Fds, Gll^Fds, Gll^Fds, Gll^Fds, Gll^Fds, Gll, Gs^Fds, Gs^Fds, Gll^Fms, Gll^Fms, Gs^Fds, Gs^Fds, Gll^Fms, Gll^Fms, Gll^Fms, Gll^Ve, Gs^Fds, Gs^Fds, Hh^Fds, Hh^Ve, Hh^Fds, Hh^Fms, Hh^Fds, Hh^Fds, Hh^Fds, Hh^Fds, Ww, Ww, Ww, Gll^Fds
Gll^Fds, Gll^Fds, Gll^Fds, Gll^Fds, Gll, Rd, Gs^Fds, Gs^Fds, Gll^Fms, Gs^Fds, Gg^Fet, Gs^Fds, Gs^Fds, Gll^Fms, Gll^Fms, Gll^Fms, Gs^Fds, Gs^Fms, Hh^Fds, Hh^Fds, Hh^Fds, Hh^Fds, Hh^Fds, Hh^Fds, Ww, Ww, Ww, Ww, Gll^Fds, Gll^Fds
Gs^Fmw, Gll^Fds, Gll^Fds, Gll^Fds, Rd, Gs^Fds, Gs^Fds, Gll^Fms, Gll^Fms, Gll^Fms, Gs^Fds, Gs^Fms, Gs^Fds, Gs^Fds, Gll^Fms, Hh^Fds, Hh^Ve, Hh^Fds, Hh^Fds, Hh^Fds, Hh^Fds, Hh^Fds, Ww, Ww, Ww, Ww, Hh^Fds, Gs^Fp, Gll^Fds, Gll^Fds
Gll^Fds, Gll^Fds, Gll^Fds, Gll^Fds, Rd, Gs^Fds, Gs^Fds, Gll^Fms, Gll^Fms, Gs^Fds, Gll^Fms, Gs^Fds, Gll^Fms, Gll^Ve, Gll^Fms, Hh^Fds, Ww, Hh^Fds, Ww, Hh^Fds, Ww, Ww, Ww, Ww, Hh^Fds, Hh^Fds, Gll^Fds, Gll^Fds, Gll^Fds, Gll^Fds
Gs^Fmw, Gll^Fds, Gll^Fds, Gll^Fds, Re, Gs^Fds, Gll^Fms, Gll^Fms, Gll^Fms, Gll^Fms, Ww, Gll^Fms, Gll^Fms, Gll^Fms, Ww, Ww, Ww, Ww, Ww, Ww, Ww, Ww, Gs^Fds, Hh^Fds, Gll^Ve, Gs^Fms, Gll^Fds, Gll^Fds, Gll^Fds, Gll^Fds
Gs^Fmw, Gll^Fds, Gll^Fds, Gll^Fds, Wwf, Gs^Fds, Gs^Fds, Gll^Fms, Ww, Ww, Hh^Fms, Ww, Ww, Ww, Ww, Ww, Hh^Fp, Hh^Fp, Hh^Fp, Hh^Fds, Hh^Fds, Hh^Fds, Hh^Fds, Hh^Fds, Gll^Fms, Gll^Fds, Gll^Fds, Gll^Fds, Gs^Fp, Gll^Fds
Ww, Gll^Fds, Ww, Wwf, Ww, Wwf, Ww, Ww, Gll^Fds, Hh^Fms, Hh^Fms, Hh^Fms, Hh^Fms, Ww, Hh^Fms, Hh^Fp, Hh^Fp, Hh^Fp, Hh^Fds, Hh^Fds, Hh^Fds, Hh^Fds, Gll^Fms, Gll^Fms, Gll^Fet, Gll^Fds, Gll^Fds, Gll^Fds, Gs^Fp, Gll^Fds
Gll^Fds, Ww, Gll^Fms, Ww, Wwf, Ww, Gll^Fds, Gll^Fds, Gs^Fms, Gs^Fms, Gs^Fms, Hh^Fms, Hh^Fms, Hh^Fds, Hh^Fms, Hh^Fds, Hh^Fmw, Hh^Fp, Hh^Fds, Hh^Fds, Gll^Fms, Gll^Fms, Gll^Ve, Gll^Fms, Gll^Fms, Gll^Fds, Gll^Fds, Gll^Fds, Gs^Fp, Gs^Fp
Hh^Fms, Gll^Fds, Gll^Fds, Re, Gs^Fms, Gll^Fds, Gll^Fds, Gs^Fms, Gll^Fds, Gs^Fms, Hh^Fms, Hh^Fms, Hh^Fms, Hh^Fds, Hh^Fds, Hh^Fds, Hh^Fds, Hh^Fp, Hh^Fp, Hh^Fms, Hh^Fms, Gll^Fms, Gll^Fms, Gll^Fms, Gll^Fms, Gll^Fds, Gll^Fds, Gll^Fds, Gs^Fp, Gs^Fp
Hh^Fms, Gll^Fds, Gll^Fms, Rd, Gll^Fds, Gs^Fms, Gll^Fds, Gll^Fds, Gll^Fds, Hh^Fms, Hh^Fms, Hh^Fms, Gs^Fds, Hh^Fds, Hh^Fp, Hh^Ve, Hh^Fms, Hh^Fds, Hh^Fms, Hh^Fp, Hh^Fp, Hh^Fp, Hh^Fms, Gll^Fms, Gll^Fms, Gll^Fet, Gll^Fds, Gs^Fp, Gs^Fp, Gs^Fp
Gs^Fds, Gll^Fms, Gll^Fds, Rd, Gs^Fms, Gll^Fds, Gs^Fms, Gll^Fds, Gs^Fms, Hh^Fms, Hh^Fms, Hh^Fms, Hh^Fms, Hh^Fds, Hh^Fms, Hh^Fp, Hh^Fp, Hh^Fms, Hh^Fp, Hh^Fp, Hh^Fp, Gll^Fp, Gll^Fds, Gll^Fds, Gll^Fds, Gll^Fp, Gll^Fp, Gll^Fds, Gll^Fds, Gll^Fds
Gll^Fms, Gll^Ve, Rp, Rp, Rp, Gll^Ve, Gll^Fds, Gll^Fds, Gll^Fds, Hh^Fms, Hh^Fms, Hh^Fms, Hh^Fms, Hh^Fms, Hh^Fds, Hh^Fds, Hh^Fp, Hh^Fp, Hh^Ve, Hh^Fp, Hh^Fp, Gll^Fp, Gll^Fp, Gll^Fds, Gll^Ve, Gll^Fp, Gll^Fp, Gll^Fds, Gll^Fds, Gll^Fds
Gll^Fms, Gll^Fds, Rp, Rp^Ve, Rp, Gll^Fds, Gll^Fds, Gll^Fds, Gll^Fds, Hh^Fms, Hh^Fms, Hh^Fms, Hh^Fms, Hh^Fms, Hh^Fms, Hh^Fms, Hh^Fms, Hh^Fp, Hh^Fds, Hh^Fms, Gll^Fp, Gll^Fp, Gs^Fds, Gll^Fp, Gs^Fds, Gll^Fp, Gll^Fds, Gll^Fds, Gs^Fp, Gll^Fds
Gll^Fms, Gll^Ve, Gll^Fds, Rp, Gll^Fms, Gll^Ve, Gll^Fms, Gll^Fms, Gll^Fds, Hh^Fds, Hh^Fds, Hh^Fms, Hh^Fms, Hh^Fms, Hh^Ve, Hh^Fms, Hh^Fms, Hh^Fms, Hh^Fds, Hh^Fds, Gll^Fp, Gll^Fp, Gll^Fp, Gll^Fp, Gll^Fp, Gll^Fp, Gll^Fds, Gll^Fds, Gs^Fp, Gll^Fds
Gll^Fds, Gll^Fds, Gll^Fds, Gll^Ve, Gll^Fms, Gll^Fms, Gll^Fms, Gll^Fms, Hh^Fds, Hh^Fds, Hh^Fms, Hh^Fms, Hh^Fms, Hh^Fms, Hh^Fds, Hh^Fds, Hh^Fds, Hh^Fms, Hh^Fds, Hh^Fds, Gll^Fp, Gll^Fds, Gll^Fds, Gll^Fp, Gll^Fds, Gll^Fds, Gll^Fds, Gll^Fds, Gs^Fp, Gll^Fds
Hh^Fms, Gll^Fds, Gll^Fds, Gll^Fms, Gll^Fms, Gll^Fms, Gll^Fms, Gs^Fds, Hh^Fdw, Hh^Fds, Hh^Fmw, Hh^Fms, Hh^Fmw, Hh^Fms, Hh^Fp, Hh^Fds, Hh^Fds, Hh^Fds, Gll^Fp, Gll^Fp, Gll^Fp, Gll^Fds, Gll^Fds, Gg^Fet, Gll^Fds, Gll^Fds, Gll^Fds, Gs^Fp, Gs^Fp, Gll^Fds
