border_size=1
usage=map

Gs^Fds, Gs^Fds, Gs^Fds, Gg, Gs^Fds, Gg, Gs^Fds, Gs^Fds, Gs^Fds, Gs^Fds, Gs^Fds, Gs^Fds, Gs^Fds, Hh^Fds, Hh^Fds, Hh^Fds, Hh^Fms, Gg, Gs^Fds, Gg, Gg, Gg, Gg, Gs^Fds, Gs^Fds, Hh^Fds, Hh^Fds, Gs^Fds, Gs^Fds, Gs^Fds, Gs^Fds, Hh^Fds, Hh^Fds, Gs^Fds, Hh^Fds, Gg, Gs^Fds, Gs^Fds, Gs^Fds, Gg, Gg, Gg, Rp, Gg, Gg, Gg
Gs^Fds, Gs^Fds, Gll^Fds, Gs^Fds, Gg^Es, Gg, Gs^Fds, Gs^Fds, Gs^Fds, Gs^Fds, Gg, Gs^Fds, Gs^Fds, Hh^Fds, Hh^Fms, Hh^Fds, Hh^Fds, Hh^Fds, Gs^Fds, Gg, Gg, Gg^Efm, Gg, Gs^Fds, Hh^Fds, Hh^Fds, Gs^Fms, Gs^Fds, Gg, Gs^Fms, Gs^Fds, Hh^Fds, Hh^Fms, Hh^Fds, Hh^Fms, Hh^Fds, Gs^Fds, Gs^Fds, Gg, Gg^Efm, Gg, Rp, Gg, Gg, Gg, Gg
Gg, Gs^Fds, Gs^Fds, Gs^Fds, Gg^Efm, Gg, Gs^Fds, Gll^Fds, Gs^Fms, Gs^Fds, Gg, Gg, Gg, Hh^Fds, Gs^Fds, Hh^Fds, Hh^Fds, Hh^Fds, Gs^Fms, Gs^Vl, Gg, Gg, Gs^Fds, Gs^Fds, Gs^Fms, Hh^Fds, Gs^Fds, Gg, Gg^Em, Gg, Gs^Fds, Gs^Fds, Gs^Fms, Gs^Fms, Gs^Fds, Gs^Fds, Gg, Gg, Gg, Gg, Rp, Rp, Gg, Gg, Gs^Fds, Gg
Gs^Fds, Gg^Em, Gg, Gg, Gg, Gg, Gg, Gll^Fds, Gs^Fds, Gs^Fds, Gg^Efm, Gg^Es, Gg, Gg, Gll^Fds, Gs^Fms, Gs^Fds, Hh^Fds, Gs^Fds, Gs^Fds, Gg, Gg, Gg, Gs^Fds, Gs^Fds, Gs^Fds, Gll^Fds, Gs^Fds, Gg, Gs^Vl, Gg, Gs^Fds, Gs^Fms, Gs^Fms, Gs^Fds, Gs^Fds, Ce, Ce, Ce, Rp, Gg, Gg, Gs^Fds, Gs^Fds, Hh^Fms, Gs^Fds
Gs^Fds, Gs^Fds, Gs^Fds, Gg, Gg, Gg, Gg, Gg, Gg, Gg, Gg, Gg, Gg, Gg, Gs^Fds, Gs^Fds, Gg, Gs^Fds, Gs^Fds, Gg, Gg, Gg, Gg^Em, Gg, Gg, Gll^Fds, Gs^Fms, Gs^Fds, Gs^Fds, Gg, Gg, Gg, Gs^Fds, Gs^Fds, Gg, Gg, Ce, 1 Ke, Ce, Rp, Gg, Gg, Gs^Fds, Gs^Fms, Hh^Fms, Gs^Fds
Gs^Fds, Gs^Fms, Gll^Fds, Gs^Fds, Gg, Gg^Em, Gs^Vl, Gs^Fds, Gs^Fds, Gg, Gs^Fds, Gg, Gg, Gg, Gg^Efm, Gg, Gg, Gg, Gs^Eff, Gs^Fms, Gs^Eff, Gg^Eff, Gg^Eff, Gg^Em, Gg, Gg, Gg, Gs^Fds, Gs^Fds, Gg, Gg, Gg^Efm, Gg, Gg^Em, Gg, Gg, Ce, Ce, Rp, Rp, Gg^Es, Gg, Gs^Fds, Gs^Fds, Hh^Fms, Hh^Fds
Gs^Fds, Gs^Fds, Gs^Fms, Gs^Fds, Gg, Gg, Gs^Fds, Gs^Fds, Gll^Fds, Gll^Fds, Gs^Fds, Gs^Fds, Gg, Gg, Gg, Gg, Gg^Eff, Gg^Eff, Rb^Gvs, Gs^Eff, Gg, Gg^Em, Gg, Gg^Eff, Gg^Eff, Gg, Gg^Es, Gg, Gg, Gg, Gg, Gg, Gg^Eff, Gg^Eff, Gg^Eff, Gg, Rp, Rp, Gg, Gg, Gg, Gg, Gg, Gs^Fds, Hh^Fms, Hh^Fds
Gs^Fds, Gs^Fds, Gs^Fds, Gg, Gg, Gg, Gg, Gs^Fds, Gs^Fds, Gll^Fds, Gs^Fds, Gg, Gg, Gg^Em, Gg^Eff, Gg^Eff, Gg, Rb^Gvs, Rb^Gvs, Rb^Gvs, Rb^Gvs, Gg, Gg^Em, Gg, Gg, Gg^Eff, Gg^Eff, Gg, Gg^Eff, Gg^Eff, Gg^Eff, Gg^Eff, Gg, Gg, Gg^Em, Gg, Rp, Gg, Gg^Es, Gg, Gg, Gg^Efm, Gg, Gs^Fds, Gs^Fms, Gs^Fds
Ww, Gg, Gg, Gg, Gg, Gg^Efm, Gg, Gg, Gg, Gs^Fds, Gg^Es, Gg, Gg^Eff, Gg^Eff, Gg, Gg, Gg, Rb^Gvs, Rb^Gvs, Rb^Gvs, Rb^Gvs, Rb^Gvs, Gg, Gg, Rb^Gvs, Gg^Em, Gg, Gg^Eff, Rb^Gvs, Rb^Gvs, Rb^Gvs, Rb^Gvs, Rb^Vh, Gg, Rp, Rp, Rb^Gvs, Gg^Eff, Gg^Eff, Gg, Gg, Gg, Gg, Gg, Gg, Gs^Fds
Gs^Fds, Ww, Ww, Gg, Ww, Gg, Gg^Es, Gg, Gg, Gg, Gg, Gg, Gg^Eff, Gg^Eff, Rb^Gvs, Gg, Rb^Gvs, Rb^Gvs, Rb, Rb^Vh, Gg, Gg, Rb^Gvs, Rb^Gvs, Rb^Gvs, Rb^Gvs, Gg, Gg, Rb^Gvs, Rb^Gvs, Rb^Gvs, Rb^Gvs, Rb^Gvs, Rp, Rb^Vh, Rb^Gvs, Rb^Gvs, Rb^Gvs, Gg^Eff, Gg^Eff, Gs^Fds, Gs^Fds, Gs^Fds, Gg, Gs^Fds, Gg
Gs^Fds, Gs^Fds, Gs^Fds, Ww, Gs^Fds, Ww, Ww, Gg, Gg, Gg, Gg^Eff, Gg^Eff, Gg^Efm, Gg^Efm, Rb^Gvs, Rb^Gvs, Rb^Gvs, Rb^Vh, Rb^Gvs, Rb, Rb, Rb^Vh, Rb^Gvs, Rb^Gvs, Rb^Gvs, Rb^Gvs, Gg^Es, Gg, Gg, Rb^Gvs, Rb^Gvs, Rb^Gvs, Rp, Rp, Rb^Gvs, Rb^Gvs, Rb^Gvs, Rb^Gvs, Gg^Eff, Gg^Eff, Gs^Fds, Gs^Fds, Hh^Fms, Hh^Fds, Gs^Fds, Gs^Fds
Gs^Fds, Gs^Fds, Gs^Fds, Gs^Fds, Gs^Fds, Gg, Gg, Ww, Ww, Gg^Eff, Gg^Efm, Gg^Efm, Gg^Efm, Gg^Efm, Rb^Gvs, Rb^Gvs, Rb^Gvs, Rb^Gvs, Gg^Efm, Gg^Efm, Gg^Efm, Rb, Rb, Rb^Gvs, Gg, Gg, Rb^Gvs, Rb^Gvs, Gg^Em, Gg, Rp, Rp, Gg, Gg^Em, 2 Gg, Rb^Gvs, Gg, Gg^Eff, Gg^Eff, Gg, Gg, Gg, Gg, Gs^Fds, Gg, Gg
Gs^Fds, Gs^Fms, Gs^Fds, Gs^Fms, Gs^Fds, Gg, Gg^Efm, Gg, Ww, Gg^Efm, Gg^Efm, Gg^Efm, Gg^Efm, Gg^Efm, Gg, Rb^Gvs, Rb^Gvs, Gg, Gg, Gg^Efm, Gg^Efm, Gg^Efm, Gg, Rb, Gg^Wm, Rb^Gvs, Rb^Gvs, Rb^Gvs, Rb^Gvs, Gg, Rp, Rb^Vh, Rb^Gvs, Gg, Gg, Gg, Gg, Gg^Efm, Gg, Gg^Eff, Gg^Eff, Gg, Gg, Gg, Gs^Fds, Gg
Gg, Gs^Fds, Gs^Fds, Gs^Fds, Gg, Gg, Gg, Gg, Gs^Fds, Ww, Ww, Gg^Efm, Gg^Efm, Gg^Efm, Gg^Efm, Gg, Gg^Em, Gg, Rb^Gvs, Rb^Gvs, Rb^Gvs, Rb^Gvs, Gg, Rb, Rb^Gvs, Rb^Gvs, Rb^Gvs, Rb^Vh, Rp, Rp, Rb^Gvs, Rb^Gvs, Rb^Gvs, Rb^Gvs, Gg, Gg, Gg, Gg, Gg^Eff, Gg^Eff, Gg, Gs^Fds, Gs^Fds, Gs^Fds, Hh^Fds, Gg
Gg, Gg, Gg, Gg^Em, Gg, Gg, Gg, Gg, Gs^Fds, Gs^Fds, Gs^Fds, Ww, Gg^Efm, Gg^Efm, Gg^Efm, Gg, Rb^Gvs, Rb^Gvs, Rb^Gvs, Rb^Gvs, Rb^Gvs, Rb^Vh, Rp, Rb, Rb, Rb^Gvs, Rp, Rp, Gg, Rb^Gvs, Rb^Gvs, Rb^Gvs, Rb^Gvs, Rb^Gvs, Rb^Gvs, Gg, Gg^Eff, Gg^Eff, Gs^Fds, Gg, Gg, Gg, Gg, Gs^Fds, Hh^Fms, Gs^Fds
Gg, Gg, Gg, Gs^Vl, Gg, Gg^Efm, Gs^Fds, Gs^Fds, Gs^Fds, Gs^Fds, Gs^Fds, Ww, Ww, Gg^Efm, Rb^Vh, Gg, Rb^Gvs, Rb^Gvs, Rb^Gvs, Rb^Gvs, Rp, Rp, Rb^Gvs, Rp, Rp, Rp, Rb^Vh, Gg, Gg, Gg^Efm, Gg, Rb^Gvs, Gg, Rb^Gvs, Gg^Eff, Gg^Eff, Gs^Fds, Gs^Fds, Gs^Fds, Gs^Fds, Gg, Gg^Efm, Gg, Gg, Gs^Fds, Hh^Fds
Gs^Fds, Gs^Fds, Gs^Fds, Gs^Fds, Gs^Fds, Gg, Gg, Gs^Fds, Gs^Fds, Gs^Fds, Gs^Fds, Gs^Fds, Ww, Rb^Gvs, Rb^Gvs, Rb^Gvs, Rp, Rp, Rp, Rp, Ce, Ce, Rb^Gvs, Rb^Gvs, Rb^Gvs, Rb^Gvs, Rb^Gvs, Rb^Gvs, Gg^Eff, Gg^Eff, Gg^Eff, Gg, Gg^Eff, Gg^Eff, Gg^Es, Gs^Fds, Gs^Fds, Gs^Fds, Gg, Gg, Gs^Fds, Gg, Gg, Gg, Gg, Gg
Gs^Fms, Gs^Fds, Gs^Fds, Gs^Fds, Gs^Fds, Gg, Gg^Es, Gs^Fds, Gs^Fds, Gs^Fds, Gs^Fds, Gs^Fds, Ww, Rb^Gvs, Rb^Gvs, Rb^Gvs, Rp, Rb^Gvs, Rb^Gvs, Rb^Gvs, 3 Ke, Ce, Ce, Rb^Gvs, Rb^Gvs, Rb^Gvs, Gg^Eff, Gg^Eff, Gll^Fds, Gs^Fds, Gs^Fds, Gg^Eff, Gg, Gg, Gg, Gg, Gg, Gg, Gg, Gs^Vl, Gg, Gs^Fds, Gs^Fds, Gs^Fds, Gs^Fds, Gg
Gs^Fds, Gs^Fms, Gs^Fms, Gs^Fms, Gs^Fds, Gg, Gg, Gg, Gg, Gs^Fds, Gs^Fds, Gs^Fds, Ww, Rb^Gvs, Rb^Gvs, Rb^Gvs, Rp, Rb^Gvs, Rb^Gvs, Rb^Gvs, Gg, Ce, Gg, Gg, Gg^Eff, Gg^Eff, Gs^Fds, Gs^Fds, Gs^Fds, Gll^Fds, Gg, Gg^Em, Gg^Em, Gg, Gs^Fds, Gg, Gg, Gg^Efm, Gg, Gs^Fds, Gs^Fds, Gs^Fds, Gs^Fms, Hh^Fds, Hh^Fds, Gs^Fds
Gs^Fds, Gs^Fds, Gs^Fds, Gs^Fds, Gg, Gg^Em, Gg, Gg, Gg^Es, Gg, Gs^Vl, Gs^Fds, Gg, Ww, Rb^Gvs, Rb^Gvs, Rp, Rb^Gvs, Rb^Gvs, Rb^Gvs, Gg, Gg^Em, Gg^Eff, Gg^Eff, Gg, Gg, Gs^Fds, Gg, Gg, Gs^Vl, Gs^Fds, Gg^Es, Gs^Fds, Gll^Fds, Gs^Fds, Gs^Fds, Gs^Fds, Gg, Gg, Gs^Fds, Gg, Gs^Fds, Gs^Fds, Hh^Fds, Hh^Fms, Gs^Fds
Gg, Gg, Gg^Efm, Gg, Gg, Gg, Gg, Gg^Efm, Gg, Gg, Gll^Fds, Gg, Gg^Es, Ww, Ww, Rb^Gvs, Rb^Gvs, Rp, Rp, Rb^Vh, Gg^Eff, Gg^Eff, Gg, Gg^Es, Gg^Em, Gg, Gg, Gg, Gg, Gs^Fds, Gs^Fds, Gs^Fds, Gs^Fds, Gll^Fds, Gs^Fds, Gs^Fds, Gg, Gg, Gg, Gg, Gg^Es, Gg, Gg, Gs^Fds, Hh^Fds, Hh^Fds
Gg, Gg, Gg, Gg, Gll^Fds, Gs^Fds, Gll^Fds, Gg, Gg, Gs^Fds, Gll^Fds, Gll^Fds, Gg, Gs^Fds, Ww, Rb^Gvs, Rb^Gvs, Rb^Gvs, Rp, Gg, Gg^Em, Gg^Eff, Gg^Eff, Gg, Gg, Gg, Gg^Efm, Gg, Gg, Gg, Gg^Em, Gs^Fds, Gg, Gs^Fds, Gs^Fds, Gs^Fds, Gg, Gg, Gg^Efm, Gg, Gg, Gg, Gg^Efm, Gs^Fds, Gs^Fds, Hh^Fds
Gg, Gg, Gs^Fds, Gs^Fds, Gll^Fms, Gll^Fds, Gs^Fds, Gg, Gg, Gg, Gll^Fds, Gll^Fds, Gg, Gs^Fds, Gs^Fds, Ww, Ww, Rb^Vh, Rp, Gg, Gg^Eff, Gg^Eff, Gg^Es, Gg, Gg, Gg, Gg, Gg, Gg, Gg, Gg, Gg, Gg, Gg, Gg, Gg, Gg, Gg, Gg, Gg, Gg, Gg, Gg, Gg, Gg, Gs^Fds
Gs^Fds, Gs^Fds, Gll^Fds, Gs^Fds, Gll^Fds, Gs^Fds, Gg, Gg^Es, Gs^Fds, Gll^Fds, Gg, Gg, Gg, Gll^Fds, Gll^Fds, Gs^Fds, Rb, Ww^Bw/, Ww, Gg^Eff, Gg, Gg, Gg, Gg, Gs^Fds, Gs^Fds, Gs^Fds, Gs^Fds, Gs^Fds, Gs^Fds, Gs^Fds, Gg, Gg^Em, Gg, Gg^Efm, Gg, Gg, Gs^Vl, Gs^Fds, Gs^Fds, Gg, Gg^Em, Gg, Gg, Gs^Fds, Gs^Fds
Gs^Fds, Gs^Fds, Gll^Fms, Gs^Fds, Gg, Gg^Efm, Gg, Gg, Gg, Gs^Fds, Gg, Gg, Gg^Es, Gll^Fds, Gll^Fds, Gs^Fds, Rb, Gg, Gg, Ww, Gg, Gg, Gg^Em, Gg, Gs^Fds, Gll^Fds, Gll^Fds, Gll^Fds, Gll^Fds, Gs^Fds, Gs^Fds, Gg, Gg, Gg, Gg, Gg, Gg, Gs^Fds, Hh^Fds, Gs^Fds, Gs^Fms, Gs^Fds, Gs^Fds, Gs^Fds, Hh^Fds, Gs^Fds
Gs^Fds, Gs^Fds, Gs^Fds, Gs^Fds, Gg, Gg, Gg, Gs^Fds, Gll^Fds, Gg, Gg, Gg, Gg, Gll^Fds, Gs^Fds, Rb, Gg, Gg, Gg^Em, Ww, Gg, Gg, Gg, Gg, Gg, Gs^Fds, Gs^Fds, Gs^Fds, Gg, Gs^Fds, Gg, Gg, Gg, Gg, Gg, Gg, Gg, Gs^Fds, Gs^Fds, Hh^Fds, Gs^Fds, Gs^Fds, Gs^Fds, Hh^Fds, Hh^Fds, Hh^Fds
Gs^Fds, Gs^Fds, Ce, Ce, Ce, Gg, Gs^Fds, Gs^Fds, Gll^Fds, Gs^Fds, Gg, Gg, Gg, Gg, Rb, Rb, Gg, Gg, Gg, Ww, Ww, Gg, Gg, Gg, Gg^Efm, Gg, Gg, Gg, Gg, Gg, Gg, Gg, Gg, Gg^Em, Gg, Gg, Gg, Gs^Fds, Gg, Gg, Gg, Gs^Fds, Gg, Gs^Fms, Gs^Fds, Gs^Fds
Gg, Gg, Ce, 4 Kea, Ce, Gs^Fds, Gg, Gll^Fds, Gs^Fds, Gs^Vl, Gg, Gg^Efm, Gg, Rb, Gg, Gg, Gg, Gs^Fds, Gs^Fds, Gg, Gg, Ww, Ww, Gg, Gg, Gg, Gg^Efm, Gg, Gg, Gg, Gs^Fds, Gs^Fds, Gs^Fds, Gs^Fds, Gs^Fds, Gg, Gg^Efm, Gg, Gg, Gg, Gg, Gg, Gg, Gs^Fds, Gs^Fds, Gs^Fds
Gs^Fds, Gg, Gg, Ce, Gg, Gs^Fds, Gs^Fds, Gs^Fds, Gg^Em, Gg, Gs^Fds, Gs^Fds, Gs^Fds, Rb, Gg, Gg, Gs^Fds, Gs^Fds, Gll^Fds, Gs^Fds, Gg, Gg, Ww, Gg, Gg, Gg, Gg, Gg, Gs^Fds, Gs^Fds, Gs^Fds, Hh^Fds, Gs^Fds, Gll^Fds, Gs^Fds, Gg, Gg, Gg, Gs^Fds, Gg, Gs^Fds, Gs^Fds, Gg, Gs^Fds, Gg, Gg
Gs^Fds, Gs^Fds, Gs^Fds, Gg, Gg, Gs^Fds, Gg, Gs^Fds, Gg, Gg, Gll^Fds, Gs^Fds, Gs^Fds, Rb, Gg, Gg, Gs^Fds, Gs^Fds, Gll^Fds, Gs^Fds, Gs^Fds, Gg^Em, Ww, Gg, Gg, Gg, Gg^Es, Gg, Gg^Es, Gs^Fds, Gs^Fds, Gs^Fds, Gs^Fds, Gs^Fds, Gg, Gg^Em, Gg, Gs^Fds, Gs^Fds, Gs^Fds, Gg, Gg, Gs^Vl, Gg, Gg, Gg
Gs^Fds, Gll^Fds, Gs^Fms, Gs^Fds, Gg, Gg, Gg, Gg, Gg, Gs^Fds, Gll^Fds, Gll^Fds, Rb, Rb, Gg^Efm, Gg, Gs^Fds, Gs^Fds, Gs^Fds, Gs^Fds, Gs^Fds, Gg, Gg, Ww, Gg, Gg, Gg^Em, Gg, Gg, Gg, Ce, Ce, Ce, Gg, Gg, Gg, Gg^Es, Gg, Gg, Gg, Gg^Es, Gg, Gs^Fds, Gs^Fds, Gs^Fds, Gs^Fds
Gs^Fds, Gs^Fds, Gs^Fds, Gs^Fds, Gg, Gg^Efm, Gg, Gg, Gg^Em, Gs^Fds, Gg, Gs^Fds, Rb, Gg, Gg, Gg, Gg, Gg, Gg^Es, Gs^Fds, Gg, Gg, Gg, Ww, Gg, Gg, Gs^Fds, Gs^Vl, Gg, Gg, Ce, 5 Ke, Ce, Gg, Gs^Fds, Gg, Gg, Gg, Gg, Gg, Gg^Efm, Gg, Gs^Fds, Gs^Fms, Hh^Fds, Hh^Fds
Gs^Fds, Gg, Gg, Gg, Gg^Es, Gg, Gs^Fds, Gg, Gg, Gg, Gg, Rb, Gg, Gg, Gs^Vl, Gs^Fds, Gs^Fds, Gg, Gs^Fds, Gg, Gg, Gg^Efm, Gg, Ww, Gg, Gs^Fds, Gll^Fds, Gs^Fds, Gs^Fms, Gg, Gg, Ce, Gg, Gg, Gs^Fds, Gs^Fds, Gs^Fds, Gs^Fds, Gs^Fds, Gg, Gg, Gg, Gg, Gs^Fds, Hh^Fms, Hh^Fms
Gg, Gg, Gg, Gg, Gs^Fds, Gg, Gll^Fds, Gll^Fds, Gll^Fds, Gs^Fds, Gg, Rb, Gg, Gg^Es, Gs^Fds, Gs^Fds, Gll^Fds, Gs^Fds, Gs^Fds, Gg, Gs^Fds, Gg, Gg, Ww, Ww, Gs^Fds, Gs^Fds, Gll^Fds, Gs^Fms, Gg, Gs^Fds, Gg, Gg^Es, Gg, Gs^Fds, Gs^Fds, Hh^Fms, Gs^Fds, Hh^Fds, Gs^Fds, Gg, Gg, Gg, Gs^Fds, Gs^Fds, Hh^Fds
Gg, Gg, Gg, Gs^Fds, Gs^Fds, Gs^Fds, Gs^Fds, Gll^Fms, Gs^Fds, Gs^Fds, Gs^Fds, Rb, Gs^Fds, Gs^Fds, Gs^Fds, Gs^Fms, Gs^Fds, Gll^Fds, Gs^Fds, Gs^Fds, Gs^Fds, Gs^Fds, Gg, Gg, Ww, Gs^Fds, Gs^Fds, Gs^Fds, Gg, Gs^Fds, Gg, Gg, Gg, Gg, Gg, Hh^Fds, Hh^Fds, Hh^Fds, Hh^Fds, Gs^Fds, Gs^Fds, Gg, Gg, Gg, Gg, Gs^Fds
