border_size=1
usage=map

Gg, Gg, Gg^Efm, Gg, Gs^Fms, Gg, Gg, Gg, Gg, Gg, Gg^Efm, Gg, Gll^Fp, Gg, Gg, Gg, Gg, Gg, Gg^Em, Gg, Gll^Fp, Gll^Fp, Gg, Gg^Efm, Gg, Gg, Gll^Fp, Gg, Gg^Efm, Gll^Fp, Gg, Gg, Gs^Fds, Gs^Fms, Gg, Gg, Gg, Gg, Gs^Fds, Gg
Gs^Fms, Gs^Fms, Gs^Fms, Gs^Efm, Gs^Fms, Gs^Efm, Gg^Vct, Gg, Gg^Efm, Gll^Fp, Gg, Gg, Gs^Fds, Gs^Fds, Gs^Fms, Gg, Gg^Efm, Gg, Gg, Gg, Gs^Fms, Gll^Fp, Gs^Fds, Gll^Fp, Gs^Fds, Gll^Fp, Gs^Fds, Gg, Gg, Gs^Fds, Gs^Fms, Gg^Efm, Gs^Fds, Gs^Fms, Gg^Em, Gg^Efm, Gll^Fp, Gs^Fds, Gg^Vct, Gs^Fds
Gs^Fms, Gg, Gs^Fms, Gg, Gs^Fms, Gs^Fds, Gs^Fms, Gs^Fms, Gg, Gs^Fds, Gs^Fds, Gs^Fms, Gs^Fms, Gs^Fms, Gs^Fds, Gg, Gg, Gs^Fms, Gs^Fms, Gs^Fms, Gg^Vct, Gs^Fms, Gs^Fms, Gs^Fms, Gg, Gg, Gg^Efm, Gs^Fms, Gs^Fms, Gs^Fms, Gs^Fms, Gs^Fds, Gs^Fds, Gs^Fms, Gs^Fms, Gs^Fds, Gll^Fp, Gs^Fds, Gs^Fms, Gs^Fms
Gs^Fms, Gg, Gg, Gs^Fms, Gs^Fds, Gs^Fms, Gs^Fms, Gg^Efm, Gs^Fds, Gll^Fp, Gg^Es, Gs^Fms, Gg^Vct, Gs^Fds, Gs^Fds, Gg^Vct, Gs^Fds, Gg, Gg, Gs^Fms, Gs^Fms, Gs^Fds, Gs^Fms, Gg^Es, Gs^Fms, Gs^Fds, Gs^Fds, Gg^Em, Gs^Fms, Gg^Efm, Gs^Fms, Gs^Fms, Gs^Fms, Gg^Vct, Gs^Fds, Gs^Fms, Gs^Fds, Gll^Fp, Gg, Gg^Efm
Gs^Fms, Gg^Efm, Gg, Gs^Fds, Gs^Fds, Gs^Fds, Gg, Gs^Fds, Gg^Efm, Gg, Gs^Fms, Gg, Gg^Es, Gg, Gg, Gs^Fds, Gs^Fms, Gg^Efm, Gg^Efm, Gs^Fds, Gll^Fp, Gs^Fms, Gs^Fms, Gll^Fp, Gs^Fms, Gg^Vct, Gg^Efm, Gs^Fds, Gs^Fds, Gs^Fms, Gg, Gg^Em, Gs^Fms, Gg, Gg^Efm, Gg, Gg^Em, Gs^Fds, Gs^Fds, Gg
Gg, Gs^Fms, Gs^Fms, Gg^Es, Gg, Gg^Vct, Gs^Fds, Gg, Gs^Fds, Gs^Fms, Gs^Fms, Gs^Fms, Gs^Fds, Gg, Gg^Efm, Gg, Gg, Gg, Gg, Gll^Fp, Gs^Fds, Gs^Fds, Gg, Gs^Fds, Gs^Fms, Gg, Gs^Fms, Gg, Gll^Fp, Gs^Fds, Gll^Fp, Gg^Efm, Gg, Gs^Fms, Gs^Fms, Gg, Gg^Es, Gg, Gg^Efm, Gg
Gg, Gs^Fms, Gs^Fms, Gs^Fms, Gs^Fds, Gs^Fds, Gs^Fds, Gs^Fds, Gg^Vct, Gs^Fds, Gs^Fms, Gs^Fds, Gll^Fp, Gs^Fds, Gs^Fds, Gg, Gs^Fms, Gll^Fp, Gs^Em, Gg^Vct, Gs^Fms, Gg, Gs^Fms, Gg, Gs^Fms, Gs^Fms, Gg, Gg^Efm, Gg, Gg, Gg, Gll^Fp, Gs^Fds, Gg^Vct, Gg, Gg^Efm, Gg, Gs^Fms, Gs^Fds, Gg
Gs^Fms, Gs^Fds, Gg, Gs^Fds, Gg, Gg, Gs^Em, Gg, Gs^Fds, Gg^Es, Gs^Fds, Gs^Fds, Gs^Fds, Gg^Vct, Gs^Fds, Gg, Gg, Gs^Fms, Gs^Fms, Gs^Fms, Gs^Fms, Gs^Fms, Gs^Fms, Gs^Fms, Gs^Fms, Gs^Fms, Gs^Fds, Gg, Gg, Gg^Es, Gg^Efm, Gg, Gs^Fms, Gs^Fms, Gs^Fms, Gs^Fms, Gs^Fms, Gs^Fms, Gs^Fds, Gg^Vct
Gg, Gs^Fms, Gs^Fms, Gg^Vct, Gs^Fds, Gg, Gg, Gs^Fds, Gll^Fp, Gs^Fds, Gg^Efm, Gs^Fds, Gg, Gs^Fms, Gs^Fds, Gs^Fds, Gs^Fms, Gll^Fp, Gg^Efm, Gs^Fms, Gs^Fms, Gs^Fms, Gs^Fms, Gll^Fp, Gs^Fms, Gs^Fms, Gs^Fms, Gs^Fms, Gg^Vct, Gg, Gs^Fds, Gs^Fms, Gg, Gg^Efm, Gg, Gg, Gg, Gg, Gs^Fds, Gs^Fds
Gg, Gg^Em, Gs^Fds, Gs^Fds, Gll^Fp, Gll^Fp, Gg^Efm, Gg^Es, Gs^Fms, Gs^Fms, Gs^Fms, Gs^Fds, Gs^Fds, Gs^Fms, Gs^Fms, Gs^Fds, Gs^Fms, Gg^Efm, Gg^Efm, Gg^Efm, Gg^Efm, Gs^Fms, Gg^Efm, Gg^Efm, Gg^Efm, Gs^Fms, Gs^Fms, Gs^Fds, Gg^Efm, Gg, Gs^Fms, Gs^Fms, Gs^Fms, Gg, Gs^Fms, Gs^Fds, Gs^Fms, Gg^Vct, Gs^Fds, Gs^Fds
Gg, Gs^Fds, Gg, Gs^Fms, Gs^Fms, Gg, Gs^Fds, Gg^Vct, Gg, Gs^Fds, Gg^Vct, Gg, Gg, Gs^Fms, Gg, Gll^Fp, Gs^Fds, Gg^Efm, Gg^Efm, Gg^Efm, Gg^Efm, Gg^Efm, Gg^Efm, Gg^Efm, Gg^Efm, Gg^Efm, Gs^Fms, Gs^Fds, Gg^Vct, Gll^Fp, Gs^Fms, Gs^Fms, Gg^Vct, Gs^Fms, Gg, Gs^Fms, Gs^Fms, Gs^Fms, Gs^Fms, Gs^Fms
Gg, Gll^Fp, Gg^Efm, Gg^Efm, Gg^Vct, Gs^Fms, Gs^Fms, Gs^Fds, Gs^Fds, Gs^Fds, Gg, Gs^Fds, Gg, Gg^Efm, Gs^Fms, Gs^Fms, Gs^Fds, Gg^Efm, Gg^Efm, Gg^Efm, Gg^Efm, Gg^Efm, Gg^Efm, Gg^Efm, Gg^Efm, Gg^Efm, Gll^Fp, Gs^Fms, Gg^Es, Gs^Fds, Gs^Fms, Gs^Fms, Gs^Fms, Gg^Es, Gg^Efm, Gg, Gg^Es, Gs^Fds, Gs^Fds, Gs^Fms
Gg, Gs^Fds, Gs^Fms, Gg, Gs^Fms, Gs^Fms, Gs^Fms, Gg, Gg^Em, Gs^Fds, Gs^Fds, Gs^Fds, Gg, Gg^Vct, Gg, Gs^Fms, Gs^Fms, Gg^Efm, Gg^Efm, Gg^Efm, Gg^Efm, Gg^Efm, Gg^Efm, Gg^Efm, Gg^Efm, Gg^Efm, Gs^Fds, Gll^Fp, Gs^Fms, Gg^Em, Gs^Fms, Gs^Fds, Gs^Fms, Gs^Fms, Gs^Fms, Gg^Es, Gs^Fms, Gs^Fms, Gs^Fds, Gs^Fms
Gg, Gs^Fms, Gs^Fms, Gg, Gs^Fms, Gs^Fms, Gs^Fds, Gs^Fms, Gs^Fms, Gs^Fds, Gs^Fms, Gll^Fp, Gs^Fms, Gs^Fds, Gg, Gs^Fds, Gs^Fms, Gll^Fp, Gs^Fms, Gg^Efm, Gg^Efm, Gg^Efm, Gg^Efm, Gg^Efm, Gll^Fp, Gs^Fms, Gs^Fms, Gs^Fms, Gs^Fms, Gg, Gs^Fms, Gg^Vct, Gg^Efm, Gs^Fms, Gs^Fms, Gg^Vct, Gg^Em, Gg^Efm, Gs^Fms, Gg
Gs^Fms, Gg^Es, Gg^Vct, Gg, Gs^Fms, Gg, Gg, Gs^Fds, Gs^Fms, Gg, Gs^Fds, Gs^Fds, Gs^Fms, Gg^Em, Gs^Fms, Gs^Fms, Gs^Fds, Gs^Fms, Gll^Fp, Gs^Fms, Gll^Fp, Gg^Efm, Gs^Fms, Gs^Fds, Gs^Fms, Gs^Fds, Gll^Fp, Gg, Gg, Gll^Fp, Gs^Fms, Gg, Gg, Gs^Fms, Gs^Fds, Gs^Fms, Gs^Fms, Gs^Fds, Gs^Fms, Gg
Gg, Gs^Fms, Gg^Efm, Gs^Fms, Gs^Fms, Gg^Es, Gg, Gg^Efm, Gg, Gg^Efm, Gs^Fds, Gs^Fds, Gs^Fms, Gg, Gll^Fp, Gs^Fms, Gs^Fms, Gg^Efm, Gg^Efm, Gs^Fms, Gs^Fms, Gs^Fms, Gs^Fms, Gs^Fms, Gg^Efm, Gs^Fms, Gg, Gg^Vct, Gs^Fms, Gs^Fds, Gs^Fds, Gs^Fms, Gs^Fds, Gs^Fds, Gg^Efm, Gg^Vct, Gg, Gs^Fds, Gll^Fp, Gg
Gg, Gg^Es, Gs^Fms, Gs^Fms, Gs^Fms, Gs^Fms, Gs^Fms, Gs^Fms, Gll^Fp, Gg^Vct, Gs^Fms, Gs^Fms, Gg, Gg, Gg^Vct, Gs^Fds, Gs^Fms, Gll^Fp, Gs^Fms, Gg^Efm, Gg^Efm, Gg^Efm, Gg^Efm, Gg^Efm, Gll^Fp, Gg, Gs^Fms, Gg, Gs^Fds, Gs^Fds, Gg^Vct, Gs^Fms, Gg, Gg, Gs^Fms, Gg, Gg^Es, Gs^Fms, Gll^Fp, Gs^Fds
Gs^Fds, Gs^Fds, Gg, Gs^Fms, Gs^Fms, Gg, Gg^Vct, Gs^Fds, Gs^Fds, Gg^Efm, Gs^Fms, Gs^Fms, Gg^Em, Gs^Fms, Gs^Fds, Gg^Em, Gg^Efm, Gs^Fms, Gll^Fp, Gs^Fms, Gg^Vct, Gg^Efm, Gs^Fms, Gs^Fds, Gs^Fms, Gg, Gs^Fms, Gs^Fms, Gg^Efm, Gg, Gs^Fds, Gs^Fds, Gs^Fds, Gs^Fms, Gs^Fms, Gg, Gs^Fms, Gs^Fms, Gs^Fms, Gs^Fds
Gs^Fds, Gs^Fms, Gg^Es, Gs^Fds, Gg, Gg^Efm, Gs^Fds, Gs^Fds, Gs^Fds, Gs^Fds, Gs^Fms, Gs^Fms, Gs^Fms, Gs^Fms, Gs^Fms, Gs^Fms, Gs^Fms, Gs^Fms, Gs^Fms, Gs^Fms, Gs^Fms, Gs^Fms, Gs^Fms, Gs^Fms, Gs^Fms, Gs^Fms, Gg, Gg^Efm, Gs^Fms, Gs^Fds, Gg, Gs^Fds, Gg^Vct, Gg, Gs^Fms, Gg^Efm, Gs^Fms, Gs^Fms, Gs^Fms, Gg
Gg, Gs^Fds, Gs^Fds, Gg^Vct, Gs^Fds, Gg, Gg, Gs^Fms, Gs^Fds, Gll^Fp, Gs^Fds, Gs^Fms, Gs^Fds, Gs^Fds, Gs^Fds, Gs^Fms, Gs^Fms, Gg, Gg^Efm, Gs^Fms, Gs^Fms, Gs^Fms, Gs^Fms, Gs^Fms, Gg^Vct, Gs^Fms, Gs^Fds, Gg, Gs^Fms, Gs^Fms, Gs^Fds, Gs^Fms, Gg, Gs^Fms, Gg^Es, Gg^Efm, Gg^Vct, Gg^Es, Gll^Fp, Gg^Efm
Gg, Gg^Efm, Gs^Fds, Gll^Fp, Gs^Fds, Gs^Fds, Gs^Fms, Gs^Fms, Gll^Fp, Gg, Gg^Vct, Gs^Fds, Gg^Efm, Gs^Fms, Gll^Fp, Gs^Fms, Gg^Es, Gs^Fms, Gs^Fms, Gs^Fms, Gs^Fms, Gs^Fms, Gs^Fms, Gg, Gg, Gll^Fp, Gs^Fms, Gs^Fms, Gs^Fds, Gll^Fp, Gs^Fds, Gg, Gg^Efm, Gs^Fds, Gll^Fp, Gs^Fds, Gs^Fds, Gs^Fds, Gs^Fms, Gg
Gs^Fms, Gs^Fms, Gs^Fms, Gs^Fds, Gg, Gg^Vct, Gg^Es, Gs^Fds, Gg^Es, Gs^Fms, Gs^Fms, Gs^Fds, Gs^Fds, Gll^Fp, Gs^Fds, Gs^Fms, Gg^Vct, Gs^Fms, Gs^Fms, Gg^Vct, Gg, Gg^Efm, Gs^Fms, Gg^Es, Gs^Fms, Gs^Fms, Gs^Fms, Gg^Vct, Gg^Efm, Gs^Fds, Gg, Gg^Em, Gg^Vct, Gs^Fds, Gs^Fms, Gs^Fds, Gg^Efm, Gs^Fds, Gg^Vct, Gg^Efm
Gg, Gs^Fms, Gg, Gs^Fms, Gs^Fms, Gg^Efm, Gs^Fds, Gs^Fms, Gs^Fms, Gs^Fms, Gs^Fds, Gs^Fms, Gs^Fms, Gg, Gs^Fds, Gg, Gs^Fms, Gg^Efm, Gs^Fds, Gs^Fds, Gs^Fms, Gs^Fms, Gs^Fms, Gs^Fds, Gs^Fds, Gg^Em, Gs^Fds, Gs^Fms, Gg, Gs^Fms, Gs^Fms, Gs^Fms, Gs^Fms, Gs^Fms, Gg^Efm, Gg, Gll^Fp, Gs^Fms, Gs^Fds, Gg^Es
Gg, Gs^Fms, Gg, Gg, Gg, Gs^Fms, Gg, Gg^Efm, Gg, Gg, Gg, Gs^Fds, Gs^Fds, Gs^Fms, Gs^Fms, Gs^Fms, Gg, Gg, Gs^Fds, Gs^Fms, Gg, Gs^Fms, Gs^Fms, Gs^Fms, Gg, Gll^Fp, Gs^Fds, Gs^Fds, Gg, Gs^Fms, Gs^Fms, Gs^Fms, Gs^Fms, Gs^Fms, Gs^Fds, Gs^Fms, Gs^Fds, Gs^Fds, Gg, Gs^Fms
