border_size=1
usage=map

Xol, Xol, Xol, Xol, Xol, Xol, Xol, Xol, Xol, Xol, Xol, Xol, Xol, Xol, Xol, Xol, Xol, Xol, Xol, Xol, Xol, Xol, Xol, Xol, Xol, Xol, Xol, Xol, Xol, Xol, Xol, Xol, Xol, Xol, Xol, Xol, Xol, Xol, Xol, Xol, Xol, Xol, Xol, Xol, Xol, Xol
Xol, Xol, Xol, Xol, Xol, Xol, Xol, Xol, Xol, Xol, Xol, Xol, Xol, Xol, Rrc, Xol, Rrc, Xol, Xol, Xol, Xol, Xol, Rrc, Xol, Xol, Xol, Xol, Xol, Xol, Xol, Xol, Xol, Xol, Xol, Xol, Xol, Xol, Xol, Xol, Xol, Xol, Xol, Xol, Xol, Xol, Xol
Xol, Xol, Xol, Xol, Rrc, Qxu, 1 Rrc^Edb, Xol, Xol, Xol, Rrc, Qxu, Rrc^Edb, Xol, Rrc, Rrc, Rrc, Rrc, Xol, Xol, Rrc, Rrc, Rrc, Rrc, Xol, Xol, Xol, Xol, Xol, Xol, Rrc, Qxu, Rrc, Xol, Xol, Xol, Rrc, Qxu, Rrc, Xol, Xol, Xol, Xol, Xol, Xol, Xol
Xol, Xol, Xol, Xol, Xol, Rrc^Edb, Rrc^Edb, Rrc^Edb, Rrc, Rrc, Rrc^Edb, Rrc, Xol, Xol, Xol, Rrc, Xol, Rrc, Rrc, Rrc, Rrc, Rrc, Rrc, Rrc, Rrc, Xol, Xol, Xol, Xol, Xol, Xol, Rrc, Rrc, Rrc, Rrc, Rrc, Rrc, Rrc, Xol, Xol, Xol, Xol, Xol, Xol, Xol, Xol
Xol, Xol, Xol, Xol, Rrc, Rrc^Edb, Rrc, Rrc^Edb, Rrc, Rrc^Edb, Rrc, Rrc^Edb, Rrc, Xol, Xol, Xol, Rrc, Rrc, Xol, Xol, Xol, Rrc, Xol, Xol, Xol, Rrc, Rrc, Xol, Xol, Xol, Rrc, Rrc, Rrc, Rrc, Rrc, Rrc, Rrc, Rrc, Rrc, Xol, Xol, Xol, Xol, Xol, Xol, Xol
Xol, Xol, Xol, Xol, Xol, Qxu, Xol, Xol, Rrc^Edb, Xol, Xol, Qxu, Xol, Xol, Rrc, Rrc, Xol, Xol, Qxu, Xol, Xol, Rrc, Xol, Xol, Qxu, Xol, Xol, Rrc, Rrc, Xol, Xol, Qxu, Xol, Xol, Rrc, Xol, Xol, Qxu, Xol, Xol, Xol, Xol, Xol, Xol, Xol, Xol
Xol, Xol, Xol, Xol, Rrc, Xol, Xol, Xol, Rrc, Xol, Xol, Xol, Rrc, Rrc, Xol, Xol, Xol, Rrc, Rrc, Rrc, Rrc, Rrc, Rrc, Rrc, Rrc, Rrc, Xol, Xol, Xol, Rrc, Xol, Xol, Rrc, Rrc, Xol, Rrc, Rrc, Xol, Rrc, Rrc, Rrc, Xol, Xol, Xol, Xol, Xol
Xol, Xol, Rrc^Edb, Rrc, Rrc^Edb, Rrc^Edb, Rrc^Edb, Rrc, Rrc^Edb, Xol, Rrc, Rrc, Rrc, Xol, Rrc, Xol, Xol, Xol, Rrc, Rrc, Rrc, Rrc, Rrc, Rrc, Rrc, Xol, Xol, Xol, Rrc, Rrc, Rrc, Rrc, Xol, Xol, Rrc, Xol, Rrc, Rrc, Xol, Xol, Xol, Rrc, Xol, Xol, Xol, Xol
Xol, Xol, Xol, Rrc, Rrc^Edb, Rrc^Ii, Rrc^Edb, Rrc, Rrc, Rrc, Xol, Rrc, Rrc, Rrc, Rrc, Rrc, Xol, Rrc, Qxu, Rrc, Xol, Xol, Xol, Rrc, Qxu, Rrc, Xol, Rrc, Rrc, Rrc, Rrc, Xol, Xol, Xol, Rrc, Rrc, Rrc, Rrc, Xol, Xol, Xol, Rrc, Xol, Xol, Xol, Xol
Xol, Xol, Xol, Xol, Xol, Rrc, Xol, Xol, Xol, Xol, Xol, Xol, Xol, Rrc, Rrc, Rrc, Rrc, Xol, Xol, Xol, Rrc, Rrc, Rrc, Xol, Xol, Xol, Xol, Xol, Xol, Rrc, Rrc, Rrc, Xol, Xol, Xol, Rrc, Rrc, Rrc, Xol, Xol, Xol, Rrc, Xol, Xol, Xol, Xol
Xol, Xol, Xol, Xol, Xol, Xol, Xol, Xol, Xol, Xol, Xol, Xol, Xol, Xol, Xol, Xol, Xol, Xol, Xol, Xol, Xol, Xol, Rrc, Xol, Xol, Xol, Xol, Xol, Xol, Xol, Xol, Xol, Xol, Xol, Xol, Xol, Xol, Xol, Xol, Xol, Xol, Rrc, Xol, Xol, Xol, Xol
Xos, Xos, Xos, Xos, Xos, Xos, Xos, Xos, Xos, Xos, Xos, Xos, Xos, Xos, Xos, Xos, Xos, Xos, Xos, Xos, Xos, Xos, Rrc, Xos, Xos, Xos, Xos, Xos, Xos, Xos, Xos, Xos, Xos, Xos, Xos, Xos, Xos, Xos, Xos, Xos, Xos, Rrc, Xos, Xos, Xos, Xos
Xos, Xos, Xos, Xos, Xos, Xos, Xos, Xos, Gs^Fds, Gs^Fds, Gs^Fds, Gs^Fds, Gs^Fds, Gs^Fds, Gs^Fds, Gs^Fds, Xos, Xos, Xos, Xos, Gs^Fms, Gs^Fds, Rrc, Gs^Fds, Gs^Fds, Gs^Fds, Xos, Xos, Xos, Xos, Xos, Xos, Gg, Gg, Gg^Fet, Gg, Gg, Gg, Xos, Gg, Gg, Rrc, Gg, Gg^Fet, Gs^Fds, Xos
Xos, Xos, Xos, Xos, Xos, Xos, Xos, Xos, Gs^Fds, Gs^Fms, Rrc, Gs^Fms, Gs^Fds, Gs^Fms, Gs^Fds, Xos, Xol, Xos, Xos, Xol, Gs^Fds, Gs^Fds, Rrc^Ii, Gs^Fds, Xol, Xos, Xos, Xos, Xos, Xos, Rrc, Gg, Gs^Fds, Gg, Gg, Gg, Xos, Xos, Xos, Gs^Fms, Rrc, Rrc, Rrc, Rrc, Rrc, Gs^Fds
Xos, Xos, Xos, Xos, Xos, Xos, Rrc, Gs^Fds, Rrc, Rrc, Gg, Rrc, Rrc, Gs^Fds, Gs^Fds, Gg, Gg^Ii, Xol, Xol, Xol, Gg^Ii, Gg^Fet, Rrc^Ii, Gs^Fms, Gs^Fds, Xol, Xol, Xos, Rrc, Rrc, Gg, Rrc, Rrc, Gs^Fms, Gg, Xos, Xos, Xos, Xos, Rrc, Gs^Fds, Gs^Fds, Gs^Fds, Xos, Xos, Rrc
Xos, Xos, Xos, Xos, Rrc, Rrc, Gg, Rrc, Gg, Gg, Gg, Gg, Gg, Rrc, Rrc, Gg^Fet, Gs^Fds, Gg^Ii, Rrc^Ii, Rrc^Ii, Rrc^Ii, Rrc^Ii, Rrc^Ii, Gs^Fds, Gg^Ii, Gs^Fds, Gg, Gg, Rrc, Gg, Gg, Gg, Rrc, Gs^Fms, Gs^Fds, Xos, Xos, Xos, Xol, Rrc, Gs^Fds, Gs^Fms, Xos, Xos, Xos, Xos
Xos, Xos, Gs^Fds, Gs^Fds, Rrc, Gg, Xos, Gg^Fet, Xos, Xos, Xos, Xos, Gs^Fds, Gs^Fds, Rrc, Gg, Rrc^Ii, Rrc^Ii, Gs^Fms, Gs^Fds, Gg^Ii, Gg^Ii, Gg^Ii, Rrc^Ii, Rrc^Ii, Gg^Ii, Rrc, Rrc, Xos, Xos, Xos, Xos, Xos, Rrc, Rrc^Ii, Xol, Xol, Xol, Rrc, Rrc, Gs^Fms, Gs^Fds, Gs^Fds, Xos, Xos, Xos
Xos, Gs^Fds, Gs^Fds, Rrc, Gg, Xos, Xos, Xos, Xos, Xos, Xol, Gg, Gs^Fms, Gs^Fms, Gg^Ii, Rrc, Gg, Gs^Fds, Gg^Ii, Gg^Ii, Xol, Xol, Xol, Gg^Ii, Gg^Ii, Rrc, Gg, Xos, Xos, Xos, Xos, Xos, Xos, Xol, Gs^Fds, Rrc^Ii, Gs^Fds, Gs^Fds, Rrc^Ii, Gs^Fds, Gs^Fds, Gs^Fds, Gg^Fet, Xos, Xos, Xos
Gs^Fds, Gs^Fds, Rrc, Rrc, Gg, Xos, Xos, Xos, Xos, Xos, Xol, Gs^Fds, Gs^Fds, Gs^Fds, Rrc^Ii, Rrc^Ii, Rrc, Gg, Gg, Xol, Xos, Xos, Xol, Gg^Ii, Gs^Fds, Rrc, Gg, Gs^Fds, Xos, Xos, Gs^Fds, Xos, Gg, Gg^Fet, Gs^Fds, Rrc^Ii, Rrc^Ii, Rrc^Ii, Gg^Ii, Rrc^Ii, Rrc, Gg, Rrc, Gs^Fds, Gs^Fds, Xos
Rrc, Rrc, Gs^Fds, Rrc, Rrc, Gs^Fds, Gs^Fds, Gs^Fds, Gs^Fds, Xol, Gg^Ii, Gg^Ii, Rrc^Ii, Rrc^Ii, Gg^Ii, Gg^Ii, Rrc, Gs^Fds, Gg, Xol, Xos, Xos, Xos, Xos, Gs^Fds, Rrc, Rrc, Gg, Gs^Fds, Gs^Fds, Gs^Fds, Gs^Fds, Gs^Fds, Gs^Fds, Rrc^Ii, Rrc^Ii, Gs^Fds, Gg^Ii, Xol, Gg, Gs^Fds, Rrc, Gg, Gs^Fds, Rrc, Gg
Xos, Gs^Fds, Gg, Gs^Fms, Gs^Fds, Rrc, Rrc, Gs^Fms, Rrc^Ii, Rrc^Ii, Rrc^Ii, Rrc^Ii, Gg^Ii, Gg^Fet, Gg^Ii, Gg^Ii, Rrc, Gs^Fds, Xos, Xos, Xos, Xos, Xos, Xos, Xos, Gs^Fds, Gs^Fds, Rrc, Rrc, Gs^Fds, Gs^Fds, Gs^Fds, Rrc, Rrc, Gg, Gs^Fds, Xol, Xol, Xos, Xos, Gg, Gg, Xos, Gs^Fds, Gs^Fds, Rrc
Xos, Xos, Xos, Gg, Gg^Fet, Gs^Fds, Gs^Fms, Rrc, Gs^Fms, Gg^Ii, Xos, Gg^Ii, Xos, Gg^Ii, Gs^Fds, Gs^Fds, Rrc, Gs^Fds, Gs^Fds, Xos, Xos, Xos, Xos, Xos, Gs^Fds, Gs^Fds, Rrc, Rrc, Gs^Fds, Rrc, Rrc, Rrc, Rrc^Ii, Rrc^Ii, Xol, Xol, Xos, Xos, Xos, Xos, Gs^Fds, Gs^Fds, Xos, Xos, Xos, Gs^Fds
Xos, Xos, Xos, Gg, Gg, Gg, Gg, Rrc, Gs^Fds, Xos, Xos, Xos, Xos, Xos, Gs^Fds, Gs^Fds, Rrc, Gs^Fds, Gs^Fds, Xos, Xos, Xos, Gg, Gg, Gg^Fet, Rrc, Gs^Fms, Gs^Fds, Gg, Xos, Xol, Rrc^Ii, Gs^Fds, Rrc^Ii, Rrc^Ii, Xol, Xol, Xos, Gg, Gg, Gs^Fds, Gs^Fds, Gs^Fms, Xos, Xos, Xos
Xos, Xos, Xos, Xos, Xos, Gs^Fds, Rrc, Rrc, Gs^Fds, Xos, Xos, Xos, Xol, Xol, Gs^Fds, Gs^Fms, Gs^Fds, Rrc, Gs^Fds, Gg, Gg, Xos, Gg, Gg, Gs^Fms, Rrc, Gs^Fds, Gg, Xos, Xos, Xos, Xol, Rrc^Ii, Rrc^Ii, Gs^Fds, Rrc^Ii, Rrc^Ii, Gs^Fds, Gs^Fds, Gs^Fds, Gg^Fet, Gs^Fds, Gs^Fds, Xos, Xos, Xos
Xos, Xos, Xol, Xos, Gs^Fds, Gs^Fms, Rrc, Gs^Fms, Gs^Fds, Gg, Gg, Xol, Gs^Fds, Xol, Rrc, Rrc^Ii, Rrc^Ii, Rrc^Ii, Rrc, Gs^Fds, Gs^Fms, Gg, Gs^Fds, Gs^Fds, Rrc^Ii, Rrc^Ii, Gg^Ii, Xol, Xos, Xos, Xos, Xol, Xos, Gg^Fet, Gs^Fds, Gs^Fms, Rrc^Ii, Gs^Fds, Gs^Fds, Gs^Fds, Gs^Fms, Gs^Fds, Xos, Xos, Xos, Xos
Xol, Xol, Gs^Fds, Gs^Fms, Rrc^Ii, Rrc, Xos, Gg, Xol, Xol, Gg^Ii, Gs^Fds, Rrc^Ii, Rrc^Ii, Gg^Ii, Gg^Ii, Gg^Ii, Gg^Ii, Gs^Fds, Rrc, Rrc, Gs^Fds, Rrc, Rrc^Ii, Gg^Ii, Rrc^Ii, Rrc^Ii, Xol, Xos, Xos, Xos, Xos, Gg, Gg, Gs^Fms, Rrc, Gg, Gg, Xos, Gs^Fds, Gs^Fds, Gs^Fds, Xos, Xos, Xos, Xos
Gg^Ii, Gg^Ii, Rrc^Ii, Rrc^Ii, Xos, Xos, Xos, Xos, Xol, Gg^Ii, Gg^Fet, Gs^Fds, Rrc^Ii, Gg^Ii, Xol, Xol, Xol, Xol, Gg, Gs^Fds, Gs^Fms, Rrc, Gg, Gg^Ii, Gg^Ii, Gg^Ii, Gg^Ii, Rrc^Ii, Gg, Xos, Xos, Xos, Gs^Fds, Gs^Fds, Gs^Fds, Rrc, Gg, Gs^Fds, Xos, Xos, Xos, Xos, Xos, Xos, Xos, Gs^Fds
Rrc^Ii, Rrc^Ii, Gs^Fds, Gs^Fds, Xos, Xos, Xos, Xos, Gs^Fds, Gs^Fds, Rrc^Ii, Rrc^Ii, Xol, Xol, Xos, Xos, Xos, Xos, Gg, Gs^Fds, Gs^Fds, Rrc, Gg^Efm, Gg, Xos, Xos, Xos, Rrc, Rrc, Gg, Rrc, Rrc, Rrc, Gs^Fds, Rrc, Rrc, Xos, Xos, Xos, Xos, Xos, Xos, Xos, Xos, Gs^Fds, Gs^Fds
Gg^Ii, Rrc^Ii, Rrc, Xos, Xos, Xos, Gs^Fds, Gs^Fds, Rrc, Rrc^Ii, Gg^Ii, Xol, Xos, Xos, Xos, Xos, Gg, Gg, Gs^Fds, Gs^Fms, Rp, Rrc, Gg^Efm, Xos, Xos, Xos, Xos, Gg, Gg, Rrc, Gs^Fds, Gs^Fds, Xos, Rrc, Xos, Xos, Xos, Xos, Xos, Xos, Xos, Xos, Xos, Gg^Efm, Gs^Fms, Gg^Efm
Gs^Fds, Gs^Fds, Gg, Rrc, Rrc, Gg, Rrc, Rrc, Gg, Gg, Gg^Fet, Xol, Gg, Xos, Gs^Fds, Gs^Fms, Gs^Fms, Gg^Efm, Rp, Rp, Gs^Fds, Rrc, Gg^Efm, Xos, Xos, Xos, Xos, Xos, Xos, Xos, Xos, Xos, Xos, Xos, Xos, Xos, Gs^Fms, Gg, Gg^Efm, Xos, Xos, Xos, Xos, Gs^Fds, Rp, Rp
Gs^Fds, Xos, Xos, Xos, Gg, Rrc, Gs^Fds, Rp, Rp, Gg^Efm, Rp, Gg, Gg^Efm, Gs^Fds, Rp, Rp, Rp, Rp, Gs^Fms, Gs^Fds, Gs^Fds, Rrc, Rrc, Gs^Fds, Gs^Fds, Xos, Xos, Xos, Xos, Xos, Xos, Xos, Xos, Xos, Gs^Fds, Gs^Fds, Rp, Gg, Gs^Fms, Gs^Fds, Gs^Fds, Gg^Efm, Gg^Efm, Gs^Fds, Rp, Gg^Efm
Gs^Fms, Xos, Xos, Xos, Xos, Gg, Gs^Fds, Gs^Fms, Rp, Rp, Gs^Fds, Rp, Rp, Rp, Gs^Fds, Gs^Fds, Gg^Efm, Gs^Fds, Gs^Fds, Gs^Fds, Gg^Efm, Gg^Efm, Gs^Fds, Rrc, Rrc, Gs^Fds, Gg^Efm, Gg^Efm, Gs^Fds, Gs^Fds, Rp, Rp, Rp, Rp, Rp, Rp, Gs^Fds, Rp, Rp, Gs^Fds, Gg^Efm, Gg^Efm, Gg^Fet, Rp, Gg^Efm, Gg^Efm
Gs^Fds, Xos, Xos, Xos, Xos, Xos, Gs^Fds, Gs^Fds, Rp, Gg^Efm, Gg^Fet, Gs^Fds, Gs^Fms, Gs^Fds, Gs^Fds, Gg^Efm, Gg^Efm, Gg^Fet, Gs^Fds, Gg^Efm, Gg^Efm, Gg^Efm, Gs^Fds, Gs^Fms, Rrc, Gs^Fds, Rp, Gg^Efm, Rp, Rp, Gg^Efm, Gg^Efm, Gg^Efm, Gs^Fds, Gs^Fds, Gs^Fds, Gs^Fds, Gs^Fds, Gg^Efm, Rp, Rp, Gg^Efm, Rp, Rp, Gs^Fds, Gg^Efm
Rrc, Gs^Fds, Gs^Fms, Xos, Xos, Xos, Gg^Efm, Gs^Fms, Rp, Gg^Efm, Gg^Efm, Gs^Fds, Gg^Efm, Gs^Fds, Gs^Fms, Gs^Fds, Gg^Efm, Gs^Fms, Gs^Fms, Gg^Efm, Gg^Efm, Gs^Fds, Gs^Fms, Gs^Fds, Gs^Fds, Rrc, Gg^Efm, Rp, Gg^Efm, Gg^Fet, Gs^Fds, Gs^Fds, Gg^Efm, Gs^Fms, Gs^Fms, Gs^Fds, Gs^Fds, Gg^Efm, Gs^Fds, Gs^Fds, Gg^Efm, Rp, Gg^Efm, Gs^Fds, Gs^Fms, Gs^Fds
Gs^Fds, Rrc, Rrc, Gg^Efm, Gg, Gg, Gg, Gs^Fds, Rp, Gg^Efm, Gg^Efm, Gg^Efm, Gs^Fds, Gs^Fds, Gs^Fds, Gs^Fds, Gs^Fds, Gs^Fms, Gg, Gs^Fds, Gg, Gs^Fds, Gg, Gs^Fds, Gg, Rrc, Rrc, Gg^Efm, Gg, Gs^Fds, Gg, Gs^Fms, Gg, Gs^Fds, Gs^Fds, Gg^Efm, Gs^Fds, Gs^Fms, Gs^Fds, Gs^Fds, Gg, Rp, Gg, Gs^Fds, Gs^Fds, Gs^Fds
