border_size=1
usage=map

Mm, Mm, Mm, Mm, Mm, Hh^Fds, Hh^Fms, Hh^Fms, Hh^Fms, Hh^Fds, Hh^Fds, Hh^Fds, Hh^Fds, Gs^Fds, Hh^Fds, Gs^Fds, Gs^Fds, Gs^Fds, Gs^Fds, Gg, Gg, Rp, Gg, Gg, Gs^Fds, Gs^Fds, Gs^Fds, Hh^Fds, Hh^Fms, Hh^Fds, Hh^Fds, Hh^Fds, Hh^Fds, Gs^Fds, Mm, Mm, Mm, Mm, Mm, Gs^Fds
Mm, Mm, Mm, Mm, Hh^Fms, Hh^Fds, Hh^Fms, Hh^Fds, Hh^Fds, Hh^Fds, Gs^Fds, Hh^Fms, Gs^Fms, Hh^Fds, Gs^Fds, Hh^Fds, Gs^Fds, Gs^Fds, Gs^Fds, Gg, Gg^Efm, Rp, Rp, Gg, Gg^Em, Gs^Fds, Gg^Vl, Hh^Fds, Hh^Fds, Hh^Fds, Hh^Fms, Hh^Fds, Hh^Fds, Hh^Fds, Hh^Fms, Mm, Mm, Mm, Mm, Mm
Mm, Mm, Mm, Mm, Hh^Fms, Gs^Fds, Gs^Fms, Gs^Fds, Gs^Fms, Gs^Fds, Gs^Fds, Gs^Fds, Gg, Gs^Fds, Gg, Gs^Fds, Gg, Gs^Fds, Gg, Gg, Gg, Gg, 1 Rp, Gg, Gg, Gg, Gg, Gg, Gg, Gs^Fms, Gg^Em, Hh^Fds, Gs^Fms, Hh^Fds, Gs^Fds, Hh^Fms, Hh^Fds, Hh^Fds, Mm, Mm
Gs^Fds, Hh^Fms, Hh^Fms, Hh^Fms, Gs^Fds, Gs^Fds, Hh^Fds, Gs^Fds, Gs^Fds, Gs^Fds, Gg, Gg^Em, Gg^Em, Gg^Efm, Gg^Efm, Gg, Gg, Gg^Vl, Gg, Gg^Em, Gg^Es, Gg, Rp, Gg^Es, Gg, Gs^Fds, Gs^Fds, Gg, Gs^Fds, Gg, Gg, Gg, Gg^Es, Gs^Fds, Gs^Fds, Hh^Fms, Hh^Fms, Hh^Fms, Mm, Mm
Gs^Fds, Hh^Fms, Gs^Fds, Hh^Fms, Gs^Fds, Gs^Fds, Hh^Fds, Gs^Fds, Gs^Fms, Gg^Es, Gg, Gg^Em, Gs^Fds, Gg, Gg, Gg, Gg, Gg, Gg^Es, Gg, Gg, Rp, Gg, Gg, Gg^Efm, Gs^Fds, Gs^Fms, Gs^Fds, Hh^Fds, Hh^Fds, Hh^Fms, Gs^Fds, Gg, Gs^Fds, Gs^Fms, Hh^Fds, Hh^Fds, Hh^Fds, Mm, Mm
Gs^Fds, Gs^Fds, Gs^Fds, Gg^Vl, Gg, Gs^Fds, Gs^Fds, Gs^Fds, Gg, Gg, Gs^Fds, Gs^Fds, Gs^Fds, Gs^Fds, Gs^Fds, Gs^Fds, Gg, Gg, Gg^Efm, Gg, Gg, Rp, Gg, Gg, Gg, Gg, Gs^Fds, Gs^Fds, Hh^Fms, Mm, Hh^Fms, Gs^Fds, Gs^Fds, Gg^Em, Gg, Gs^Fds, Hh^Fds, Hh^Fds, Hh^Fds, Mm
Gg, Gg, Gg^Em, Gg, Gs^Fds, Gg, Gg, Gg, Gg^Efm, Gg^Efm, Gs^Fds, Hh^Fds, Hh^Fds, Gs^Fds, Gs^Fms, Gs^Fds, Gs^Fds, Gs^Fds, Gg, Gg^Efm, Rp, Rp, Rb^Gvs, Rb^Gvs, Rb^Gvs, Rb^Gvs, Rb^Gvs, Gs^Fds, Gs^Fds, Gs^Fds, Hh^Fds, Hh^Fds, Gs^Fms, Gg, Gg^Efm, Gg, Gg^Vl, Gs^Fds, Gs^Fms, Gs^Fds
Gg^Em, Gg^Em, Gg, Gg^Es, Gs^Fds, Gs^Fds, Gs^Fms, Gg, Gg, Gs^Fds, Gs^Fms, Hh^Fms, Hh^Fds, Gs^Fds, Gs^Fms, Gs^Fds, Gs^Fds, Gs^Fds, Gs^Fds, Rp, Rb^Gvs, Rb^Gvs, Rb^Gvs, Rb^Gvs, Rb^Gvs, Rb^Gvs, Gs^Fds, Rb^Gvs, Rb^Gvs, Gs^Fds, Gs^Fds, Gs^Fds, Rb^Gvs, Gg, Gg^Efm, Gg, Gg, Gs^Fds, Gs^Fds, Gs^Fds
Gs^Fds, Gg, Gs^Fms, Gs^Fds, Hh^Fds, Hh^Fds, Hh^Fds, Gs^Fds, Rb^Vh, Gs^Fds, Gs^Fds, Hh^Fds, Gs^Fds, Hh^Fds, Gs^Fds, Gs^Fds, Gs^Fds, Gs^Fms, Gs^Fds, Rp, Rb^Gvs, Rb^Gvs, Rb^Gvs, Gs^Fds, Gs^Fms, Gs^Fds, Hh^Fds, Gs^Fds, Rb^Vh, Rb^Gvs, Rb^Gvs, Rb^Gvs, Rb^Gvs, Gg, Gg, Gg, Gs^Fds, Gg^Es, Gg, Gg
Gs^Fds, Gs^Fms, Gs^Fms, Gs^Fms, Hh^Fds, Mm, Hh^Fms, Gs^Fds, Rb^Gvs, Gs^Fds, Gs^Fds, Gs^Fms, Gs^Fds, Gs^Fds, Gs^Fds, Gs^Fds, Hh^Fms, Hh^Fds, Hh^Fds, Rp, Rp, Rb^Vh, Rb^Gvs, Gs^Fds, Gs^Fds, Gs^Fds, Hh^Fms, Hh^Fds, Hh^Fms, Rb^Gvs, Rb^Gvs, Rb^Gvs, Rb^Gvs, Gs^Fds, Gs^Fds, Gs^Fds, Hh^Fds, Gs^Fds, Gs^Fds, Gs^Fds
Gs^Fds, Gs^Fds, Gs^Fds, Gs^Fds, Hh^Fds, Hh^Fms, Gs^Fds, Gs^Fds, Gs^Fds, Rb^Gvs, Rb^Gvs, Rb^Gvs, Rb^Gvs, Gs^Fds, Gs^Fds, Hh^Fds, Hh^Fds, Hh^Fds, Hh^Fds, Hh^Fds, Rp, Rb^Gvs, Rb^Gvs, Gs^Fds, Gs^Fds, Gs^Fms, Hh^Fds, Mm, Hh^Fds, Gs^Fds, Gs^Fds, Rb^Gvs, Rb^Gvs, Gs^Fds, Gs^Fds, Hh^Fds, Hh^Fds, Gs^Fms, Gs^Fds, Gs^Fds
Gs^Fds, Ss, Sm, Gs^Fms, Gs^Fms, Gs^Fds, Hh^Fds, Gs^Fds, Gs^Fds, Rb^Gvs, Rb^Gvs, Rb^Vh, Rb^Gvs, Gs^Fds, Gs^Fds, Hh^Fds, Hh^Fds, Hh^Fds, Rp, Rp, Rp^Vhh, Rb^Gvs, Rb^Gvs, Gs^Fds, Gs^Fds, Gs^Fds, Gs^Fds, Hh^Fms, Gs^Fms, Gs^Fds, Rb^Gvs, Rb^Gvs, Gs^Fds, Gs^Fds, Hh^Fds, Hh^Fds, Hh^Fms, Gs^Fds, Gs^Fds, Gs^Fds
Ww, Gs^Fds, Gs^Fds, Gs^Fds, Gs^Fds, Hh^Fms, Hh^Fds, Hh^Fds, Hh^Fds, Gs^Fds, Gs^Fms, Rb^Gvs, Rb^Gvs, Rb^Gvs, Rb^Gvs, Gs^Fds, Rp^Vhh, Rp, Rp^Vhh, Rp, Rp^Vhh, Rb^Gvs, Rb^Gvs, Rb^Gvs, Rb^Gvs, Gs^Fds, Rb^Gvs, Gs^Fds, Gs^Fds, Gs^Fds, Rb^Vh, Rb^Gvs, Gs^Fds, Gs^Fms, Hh^Fds, Gs^Fds, Hh^Fds, Hh^Fds, Gs^Fds, Gs^Fds
Gs^Fds, Ww, Sm, Ss, Sm, Hh^Fms, Hh^Fds, Hh^Fds, Gs^Fds, Gs^Fds, Gs^Fds, Rb^Gvs, Rb^Gvs, Rb^Gvs, Rp, Rp, Rp, Rp, Rp, Rp, Rp, Rb^Gvs, Gs^Fds, Gs^Fds, Rb^Gvs, Rb^Gvs, Rb^Gvs, Rb^Gvs, Rb^Gvs, Rb^Gvs, Ss, Rb^Gvs, Gs^Fds, Gs^Fds, Hh^Fds, Hh^Fds, Gs^Fms, Hh^Fds, Gs^Fms, Gs^Fds
Gs^Fds, Ww, Ww, Ss, Gs^Fds, Sm, Sm^Vhr, Gs^Fds, Gs^Fms, Gs^Fds, Rb^Gvs, Rb^Gvs, Rp, Rp, Ss, Gs^Fds, Gs^Fds, Rp^Vhh, Rp, Rp, Gs^Fds, Gs^Fds, Gs^Fds, Gs^Fds, Gs^Fds, Ss, Sm^Vhr, Rb^Gvs, Sm, Ss, Sm, Sm, Ss, Gs^Fds, Gs^Fds, Gs^Fms, Gs^Fds, Gs^Fds, Gs^Fds, Gs^Fds
Ss, Sm, Gs^Fds, Ww, Ww, Ww, Ww, Ss, Ww, Ss, Rp, Rp, Ss, Ss, Gs^Fds, Ss, Gs^Fds, Gs^Fds, Gs^Fds, Gs^Fms, Sm, Gs^Fds, Ss, Gs^Fds, Ss, Ss, Gs^Fds, Sm, Ss, Ss, Gs^Fds, Ss, Sm, Sm, Ss, Gs^Fds, Sm, Ss, Sm, Ss
Ss, Ss, Ss, Gs^Fms, Sm, Ss, Gs^Fds, Ww, Rp, Ww^Bw/, Ww, Ss, Ww, Ss, Ss, Ss, Ss, Gs^Fds, Ss, Gs^Fds, Ss, Sm, Gs^Fds, Sm, Gs^Fds, Ss, Gs^Fms, Gs^Fds, Gs^Fds, Sm, Ss, Gs^Fms, Gs^Fds, Ss, Gs^Fds, Ss, Gs^Fds, Sm, Sm, Sm
Ss, Sm, Gs^Fms, Ss, Gs^Fds, Ss, Sm, Ss, Sm, Ss^Bw\, Rp, Ww, Ss, Ww, Ww, Sm, Ss, Ss, Ss, Sm, Gs^Fds, Gs^Fms, Ss, Ss, Ss, Gs^Fds, Ss, Gs^Fds, Ww, Ww, Ww, Ww, Ww, Ss, Gs^Fds, Gs^Fms, Gs^Fds, Gs^Fds, Ss, Ss
Gs^Fds, Ss, Ss, Ss, Gs^Fms, Gs^Fds, Ss, Gs^Fds, Gs^Fms, Ss, Ss, Ss^Bw\, Rr, Sm, Gs^Fds, Ww, Ww, Ss, Ww^Dr, Ss, Sm, Sm^Vhr, Ss, Sm, Sm, Sm, Sm, Ww, Gs^Fds, Gs^Fds, Ss, Gs^Fds, Ss, Ww, Ww^Dr, Ss, Sm, Gs^Fds, Ss, Gs^Fds
Gs^Fds, Gs^Fds, Gs^Fds, Gs^Fds, Gs^Fds, Gs^Fds, Sm, Sm, Gs^Fds, Gs^Fds, Sm, Gs^Fds, Sm, Rr, Sm, Gs^Fds, Gs^Fms, Ww, Ss, Ss, Ss, Ss, Ss, Ss, Sm, Ss, Ss, Ww, Gs^Fds, Gs^Fds, Rr, Gs^Fds, Gs^Fms, Sm, Ss, Ww, Ww, Ww, Ww, Gs^Fds
Gs^Fds, Sm, Gs^Fds, Sm, Sm, Gs^Fds, Ss, Sm, Ss, Ss, Ss, Gs^Fms, Ss, Rr, Rr, Gs^Fds, Ss, Ww, Ss, Sm, Ss, Ss, Gs^Fds, Gs^Fds, Gs^Fds, Gs^Fds, Gs^Fds, Ww, Ww, Rr, Ss, Rr, Rr, Gs^Fds, Ss, Gs^Fds, Gs^Fms, Gs^Fds, Sm, Ww
Gs^Fds, Sm, Ss, Gs^Fds, Ss, Ss, Gs^Fds, Gs^Fds, Gs^Fds, Gs^Fds, Gs^Fds, Gs^Fds, Rr, Ss^Bw/, Ss, Ss^Bw\r, Ww^Bw\r, Ww, Gs^Fds, Ss, Ss, Gs^Fds, Gs^Fds, Sm, Gs^Fds, Ss, Ss, Gs^Fds, Ss, Ww^Dr, Ww, Ss, Ss, Rr, Rr, Gs^Fds, Gs^Fms, Gs^Fds, Gs^Fds, Ss
Ss, Sm, Ss, Ss, Gs^Fds, Gs^Fms, Gs^Fds, Gs^Fds, Gs^Fms, Gs^Fms, Gs^Fds, Rr, Ss, Gs^Fds, Ww, Ww, Gs^Fds, Ss^Bw\r, Rp, Ss, Rp, Ss, Ss, Gs^Fms, Ss, Sm, Gs^Fds, Gs^Fds, Gs^Fds, Ss, Sm, Ww, Gs^Fds, Gs^Fds, Gs^Fds, Rr, Rr, Gs^Fds, Gs^Fds, Ss
Ss, Sm, Gs^Fds, Gs^Fds, Gs^Fds, Gs^Fds, Gs^Fds, Gs^Fds, Gs^Fds, Gs^Fds, Rr, Rr, Gs^Fds, Gs^Fds, Ww, Gs^Fds, Gs^Fds, Ss, Ss, Rp, Ss, Rp, Rp, Ss, Gs^Fds, Ss, Sm, Gs^Fms, Ss, Ss, Gs^Fds, Ww, Gs^Fds, Ss, Gs^Fds, Sm, Rr, Gs^Fds, Ss, Ss
Ss, Sm, Gs^Fds, Gs^Fms, Gs^Fds, Gs^Fds, Gg^Em, Gs^Fds, Gg^Emf, Rr, Gs^Fds, Ss, Gs^Fds, Ss, Ww, Gs^Fds, Ss, Gs^Fds, Gs^Fds, Ss, Rp, Ss^Bw/r, Ss, Ss, Gs^Fds, Ss, Gs^Fds, Ss, Sm, Gs^Fms, Ww, Ww, Gs^Fds, Ss, Gs^Fms, Sm, Rr, Gs^Fds, Gs^Fds, Gs^Fds
Sm, Ss, Gs^Fds, Gs^Fms, Gs^Fds, Gs^Fds, Gg^Emf, Gg^Em, Rr, Rr, Gs^Fds, Gs^Fds, Gs^Fds, Gs^Fds, Ww, Gs^Fds, Gs^Fds, Gs^Fds, Gs^Fds, Gs^Fds, Gs^Fds, Rp, Rp, Ss, Ss, Gs^Fds, Ss, Gs^Fds, Ss, Gs^Fds, Ww, Gs^Fds, Sm, Gs^Fds, Gs^Fds, Rr, Gs^Fds, Gs^Fds, Ss, Gs^Fds
Sm, Sm, Gs^Fds, Gs^Fds, Gs^Fds, Gg^Em, Gg^Emf, Rr, Gg^Emf, Gg^Em, Gs^Fds, Ss, Gs^Fds, Ss, Ss, Ww, Ww, Ss, Gs^Fds, Ss, Gs^Fds, Ss, Rp, Ss, Sm, Gs^Fds, Ww, Gs^Fds, Ww^Dr, Ww, Gs^Fds, Ss, Gs^Fds, Gs^Fds, Ss, Rr, Sm, Gs^Fms, Gs^Fds, Gs^Fds
Gs^Fms, Sm, Ss, Gs^Fds, Gs^Fms, Gg^Emf, Gg^Em, Rr, Rr, Gg^Emf, Gs^Fds, Ss, Gs^Fms, Ss, Ss, Gs^Fds, Ss, Ww, Gs^Fds, Sm, Ss, Gs^Fds, Ww, Ww^Bw\r, Ww^Bw\r, Ww, Ss, Ww, Ss, Gs^Fds, Ss, Ss, Gs^Fds, Ss, Rr, Rr, Gs^Fds, Gs^Fds, Sm, Ss
Gs^Fms, Ss, Ss, Ss, Gs^Fds, Gs^Fds, Gs^Fds, Gg^Emf, Rr, Gg^Em, Gg^Emf, Gs^Fds, Gs^Fds, Gs^Fds, Gs^Fms, Ss, Ss, Ww, Ww, Gs^Fds, Ww, Ww, Gs^Fds, Ss, Gs^Fds, Rr, Rr, Gs^Fds, Gs^Fds, Gs^Fds, Gs^Fds, Sm, Ss, Rr, Ss, Ss, Ss, Ss, Gs^Fds, Ss
Sm, Sm, Ss, Ss, Gs^Fds, Gs^Fms, Gs^Fds, Gs^Fds, Gg^Emf, Rr, Rr, Gg^Em, Gg^Emf, Gs^Fds, Ss, Ss, Sm, Ss, Ss, Ww^Dr, Ss, Gs^Fds, Gs^Fds, Sm, Sm, Ss, Ss, Rr, Rr, Ss, Ss, Ss, Sm^Bw/, Rr, Gs^Fds, Gs^Fds, Sm, Ss, Gs^Fms, Gs^Fds
Sm, Sm, Sm, Ss, Ss, Ss, Gs^Fds, Gs^Fds, Gs^Fds, Gg^Emf, Gg^Em, Gg^Em, Gg^Em, Gs^Fds, Ss, Ss, Ss, Ss, Gs^Fms, Sm, Gs^Fds, Gs^Fms, Ss, Sm, Sm, Gs^Fds, Gs^Fms, Ss, Ss, Rr, Rr, Rr, Ss, Sm, Gs^Fms, Gs^Fds, Sm, Ss, Ss, Ss
Ss, Ss, Ss, Sm, Gs^Fds, Ss, Ss, Gs^Fms, Ss, Gg^Emf, Gg^Emf, Gg^Emf, Ss, Ss, Sm, Ss, Sm, Ss, Ss, Gs^Fds, Ss, Sm, Sm, Ss, Sm, Sm, Gs^Fds, Sm, Gs^Fms, Sm, Ss, Ss^Bw\r, Rp, Ss, Ss, Gs^Fds, Gs^Fds, Gs^Fms, Ss, Gs^Fds
Gs^Fds, Gs^Fds, Ss, Sm, Sm, Sm, Sm, Ss, Ss, Ss, Sm, Ss, Ss, Ss, Ss, Ss, Ss, Gs^Fds, Gs^Fms, Ss, Sm, Sm, Gs^Fds, Gs^Fds, Sm, Sm, Sm, Sm, Ss, Sm, Gs^Fms, Sm, Sm, Rp, Sm, Sm, Sm, Gs^Fds, Sm, Gs^Fds
Gs^Fds, Gs^Fds, Gs^Fds, Ss, Ss, Sm, Ss, Sm, Sm, Sm, Ss, Ss, Sm, Ss, Ss, Ss, Gs^Fds, Gs^Fds, Gs^Fds, Ss, Ss, Gs^Fds, Ss, Sm, Ss, Gs^Fds, Gs^Fds, Gs^Fds, Gs^Fds, Ss, Sm, Gs^Fds, Rp, Rp, Sm, Gs^Fds, Gs^Fds, Sm, Gs^Fds, Gs^Fds
Gs^Fds, Gs^Fms, Gs^Fds, Gs^Fds, Gs^Fms, Ss, Ss, Sm, Ss, Ss, Ss, Ss, Ss, Sm, Ss, Ss, Gs^Fds, Gs^Fms, Gs^Fms, Gs^Fds, Gs^Fds, Gs^Fds, Gs^Fds, Ss, Gs^Fds, Sm, Sm, Sm, Gs^Fds, Gs^Fds, Rp, Sm^Bw/r, Sm, Ss, Ss, Gs^Fds, Gs^Fds, Sm, Gs^Fds, Gs^Fds
Gg^Efm, Gg, Gg, Gs^Fds, Gs^Fds, Gs^Fds, Gs^Fds, Ss, Gs^Fms, Gs^Fds, Gs^Fds, Gs^Fds, Gs^Fds, Gs^Fds, Gs^Fds, Gs^Fds, Gs^Fds, Gs^Fds, Gg^Es, Gs^Fds, Gs^Fds, Gs^Fms, Gs^Fds, Gs^Fds, Gg, Gs^Fds, Gs^Fds, Gs^Fds, Gs^Fds, Rp, Gs^Fds, Gs^Fds, Gs^Fds, Gs^Fds, Ss, Ss, Ss, Sm, Gs^Fds, Gs^Fds
Gg, Gg^Efm, Gg, Gs^Fds, Gg, Gs^Fds, Gs^Fds, Gs^Fds, Gs^Fds, Gs^Fds, Gs^Fds, Gs^Fms, Gs^Fds, Gs^Fds, Gg, Gg, Gg^Vl, Gg, Gg, Gs^Fds, Gg^Efm, Gg, Gg, Gg^Es, Gg, Gg^Es, Gg, Gs^Fds, Rp, Rp, Gg^Es, Gs^Fds, Gs^Fds, Gs^Fds, Gs^Fds, Gs^Fds, Gs^Fds, Gs^Fds, Hh^Fds, Gs^Fds
Gs^Fds, Gg, Gs^Fds, Gg, Gg, Gg^Efm, Gg, Gg, Gg, Gs^Fds, Gg^Es, Gg, Gg^Efm, Gg, Gs^Fds, Gg, Gg, Gg, Gg^Efm, Gg^Em, Gg, Gg, Gs^Fds, Gs^Fds, Gs^Fds, Gs^Fds, Rp, Rp, Gg, Gg^Efm, Gg^Efm, Gg, Gs^Fds, Gs^Fds, Gs^Fds, Gs^Fds, Gs^Fds, Gs^Fds, Hh^Fds, Hh^Fds
Gs^Fds, Gg, Gg, Gg^Es, Gs^Fds, Gg, Gg, Gg^Em, Gg, Gg^Vl, Gs^Fds, Gg, Gs^Fds, Gg, Gs^Fds, Gs^Fds, Gs^Fms, Gs^Fds, Hh^Fds, Gs^Fds, Gs^Fds, Gs^Fds, Hh^Fds, Hh^Fds, Hh^Fds, Rp, Gs^Fds, Gs^Fds, Gg, Gg, Gg^Vl, Gg, Gs^Fds, Gs^Fds, Gs^Fds, Hh^Fms, Hh^Fds, Hh^Fds, Hh^Fds, Hh^Fds
Gs^Fds, Gs^Fds, Gs^Fds, Gg, Gs^Fds, Gs^Fds, Gs^Fds, Gs^Fds, Gg^Es, Gg, Gs^Fds, Gs^Fms, Gs^Fds, Gs^Fds, Gg, Gs^Fds, Gg, Gs^Fds, Gs^Fds, Hh^Fds, Gs^Fds, Gs^Fds, Hh^Fds, Hh^Fds, Rp, Rp, Gs^Fds, Gs^Fds, Gs^Fds, Gg, Gg, Gg, Gg, Gs^Fds, Hh^Fds, Hh^Fds, Hh^Fms, Hh^Fds, Hh^Fds, Hh^Fds
Hh^Fds, Gs^Fms, Gg^Em, Gg, Gs^Fds, Gs^Fds, Hh^Fds, Gs^Fms, Gs^Fds, Gs^Fds, Gs^Fds, Gs^Fds, Gs^Fds, Gg, Gg, Gg, Gg^Efm, Gs^Fds, Gg, Gs^Fds, Rp, Rp, Rp, Rp, Gg, Gg, Gs^Fds, Hh^Fms, Gs^Fds, Gs^Fds, Gs^Fds, Gg^Efm, Gg, Gs^Fds, Gs^Fds, Hh^Fds, Hh^Fms, Hh^Fds, Hh^Fds, Hh^Fds
Hh^Fds, Gs^Fds, Gg, Gg, Gg^Efm, Gs^Fds, Gs^Fds, Gs^Fds, Gg, Gs^Fds, Gs^Fds, Gs^Fds, Gg, Gg, Gg, Gg^Efm, Gg, Gg, Gg^Em, Rp, Gs^Fds, Hh^Fds, Gs^Fds, Gg^Vl, Gg^Em, Gg, Gs^Fms, Gs^Fds, Hh^Fds, Hh^Fds, Gs^Fds, Gs^Fds, Gs^Fds, Gg, Gg, Gs^Fds, Gs^Fds, Gs^Fds, Gs^Fds, Gs^Fds
Gs^Fds, Gs^Fms, Gg^Es, Gg, Gg^Efm, Gg, Gg^Es, Gg, Gg^Vl, Gg, Gg, Gg^Es, Gg, Gs^Fds, Gs^Fds, Gs^Fds, Gg, Gg, Gg, Rp, Gs^Fds, Hh^Fds, Gs^Fds, Gg, Gg, Gg, Gs^Fds, Hh^Fds, Hh^Fds, Hh^Fms, Gs^Fds, Gs^Fds, Gg, Gg, Gg^Vl, Gg, Gs^Fds, Gs^Fds, Gs^Fds, Gs^Fds
Gs^Fds, Gs^Fds, Gs^Fds, Gg, Gg, Gg, Gg, Gg, Gg^Efm, Gg, Gg, Gs^Fds, Gs^Fms, Gs^Fds, Gs^Fds, Gg^Es, Gg, Gg^Vl, Rp, Rp, Gs^Fds, Gs^Fds, Gs^Fds, Gg, Gg, Gs^Fds, Gs^Fds, Gs^Fds, Gs^Fds, Gs^Fds, Gs^Fds, Gg, Gg^Efm, Gg, Gg, Gg, Gs^Fds, Gs^Fds, Gs^Fds, Gs^Fds
Gs^Fds, Hh^Fms, Hh^Fds, Gs^Fds, Gs^Fds, Gs^Fds, Gs^Fds, Gg, Gs^Fds, Gg, Gs^Fds, Gs^Fds, Gs^Fds, Gs^Fds, Gs^Fds, Gs^Fds, Rp, Rp, Gg^Em, Gg, Gs^Fds, Gs^Fds, Hh^Fms, Gs^Fds, Gs^Fds, Gg^Efm, Gg, Gs^Fds, Gg, Gs^Fds, Gg, Gg, Gs^Fds, Gg, Gg, Gs^Fds, Gs^Fds, Gs^Fds, Hh^Fds, Gs^Fds
Gs^Fds, Gs^Fds, Gs^Fds, Hh^Fds, Hh^Fds, Gs^Fds, Gs^Fms, Gs^Fds, Gs^Fds, Gs^Fms, Gg, Gs^Fds, Gs^Fds, Gs^Fms, Rp, Rp, Gg, Gg^Es, Gg^Efm, Gg, Gs^Fds, Hh^Fds, Hh^Fds, Gs^Fds, Gs^Fds, Gg^Em, Gg, Gg, Gg, Gg, Gg, Gs^Fds, Gs^Fds, Gs^Fds, Gs^Fds, Gs^Fds, Gs^Fds, Hh^Fds, Hh^Fds, Gs^Fds
Gs^Fds, Gs^Fds, Gs^Fds, Hh^Fds, Hh^Fms, Hh^Fds, Gs^Fds, Gs^Fds, Gg, Gg^Efm, Gg^Es, Gs^Fds, Rp, Rp, Gs^Fds, Gs^Fds, Gs^Fds, Gg, Gg, Gg, Gs^Fds, Gs^Fds, Gs^Fms, Gs^Fds, Gs^Fds, Gg, Gg, Gg^Vl, Gg, Gg^Em, Gg, Gs^Fds, Gs^Fds, Gs^Fds, Gs^Fds, Gs^Fds, Hh^Fds, Hh^Fds, Hh^Fds, Hh^Fds
Gg, Gg^Vl, Gs^Fds, Gs^Fms, Gs^Fds, Hh^Fds, Gs^Fds, Gg^Em, Gg^Em, Gg, Rp, Rp, Gs^Fds, Gs^Fds, Gs^Fms, Gs^Fds, Gs^Fms, Gs^Fds, Gs^Fds, Gg, Gs^Fds, Gs^Fds, Gs^Fds, Gs^Fds, Gs^Fms, Gs^Fds, Gs^Fds, Gg, Gg^Em, Gg^Efm, Gs^Fds, Gs^Fds, Gs^Fds, Gs^Fds, Gs^Fds, Hh^Fds, Hh^Fds, Hh^Fds, Hh^Fds, Hh^Fds
Gg, Gg^Efm, Gg, Gs^Fds, Gs^Fds, Gs^Fds, Gs^Fds, Gg, Rp, Rp, Gs^Fds, Gs^Fds, Gs^Fds, Gs^Fds, Gs^Fds, Gs^Fds, Gs^Fds, Gs^Fds, Gs^Fds, Gs^Fds, Gs^Fds, Gs^Fms, Gs^Fds, Gs^Fds, Gs^Fds, Gs^Fds, Gs^Fds, Gs^Fds, Gs^Fds, Gs^Fds, Gs^Fds, Gs^Fds, Gs^Fds, Gs^Fds, Gs^Fds, Hh^Fds, Hh^Fds, Hh^Fds, Hh^Fds, Hh^Fds
